vp;trial;timest;timeend;x;y;duration;roi
vpja49;1;319;484;-94;-236,9;165;255000
vpja49;1;498;639;-123,6;-217;141;0
vpja49;1;648;1172;-118,6;-199,3;524;0
vpja49;1;1221;1526;-72,7;81;305;255255000
vpja49;1;1573;1725;-265,2;154,3;152;2,55e+08
vpja49;1;1943;2072;-11,6;-4;129;2,55e+08
vpja49;1;2084;2345;-15,9;20,9000000000001;261;255255000
vpja49;1;2405;2725;-414,1;-0,699999999999932;320;255
vpja49;1;2743;2977;-445;5,70000000000005;234;255
vpja49;1;2987;3380;-457,5;1,60000000000002;393;255
vpja49;1;3400;3559;-481,3;-40,9;159;255
vpja49;1;3752;3829;-80,9;-276,3;77;255000
vpja49;1;3845;4514;-104,9;-236,5;669;255000
vpja49;1;4569;4706;26,9;178,6;137;0
vpja49;1;4735;4945;1,20000000000005;92,2;210;255255000
vpja49;1;4960;5126;-25,4;72,1;166;255255000
vpja49;1;5162;5335;-181,1;52,9000000000001;173;2,55e+08
vpja49;1;5385;5847;-113,8;-219,8;462;0
vpja49;1;5857;6052;-101,1;-209,3;195;255000
vpja49;1;6217;6388;-28,4;-28,5999999999999;171;2,55e+08
vpja49;1;6405;6624;-21,3;0,400000000000091;219;2,55e+08
vpja49;1;6706;6865;547;-134;159;0
vpja49;1;6886;7154;598,5;-147,7;268;0
vpja49;1;7183;7250;499,3;-223,3;67;0
vpja49;1;7290;7578;276,5;-88,1999999999999;288;0
vpja49;1;7775;7837;204;-50,1999999999999;62;0
vpja49;1;7892;8521;349,4;-400,8;629;0
vpja49;1;8544;8873;280,4;-415,4;329;0
vpja49;1;8926;9204;191,6;-107,6;278;0
vpja49;1;9246;9402;117,2;82,7;156;0
vpja49;1;9432;9679;21,2;124,2;247;255255000
vpja49;1;9700;9779;-2,39999999999998;81,4000000000001;79;255255000
vpja49;1;9796;9975;-22,6;53,2;179;255255000
vpja49;2;167;256;12,928125;0,425000000000068;89;0
vpja49;2;293;421;-104,371875;-147,875;128;2,55e+08
vpja49;2;439;614;-118,871875;-154,375;175;255000
vpja49;2;620;1433;-130,271875;-152,775;813;255000
vpja49;2;1489;1747;-56,471875;197,825;258;2,55e+08
vpja49;2;1784;1940;-101,571875;307,825;156;0
vpja49;2;2301;2425;-323,871875;132,125;124;0
vpja49;2;2465;2712;-414,671875;22,225;247;255
vpja49;2;2756;2888;-463,271875;263,325;132;0
vpja49;2;2913;3078;-426,171875;305,925;165;0
vpja49;2;3097;3179;-410,071875;339,325;82;0
vpja49;2;3208;3307;-418,971875;448,125;99;0
vpja49;2;3343;3488;-425,071875;257,625;145;0
vpja49;2;3508;3936;-416,971875;220,725;428;0
vpja49;2;3963;4055;-411,471875;310,825;92;0
vpja49;2;4072;4244;-417,171875;282,525;172;0
vpja49;2;4252;4412;-416,971875;270,725;160;0
vpja49;2;4436;4663;-418,771875;336,425;227;0
vpja49;2;4836;4873;-430,771875;431,625;37;0
vpja49;2;4894;5124;-404,671875;394,625;230;0
vpja49;2;5134;5330;-408,871875;407,825;196;0
vpja49;2;5349;5616;-437,471875;372,725;267;0
vpja49;2;5624;5699;-432,371875;366,525;75;0
vpja49;2;5732;5980;-441,371875;249,625;248;0
vpja49;2;6109;6284;432,428125;334,525;175;255255000
vpja49;2;6438;6710;74,828125;-367,475;272;0
vpja49;2;6737;6939;-41,571875;-374,875;202;0
vpja49;2;6965;7262;12,828125;-430,075;297;0
vpja49;2;7291;7560;-1,97187499999995;-349,775;269;0
vpja49;2;7581;8417;-41,071875;-343,875;836;0
vpja49;2;8458;9018;-124,771875;-166,275;560;255000
vpja49;2;9061;9215;-92,471875;42,4250000000001;154;2,55e+08
vpja49;2;9386;9466;-309,971875;-221,475;80;0
vpja49;2;9650;10000;-314,571875;-181,175;350;0
vpja49;3;283;688;-33,4;-237,5;405;255000
vpja49;3;704;1160;-53,6999999999999;-250,4;456;0
vpja49;3;1216;1438;-213,9;96,4000000000001;222;255
vpja49;3;1457;1596;-231;110,2;139;255
vpja49;3;1659;1968;-36,4;-253,2;309;255000
vpja49;3;1987;2525;-46;-209,6;538;0
vpja49;3;2569;2684;-190,3;-124,2;115;0
vpja49;3;2727;3005;-23,5999999999999;-259,8;278;255000
vpja49;3;3053;3208;-267,7;-67,6;155;0
vpja49;3;3225;3577;-241,1;-77,9999999999999;352;0
vpja49;3;3618;3915;-201,8;112,5;297;255
vpja49;3;4101;4152;288,1;154,5;51;255255000
vpja49;3;4384;4426;302,4;156,1;42;255255000
vpja49;3;4465;4668;348,5;-38,3;203;0
vpja49;3;4712;4913;558,1;12,1;201;0
vpja49;3;4981;5174;-63,5999999999999;-256;193;0
vpja49;3;5194;5748;-24,9;-236,8;554;255000
vpja49;3;5759;5951;-23,4;-251,9;192;255000
vpja49;3;5964;6475;-13,9;-263,7;511;255000
vpja49;3;6496;6852;-24,5999999999999;-225,7;356;255000
vpja49;3;6899;7249;-48,4;-5,69999999999993;350;2,55e+08
vpja49;3;7276;7523;-99,5999999999999;57,2;247;2,55e+08
vpja49;3;7712;7791;-66,0999999999999;70;79;0
vpja49;3;8225;8397;-94,3;122,8;172;0
vpja49;3;8656;8687;-213,1;163,9;31;0
vpja49;3;8904;9165;-176,5;127,2;261;255
vpja49;3;9201;9359;-183,6;-61,1;158;0
vpja49;3;9379;9656;-217,9;-78,1;277;0
vpja49;3;9665;9921;-234,9;-85,3;256;0
vpja49;4;246;447;-284,9;-222,8;201;255000
vpja49;4;467;953;-333;-232,4;486;255000
vpja49;4;1022;1311;-426,7;354,9;289;255
vpja49;4;1375;1718;145,2;258,9;343;255255000
vpja49;4;1876;2037;-327,7;-293,1;161;255000
vpja49;4;2060;2818;-300,2;-234,2;758;255000
vpja49;4;2840;3201;-306,2;-290,4;361;255000
vpja49;4;3229;3657;-297,2;-223,9;428;255000
vpja49;4;3724;3903;-398,1;301,1;179;255
vpja49;4;3928;4192;-409,9;359,3;264;255
vpja49;4;4432;4481;120,5;371;49;0
vpja49;4;4741;4825;132;279;84;255255000
vpja49;4;4848;5164;193,2;206,3;316;255255000
vpja49;4;5202;5407;342,7;65,5;205;0
vpja49;4;5466;5612;532,6;-194,7;146;0
vpja49;4;5631;6240;556,8;-148,4;609;0
vpja49;4;6350;6680;-435,5;311,9;330;255
vpja49;4;6887;6983;-360,3;71;96;2,55e+08
vpja49;4;7015;7177;-306;-74,4;162;2,55e+08
vpja49;4;7224;7475;-561,4;116,2;251;2,55e+08
vpja49;4;7508;7564;-547,5;14,1;56;2,55e+08
vpja49;4;7586;7834;-559,8;-58,8;248;2,55e+08
vpja49;4;8025;8076;-567,1;-187,8;51;0
vpja49;4;8225;8342;-582,8;-230,7;117;0
vpja49;4;8389;8765;-292,8;-298,6;376;255000
vpja49;4;8812;9186;-332,9;-45,3;374;2,55e+08
vpja49;4;9360;9581;-287,9;-330,1;221;255000
vpja49;4;9600;10000;-260,2;-304;400;255000
vpja49;5;30;71;-3,5;58,2;41;2,55e+08
vpja49;5;272;340;-1,79999999999995;45,4000000000001;68;2,55e+08
vpja49;5;371;616;-40,5;77,6;245;2,55e+08
vpja49;5;661;977;-304,6;234,9;316;255255000
vpja49;5;1021;1207;-493,3;309,8;186;255255000
vpja49;5;1256;1344;-334;115,8;88;0
vpja49;5;1417;1642;-37,8;-371,2;225;255000
vpja49;5;1658;1815;-13,6999999999999;-356,9;157;255000
vpja49;5;1840;2169;-38,1;-404,5;329;255000
vpja49;5;2190;2508;-8,5;-360,2;318;255000
vpja49;5;2524;2727;-22,4;-386,4;203;255000
vpja49;5;2806;2993;393,6;253,7;187;0
vpja49;5;3021;3203;407,5;345,7;182;255
vpja49;5;3390;3621;-23,9;-359,9;231;255000
vpja49;5;3636;3868;0,700000000000045;-338,2;232;255000
vpja49;5;3889;4606;-24,3;-382,9;717;255000
vpja49;5;4639;4740;9,89999999999998;-315,3;101;255000
vpja49;5;4852;5018;366;228,9;166;255
vpja49;5;5049;5179;406,7;343;130;255
vpja49;5;5255;5433;-290,1;231,9;178;255255000
vpja49;5;5642;5882;-279,4;-268,5;240;0
vpja49;5;5909;6122;-359,3;-302,5;213;0
vpja49;5;6186;6583;-529,5;-329,2;397;0
vpja49;5;6650;7353;-27,1999999999999;-386,7;703;255000
vpja49;5;7364;8148;-48,4;-399,1;784;255000
vpja49;5;8177;8581;-6;-334,1;404;255000
vpja49;5;8606;9047;-48,8;-391,9;441;255000
vpja49;5;9073;9349;-21;-337,7;276;255000
vpja49;5;9443;9586;255,6;260,4;143;0
vpja49;5;9619;9762;381,8;339,9;143;0
vpja49;5;9969;10000;-57,5;149,6;31;0
vpja49;6;252;470;-0,899999999999864;1,20000000000005;218;2,55e+08
vpja49;6;518;675;196,2;234,3;157;0
vpja49;6;734;1285;-66,0999999999998;-163,5;551;255000
vpja49;6;1344;1546;-165,4;315;202;255255000
vpja49;6;1558;1785;-158,4;333,4;227;255255000
vpja49;6;1852;2180;-91,3999999999999;-192,5;328;255000
vpja49;6;2201;2493;-67,5999999999998;-139,1;292;255000
vpja49;6;2552;2715;229,1;210,8;163;255
vpja49;6;2737;2918;245,6;241,1;181;255
vpja49;6;2929;3032;265,2;247,8;103;255
vpja49;6;3276;3497;234,1;258,5;221;0
vpja49;6;3550;4004;-153,7;319,6;454;255255000
vpja49;6;4458;4535;-123;258,5;77;2,55e+08
vpja49;6;4562;4797;-152,8;294,9;235;255255000
vpja49;6;4824;4965;-181,1;219,5;141;2,55e+08
vpja49;6;5024;5401;-69,6999999999998;-138,8;377;255000
vpja49;6;5424;5641;-91,4999999999999;-188,8;217;255000
vpja49;6;5652;6033;-82,1999999999998;-175,7;381;255000
vpja49;6;6174;6336;-455,9;-108,7;162;0
vpja49;6;6366;6644;-556,3;-68,5;278;0
vpja49;6;6654;6759;-566,5;-51,5;105;0
vpja49;6;6975;7222;-84,9999999999999;-186,1;247;255000
vpja49;6;7235;7588;-77,8999999999999;-157,5;353;255000
vpja49;6;7652;7828;-400,1;98,7;176;2,55e+08
vpja49;6;7858;8124;-553,9;112,8;266;0
vpja49;6;8328;8573;-171,3;151,7;245;2,55e+08
vpja49;6;8602;8813;-101,8;228,6;211;2,55e+08
vpja49;6;8826;8961;-122,2;243,8;135;2,55e+08
vpja49;6;9145;9366;-545,5;96,7;221;0
vpja49;6;9401;9757;-563,1;8,10000000000002;356;0
vpja49;6;9788;10000;-569,7;-112,7;212;0
vpja49;7;211;330;-309,4;-71,1;119;0
vpja49;7;360;707;-431,5;-102,4;347;255000
vpja49;7;722;1299;-448,2;-117,6;577;255000
vpja49;7;1349;1603;-512,8;133;254;2,55e+08
vpja49;7;1787;1956;-29,6;30,9;169;0
vpja49;7;1973;2178;-13,2;41,9;205;0
vpja49;7;2223;2354;-261,4;156,6;131;255255000
vpja49;7;2485;2526;-310,8;110,1;41;255255000
vpja49;7;2686;2824;-434,9;-96,5000000000001;138;255000
vpja49;7;2967;3025;-389,3;-133,7;58;255000
vpja49;7;3071;3415;-197,4;-227,1;344;0
vpja49;7;3596;3870;13;78,3;274;255
vpja49;7;4084;4109;-0,5;125,3;25;255
vpja49;7;4174;4447;474,8;296,3;273;0
vpja49;7;4650;4695;245,1;300,1;45;0
vpja49;7;4886;5012;-449,4;-130,4;126;255000
vpja49;7;5031;5273;-432,4;-118,6;242;255000
vpja49;7;5284;5396;-427,4;-132,4;112;255000
vpja49;7;5407;5745;-435;-145,5;338;255000
vpja49;7;5921;6047;-67,5;55,5999999999999;126;0
vpja49;7;6087;6213;-234,9;81,5999999999999;126;255255000
vpja49;7;6448;6501;-231,3;85,6999999999999;53;255255000
vpja49;7;6553;6692;-127,8;-144,5;139;0
vpja49;7;6720;6848;-207,7;-225,9;128;0
vpja49;7;7025;7072;-207,4;30,8;47;0
vpja49;7;7295;8048;-190,7;179,4;753;255255000
vpja49;7;8308;8372;-336,9;-121,4;64;0
vpja49;7;8406;8565;-204,1;-146;159;0
vpja49;7;8589;8746;-197,3;-216,6;157;0
vpja49;7;8791;8994;-445,5;-148;203;255000
vpja49;7;9005;9190;-429,5;-140,5;185;255000
vpja49;7;9232;9265;-259,7;-218,3;33;0
vpja49;7;9292;9532;-188,6;-256,6;240;0
vpja49;7;9583;9758;33,8000000000001;-391,5;175;0
vpja49;7;9778;10000;-6,10000000000002;-369,1;222;0
vpja49;8;127;195;-3,41960726351351;37,5192805715552;68;0
vpja49;8;234;526;114,280392736486;-153,180719428445;292;255000
vpja49;8;542;815;119,880392736487;-173,880719428445;273;255000
vpja49;8;829;1225;116,580392736486;-186,680719428445;396;255000
vpja49;8;1240;1906;139,480392736486;-158,380719428445;666;255000
vpja49;8;1974;2231;-396,619607263514;-137,180719428445;257;0
vpja49;8;2400;2515;-188,219607263514;-213,080719428445;115;0
vpja49;8;2547;2969;-156,919607263514;-325,480719428445;422;0
vpja49;8;3032;3483;344,480392736486;-343,280719428445;451;0
vpja49;8;3625;3871;-120,719607263514;-319,780719428445;246;0
vpja49;8;3907;3945;-139,219607263514;-200,180719428445;38;0
vpja49;8;3973;4066;-77,7196072635136;-134,280719428445;93;0
vpja49;8;4132;4444;381,380392736487;-353,780719428445;312;0
vpja49;8;4466;4695;323,380392736487;-364,980719428445;229;0
vpja49;8;4873;5075;265,080392736486;317,519280571555;202;255
vpja49;8;5107;5278;165,580392736486;251,919280571555;171;255
vpja49;8;5361;5633;-552,719607263514;375,219280571555;272;0
vpja49;8;5654;5892;-554,819607263513;421,619280571555;238;0
vpja49;8;6136;6413;-412,419607263514;102,319280571555;277;255255000
vpja49;8;6434;6549;-394,719607263514;130,619280571555;115;255255000
vpja49;8;6616;6906;160,280392736486;225,419280571555;290;255
vpja49;8;7111;7218;126,980392736486;-221,380719428445;107;255000
vpja49;8;7232;8154;141,580392736486;-196,280719428445;922;255000
vpja49;8;8323;8527;123,180392736487;-217,180719428445;204;255000
vpja49;8;8950;9017;105,180392736487;81,5192805715552;67;0
vpja49;8;9042;9565;156,880392736487;144,419280571555;523;255
vpja49;8;9632;9815;128,280392736486;-208,280719428445;183;255000
vpja49;9;90;192;0,400000000000091;-19,6999999999999;102;0
vpja49;9;229;1031;-64,8999999999999;-167,5;802;255000
vpja49;9;1081;1195;-290,9;39,6;114;0
vpja49;9;1217;1441;-295;85,6;224;255255000
vpja49;9;1491;1803;28,4000000000001;166,7;312;0
vpja49;9;1820;1941;-3,59999999999991;160,8;121;0
vpja49;9;2039;2317;-74,0999999999999;-173,2;278;255000
vpja49;9;2541;2591;-75,3999999999999;-167,2;50;255000
vpja49;9;2936;2977;-2,89999999999986;-297,6;41;0
vpja49;9;3123;3315;81,8000000000002;-362,7;192;0
vpja49;9;3344;3479;-29,4999999999999;-419,5;135;0
vpja49;9;3678;3735;-226,2;89,7;57;0
vpja49;9;3763;4143;-297,6;107,7;380;255255000
vpja49;9;4189;4335;-50,6999999999998;250,4;146;0
vpja49;9;4362;4432;10,1000000000001;188,4;70;0
vpja49;9;4698;4970;-177,1;374,1;272;0
vpja49;9;4992;5112;-209,5;303,7;120;0
vpja49;9;5170;5438;-354,8;12,2;268;0
vpja49;9;5462;5605;-401,1;-1,19999999999993;143;0
vpja49;9;5819;6298;227,4;53,9000000000001;479;0
vpja49;9;6355;6513;-80,9999999999999;-198,3;158;255000
vpja49;9;6529;6643;-59,6999999999998;-182;114;255000
vpja49;9;6699;6943;-393,4;-174,6;244;0
vpja49;9;6972;7190;-463;-149,6;218;0
vpja49;9;7353;7635;-409,3;-240,5;282;0
vpja49;9;7668;7925;-397,7;-114,8;257;0
vpja49;9;7950;8029;-454,5;-153,4;79;0
vpja49;9;8084;8264;-66,8999999999999;-191,8;180;255000
vpja49;9;8272;8480;-53,6999999999998;-185,8;208;255000
vpja49;9;8518;8792;74,4000000000001;-292,5;274;0
vpja49;9;8818;9067;53,3000000000002;-373,3;249;0
vpja49;9;9087;9344;46,0000000000002;-415,7;257;0
vpja49;9;9402;9552;334,5;-105,9;150;0
vpja49;9;9590;9798;437,1;53;208;0
vpja49;9;9847;10000;323,2;268,3;153;0
vpja49;10;230;284;35,0803927364864;58,4192805715552;54;2,55e+08
vpja49;10;321;896;-49,0196072635135;-151,080719428445;575;255000
vpja49;10;942;1310;-228,419607263514;135,519280571555;368;0
vpja49;10;1357;1530;80,5803927364864;146,919280571555;173;0
vpja49;10;1551;1629;126,580392736486;149,019280571555;78;0
vpja49;10;1679;2029;-78,9196072635135;-120,580719428445;350;2,55e+08
vpja49;10;2042;2346;-64,8196072635135;-138,180719428445;304;255000
vpja49;10;2396;2583;96,7803927364864;122,419280571555;187;0
vpja49;10;2604;3211;69,2803927364864;146,819280571555;607;0
vpja49;10;3261;3553;-256,419607263514;151,319280571555;292;0
vpja49;10;3748;4358;-232,419607263514;110,419280571555;610;255255000
vpja49;10;4409;4534;-105,819607263513;-141,080719428445;125;2,55e+08
vpja49;10;4554;5076;-73,0196072635135;-131,780719428445;522;255000
vpja49;10;5088;5425;-72,1196072635136;-142,780719428445;337;255000
vpja49;10;5589;5741;-78,2196072635136;-149,980719428445;152;255000
vpja49;10;5799;6086;326,380392736487;-1,08071942844481;287;0
vpja49;10;6137;6461;584,480392736486;-136,580719428445;324;0
vpja49;10;6473;6585;575,980392736486;-148,780719428445;112;0
vpja49;10;6766;7338;-81,0196072635135;-134,680719428445;572;255000
vpja49;10;7388;7588;-302,419607263514;66,0192805715552;200;0
vpja49;10;7775;7833;-348,219607263514;288,219280571555;58;0
vpja49;10;7873;8236;-323,519607263514;443,619280571555;363;0
vpja49;10;8472;10000;-21,3196072635135;49,5192805715552;1528;2,55e+08
vpja49;11;185;262;-5,40000000000009;3,60000000000002;77;0
vpja49;11;312;482;-183,8;-191,9;170;255000
vpja49;11;495;1386;-229,8;-159,8;891;2,55e+08
vpja49;11;1397;1463;-214,7;-169;66;2,55e+08
vpja49;11;1497;1611;-75,8000000000001;-178,9;114;0
vpja49;11;1646;1892;62,8999999999999;-206,7;246;0
vpja49;11;1919;2157;-45,6;-216,5;238;0
vpja49;11;2210;2400;259;-298,4;190;0
vpja49;11;2412;2681;284,3;-296,5;269;0
vpja49;11;2758;2870;-241,2;402,6;112;0
vpja49;11;2898;3165;-147,5;392,7;267;255255000
vpja49;11;3217;3674;-494,3;369,1;457;0
vpja49;11;3685;3986;-482,6;357,6;301;0
vpja49;11;4201;4330;-469,3;280,3;129;255
vpja49;11;4568;4701;-459,7;332,3;133;0
vpja49;11;4724;4812;-435,6;256,1;88;255
vpja49;11;4869;5238;-230,1;-180;369;0
vpja49;11;5255;5631;-218,9;-149,2;376;2,55e+08
vpja49;11;5788;5966;-480,2;249;178;0
vpja49;11;6161;6280;-539,1;-57,7;119;0
vpja49;11;6319;6643;-584,6;-173,7;324;0
vpja49;11;6697;6997;-217,9;-188,9;300;0
vpja49;11;7014;7083;-193;-171,9;69;2,55e+08
vpja49;11;7280;7459;253,5;249,8;179;0
vpja49;11;7713;7820;-66,9000000000001;371,9;107;255255000
vpja49;11;7838;7900;-83;319,5;62;255255000
vpja49;11;7973;8093;453,1;67,8;120;0
vpja49;11;8115;8320;405,4;78,6;205;0
vpja49;11;8379;8468;507,1;626;89;NA
vpja49;11;8492;8637;502,5;561,2;145;NA
vpja49;11;8841;8958;-168,8;-109,8;117;2,55e+08
vpja49;11;8982;9437;-221;-163,6;455;2,55e+08
vpja49;11;9487;9768;-236,5;187,4;281;2,55e+08
vpja49;11;9794;10000;-173,9;245,7;206;0
vpja49;12;212;329;-16,9000000000001;-165,8;117;255000
vpja49;12;352;623;-33,9000000000001;-209,4;271;255000
vpja49;12;638;1211;-47,5000000000001;-227,6;573;255000
vpja49;12;1275;1551;-453,9;206,4;276;255
vpja49;12;1575;1729;-408,9;248;154;255
vpja49;12;1804;2037;285,7;268,9;233;255255000
vpja49;12;2228;2501;-31,1000000000001;-201,7;273;255000
vpja49;12;2524;2770;-40,9000000000001;-252;246;255000
vpja49;12;2784;3074;-63,9000000000001;-251,3;290;0
vpja49;12;3242;3780;-431,9;213,7;538;255
vpja49;12;3861;4471;307,5;256,1;610;255255000
vpja49;12;4542;4737;-249,8;129,3;195;0
vpja49;12;4809;5032;71,5;-296,5;223;255000
vpja49;12;5058;5247;162,9;-368,7;189;0
vpja49;12;5311;5766;455,4;24,3;455;0
vpja49;12;5936;6137;-344,9;36,5999999999999;201;0
vpja49;12;6353;6490;-27,1000000000001;-42,6;137;2,55e+08
vpja49;12;6533;7822;-22,0000000000001;-241,8;1289;255000
vpja49;12;7887;8083;-506,6;-197,2;196;0
vpja49;12;8138;8368;-325,5;118,6;230;0
vpja49;12;8399;8523;-414,1;179,5;124;255
vpja49;12;8746;9320;-429,5;222,1;574;255
vpja49;12;9381;9629;-41,2;-1;248;2,55e+08
vpja49;12;9640;9933;-32,4000000000001;-11,5;293;2,55e+08
vpja49;13;217;423;-20,1000000000001;-97,3934426229509;206;255000
vpja49;13;437;1255;-52,8000000000001;-87,1934426229509;818;255000
vpja49;13;1276;1380;-19,1000000000001;-110,093442622951;104;255000
vpja49;13;1396;1569;-44,3000000000001;-89,5934426229509;173;255000
vpja49;13;1623;1646;-196,2;250,206557377049;23;0
vpja49;13;1679;1907;-63,0000000000001;346,806557377049;228;255255000
vpja49;13;1924;2259;-63,9000000000001;300,506557377049;335;255255000
vpja49;13;2320;2548;-539;196,906557377049;228;255
vpja49;13;2559;2932;-529,7;183,706557377049;373;255
vpja49;13;3141;3239;-535,3;169,106557377049;98;255
vpja49;13;3471;4259;-536,3;174,306557377049;788;255
vpja49;13;4345;4629;-48,5000000000001;-92,7934426229509;284;255000
vpja49;13;4833;4979;-42,7000000000002;-94,1934426229509;146;255000
vpja49;13;5019;5309;130,6;2,8065573770491;290;2,55e+08
vpja49;13;5548;5738;53,2999999999998;168,006557377049;190;2,55e+08
vpja49;13;5775;6784;-26,9000000000001;271,806557377049;1009;255255000
vpja49;13;6840;8940;315,9;332,006557377049;2100;0
vpja49;13;9107;9531;344,8;-233,693442622951;424;0
vpja49;13;9579;9814;15,6999999999999;-230,593442622951;235;255000
vpja49;13;9864;10000;351,8;-268,293442622951;136;0
vpja49;14;207;335;9,69999999999993;-113,8;128;2,55e+08
vpja49;14;375;831;-45,1;-251,3;456;255000
vpja49;14;849;1265;-54,8;-283,5;416;255000
vpja49;14;1362;1706;-44;-204,8;344;0
vpja49;14;1734;2025;-57;-311,6;291;255000
vpja49;14;2041;2300;-81,9;-292,6;259;0
vpja49;14;2371;2773;-530,7;223,3;402;255
vpja49;14;2800;3040;-514,8;298;240;255
vpja49;14;3111;3709;145;352,7;598;255255000
vpja49;14;3901;4215;-56,4;381,6;314;0
vpja49;14;4471;6300;-161,2;349,8;1829;0
vpja49;14;6504;6821;-111,9;145,5;317;2,55e+08
vpja49;14;6876;7103;250,5;154,5;227;2,55e+08
vpja49;14;7279;7549;-20,3;-300,4;270;255000
vpja49;14;7569;7769;-62,8;-310,7;200;255000
vpja49;14;7920;8050;-349,5;-109,3;130;0
vpja49;14;8096;8294;-482,5;130,3;198;255
vpja49;14;8512;8682;-494,5;243,2;170;255
vpja49;14;9117;9194;-399,4;374,6;77;0
vpja49;14;9239;9613;-131,9;282,7;374;0
vpja49;15;74;181;51,5999999999999;59,2;107;2,55e+08
vpja49;15;222;354;-12,5;-181,1;132;255000
vpja49;15;376;615;-41,1;-198,1;239;255000
vpja49;15;627;826;-63,2;-199,6;199;255000
vpja49;15;883;1205;-360,1;138,8;322;255
vpja49;15;1217;1384;-354,9;116;167;255
vpja49;15;1444;1854;-46,6;-204,2;410;255000
vpja49;15;1868;2016;-62,1;-172,4;148;0
vpja49;15;2217;2375;252;144,3;158;255255000
vpja49;15;2395;2927;212,6;138,4;532;255255000
vpja49;15;2986;3196;507,5;-38,9;210;0
vpja49;15;3248;3303;122,1;53,8000000000001;55;2,55e+08
vpja49;15;3363;3607;-343,6;99,6;244;255
vpja49;15;3790;3828;-350,8;68,7;38;0
vpja49;15;3886;4294;-36,6;-201,8;408;255000
vpja49;15;4310;6225;-56,1;-221,7;1915;255000
vpja49;15;6376;6423;461,9;-116,2;47;0
vpja49;15;6624;6695;269;73,3000000000001;71;0
vpja49;15;6725;6942;209,5;124,7;217;255255000
vpja49;15;7006;7476;143,9;-271,9;470;0
vpja49;15;7516;9343;-36,6;-216,6;1827;255000
vpja49;15;9512;10000;-50,3;-150;488;2,55e+08
vpja49;16;245;1047;-117,119607263514;-231,180719428445;802;255000
vpja49;16;1176;1307;277,280392736486;232,019280571555;131;0
vpja49;16;1328;1428;264,780392736486;261,119280571555;100;0
vpja49;16;1652;1773;-447,319607263513;331,119280571555;121;255
vpja49;16;2089;2111;-454,119607263514;334,619280571555;22;255
vpja49;16;2348;2584;-452,919607263514;339,519280571555;236;255
vpja49;16;2698;2896;301,280392736486;-19,3807194284448;198;0
vpja49;16;2922;3138;270,880392736487;-71,9807194284448;216;0
vpja49;16;3191;3380;561,880392736487;80,0192805715552;189;0
vpja49;16;3491;3610;500,980392736486;-373,180719428445;119;0
vpja49;16;3625;3780;494,880392736487;-333,180719428445;155;0
vpja49;16;3826;3952;279,780392736486;-89,2807194284448;126;0
vpja49;16;3991;4264;253,780392736486;4,21928057155526;273;0
vpja49;16;4460;4664;-455,319607263513;321,219280571555;204;255
vpja49;16;4882;5090;-472,619607263514;448,819280571555;208;0
vpja49;16;5168;5483;300,580392736486;299,819280571555;315;0
vpja49;16;5499;5735;264,880392736487;289,419280571555;236;0
vpja49;16;5745;6106;255,580392736486;288,619280571555;361;0
vpja49;16;6182;6344;-371,819607263513;294,719280571555;162;0
vpja49;16;6417;6762;-118,219607263514;-235,180719428445;345;255000
vpja49;16;6782;7195;-143,819607263513;-277,280719428445;413;255000
vpja49;16;7393;7923;-470,419607263514;386,219280571555;530;255
vpja49;16;7948;8036;-439,819607263513;334,919280571555;88;255
vpja49;16;8114;8465;289,680392736487;297,219280571555;351;255255000
vpja49;16;9113;9165;85,1803927364865;530,419280571555;52;NA
vpja49;16;9251;9497;219,080392736486;0,819280571555169;246;0
vpja49;16;9542;9767;-35,6196072635136;75,5192805715552;225;2,55e+08
vpja49;16;9791;10000;-90,0196072635135;104,019280571555;209;2,55e+08
vpja49;17;192;254;-38,3;-152,2;62;2,55e+08
vpja49;17;282;510;-13,5999999999999;-238,7;228;255000
vpja49;17;526;881;-2;-260,8;355;255000
vpja49;17;939;1055;286,8;125,3;116;255
vpja49;17;1075;1278;266;149,8;203;0
vpja49;17;1421;1775;-326,9;111,2;354;255255000
vpja49;17;1824;2049;-602,1;70,9;225;0
vpja49;17;2410;2447;-328,1;106,4;37;255255000
vpja49;17;2653;2801;-596,7;35,6;148;0
vpja49;17;2824;3183;-547,6;32,1999999999999;359;0
vpja49;17;3398;3508;-276,7;57,3;110;0
vpja49;17;3533;3698;-265;2,60000000000002;165;0
vpja49;17;3755;4061;11,1;-248,8;306;255000
vpja49;17;4140;4391;552,6;-102;251;0
vpja49;17;4425;4541;473,4;-13,8000000000001;116;0
vpja49;17;4578;4648;294,7;6,19999999999993;70;0
vpja49;17;4704;4893;26,1000000000001;-251,4;189;255000
vpja49;17;4913;5220;-1,5;-268,9;307;255000
vpja49;17;5377;5470;-12,0999999999999;-277,7;93;255000
vpja49;17;5526;5788;-373,4;-226,9;262;0
vpja49;17;6025;6968;-178;148,9;943;0
vpja49;17;7021;7214;33,3;382,3;193;0
vpja49;17;7240;7493;102;421,3;253;0
vpja49;17;7726;7860;86,6000000000001;-38,5;134;2,55e+08
vpja49;17;7881;7992;28,5;-93,4;111;2,55e+08
vpja49;17;8033;8715;8,40000000000009;-276,3;682;255000
vpja49;17;8936;9008;233,4;81,6;72;0
vpja49;17;9029;9235;274,3;90,3;206;0
vpja49;17;9276;9533;79,1000000000001;31,8;257;2,55e+08
vpja49;17;9595;9954;523,9;-50;359;0
vpja49;18;256;332;14,5803927364865;8,51928057155521;76;2,55e+08
vpja49;18;375;474;13,5803927364865;-233,980719428445;99;0
vpja49;18;500;881;-33,3196072635135;-288,480719428445;381;255000
vpja49;18;914;1076;-49,9196072635135;-154,380719428445;162;0
vpja49;18;1111;1419;-30,6196072635136;-292,880719428445;308;255000
vpja49;18;1437;1485;-45,4196072635135;-271,380719428445;48;0
vpja49;18;1497;1637;-31,6196072635136;-264,480719428445;140;0
vpja49;18;1792;2188;-28,4196072635135;-275,380719428445;396;255000
vpja49;18;2229;2578;-35,5196072635135;-96,0807194284448;349;255255000
vpja49;18;2615;2787;-182,319607263513;-31,8807194284448;172;0
vpja49;18;2815;2992;-110,319607263513;-11,9807194284448;177;0
vpja49;18;3019;3137;-46,4196072635135;-34,8807194284448;118;255255000
vpja49;18;3367;3588;-243,019607263514;-36,4807194284448;221;255
vpja49;18;3605;3784;-217,419607263514;-43,1807194284448;179;255
vpja49;18;3977;4092;-141,519607263514;-8,18071942844483;115;0
vpja49;18;4116;4288;-96,3196072635135;13,9192805715552;172;2,55e+08
vpja49;18;4489;4507;-151,719607263514;-12,3807194284448;18;0
vpja49;18;4547;4899;-209,219607263514;-245,680719428445;352;0
vpja49;18;4953;5316;-564,019607263514;-66,8807194284448;363;0
vpja49;18;5401;5539;154,280392736486;-81,8807194284448;138;0
vpja49;18;5582;5799;346,580392736486;-46,3807194284448;217;0
vpja49;18;5845;6274;293,480392736486;-222,580719428445;429;0
vpja49;18;6322;6485;537,380392736487;-30,3807194284448;163;0
vpja49;18;6556;6861;58,4803927364865;413,819280571555;305;2,55e+08
vpja49;18;7038;8449;-41,2196072635136;-271,780719428445;1411;255000
vpja49;18;8458;8672;-46,8196072635135;-276,780719428445;214;0
vpja49;18;8728;9012;-67,6196072635136;20,4192805715552;284;2,55e+08
vpja49;18;9242;9364;-198,419607263514;-16,9807194284448;122;255
vpja49;18;9669;9717;-87,9196072635135;29,3192805715552;48;2,55e+08
vpja49;18;9962;9999;-138,419607263514;-117,280719428445;37;0
vpja49;19;120;205;-1,29999999999995;45,3;85;2,55e+08
vpja49;19;247;433;1,89999999999998;-220;186;255000
vpja49;19;454;972;-26,6;-248,4;518;255000
vpja49;19;987;1206;-22,3;-215,7;219;255000
vpja49;19;1226;1691;-18,9;-262,8;465;255000
vpja49;19;1712;2438;-3,79999999999995;-227,8;726;255000
vpja49;19;2457;2678;-7,20000000000005;-272,6;221;255000
vpja49;19;2693;2894;16;-272;201;255000
vpja49;19;3081;3154;-32,2;-185,6;73;0
vpja49;19;3214;3336;-281,3;110,7;122;0
vpja49;19;3356;3545;-256;129,5;189;0
vpja49;19;3611;3740;305,1;162,1;129;255255000
vpja49;19;3760;3907;338,2;167,5;147;0
vpja49;19;4098;4340;-11,1;-265,1;242;255000
vpja49;19;4356;4546;2,60000000000002;-276,5;190;255000
vpja49;19;4556;4842;10;-286,8;286;255000
vpja49;19;4866;5224;-3,29999999999995;-226,3;358;255000
vpja49;19;5399;5551;42,4000000000001;-101,5;152;2,55e+08
vpja49;19;5580;5829;24,5999999999999;-22,2;249;2,55e+08
vpja49;19;5860;5882;31,5999999999999;-138,7;22;2,55e+08
vpja49;19;5915;6249;29,5;-281,9;334;255000
vpja49;19;6428;6780;100,7;-268,6;352;255000
vpja49;19;6810;6999;0,399999999999977;-297,1;189;255000
vpja49;19;7016;7200;3,79999999999995;-267,4;184;255000
vpja49;19;7213;7298;10,5;-243,4;85;255000
vpja49;19;7362;7571;-267,7;118,8;209;0
vpja49;19;7643;7838;351,1;126,9;195;0
vpja49;19;8031;8087;2,60000000000002;-257,7;56;255000
vpja49;19;8262;8485;7,10000000000002;-266,3;223;255000
vpja49;19;8902;8954;22,8;-270,5;52;255000
vpja49;19;9126;9280;17,3;-283,4;154;255000
vpja49;19;9301;9703;19,3;-244,4;402;255000
vpja49;19;9725;9956;21,3;-290,9;231;255000
vpja49;20;196;301;-98,9196072635135;-161,180719428445;105;0
vpja49;20;331;672;-217,219607263514;-132,680719428445;341;255000
vpja49;20;684;1205;-243,619607263514;-100,780719428445;521;255000
vpja49;20;1328;1531;-253,319607263513;-130,180719428445;203;255000
vpja49;20;1697;1781;-234,619607263514;-119,780719428445;84;255000
vpja49;20;1793;1956;-234,419607263514;-100,380719428445;163;255000
vpja49;20;2008;2174;-76,2196072635136;247,919280571555;166;255
vpja49;20;2229;2430;249,380392736487;69,3192805715552;201;255255000
vpja49;20;2450;2570;282,680392736487;78,1192805715552;120;255255000
vpja49;20;2761;2882;-448,019607263514;-77,0807194284448;121;0
vpja49;20;2914;3130;-574,919607263514;-62,2807194284448;216;0
vpja49;20;3175;3374;-364,119607263514;-272,280719428445;199;0
vpja49;20;3449;3730;209,580392736486;-329,080719428445;281;0
vpja49;20;3928;4104;34,6803927364865;83,7192805715553;176;0
vpja49;20;4148;4419;-97,1196072635136;295,719280571555;271;255
vpja49;20;4634;4704;-265,619607263514;-154,280719428445;70;255000
vpja49;20;4727;5011;-241,519607263514;-125,780719428445;284;255000
vpja49;20;5021;5141;-233,919607263514;-105,080719428445;120;255000
vpja49;20;5198;5400;221,980392736486;45,2192805715553;202;255255000
vpja49;20;5426;5567;276,080392736486;34,7192805715553;141;255255000
vpja49;20;5618;5903;567,780392736486;-56,9807194284448;285;0
vpja49;20;6132;6380;222,680392736487;-0,180719428444831;248;0
vpja49;20;6419;7331;80,2803927364864;18,2192805715553;912;0
vpja49;20;7525;7550;22,2803927364864;196,819280571555;25;0
vpja49;20;7802;8240;-20,7196072635136;189,619280571555;438;0
vpja49;20;8301;8441;-166,119607263514;-113,080719428445;140;0
vpja49;20;8467;9768;-232,119607263514;-122,580719428445;1301;255000
vpja49;20;9945;10000;-135,319607263513;142,619280571555;55;0
vpja49;21;210;286;50,1797297297297;-229,445945945946;76;2,55e+08
vpja49;21;309;425;53,2797297297299;-272,945945945946;116;2,55e+08
vpja49;21;438;889;33,3797297297298;-278,345945945946;451;2,55e+08
vpja49;21;950;1213;-131,82027027027;92,954054054054;263;255
vpja49;21;1414;1557;-143,22027027027;28,354054054054;143;255
vpja49;21;1611;1709;191,07972972973;3,85405405405402;98;0
vpja49;21;1764;2295;35,4797297297297;-297,545945945946;531;255000
vpja49;21;2492;2852;299,77972972973;116,354054054054;360;255255000
vpja49;21;2900;3030;108,87972972973;18,0540540540541;130;0
vpja49;21;3081;3503;41,9797297297297;-284,345945945946;422;2,55e+08
vpja49;21;3511;3619;29,9797297297297;-290,445945945946;108;2,55e+08
vpja49;21;3670;3892;-31,7202702702702;-1,74594594594589;222;0
vpja49;21;3925;4090;-144,62027027027;65,7540540540541;165;255
vpja49;21;4301;4926;-132,72027027027;54,7540540540541;625;255
vpja49;21;4981;5212;267,17972972973;119,054054054054;231;255255000
vpja49;21;5231;5387;298,57972972973;121,754054054054;156;255255000
vpja49;21;5575;5746;38,4797297297297;-277,745945945946;171;2,55e+08
vpja49;21;5760;6361;31,5797297297298;-310,545945945946;601;0
vpja49;21;6418;6921;-116,72027027027;32,2540540540541;503;255
vpja49;21;7171;7353;277,27972972973;145,554054054054;182;255255000
vpja49;21;7423;7651;23,2797297297299;-308,445945945946;228;0
vpja49;21;7663;8723;37,9797297297297;-289,145945945946;1060;255000
vpja49;21;8905;10000;29,2797297297299;-16,7459459459459;1095;0
vpja49;22;35;165;8,39999999999986;16,5;130;2,55e+08
vpja49;22;197;354;77,9999999999998;-84,1;157;255000
vpja49;22;371;1504;79,3999999999999;-93,5;1133;255000
vpja49;22;1560;1675;359,8;297,1;115;255
vpja49;22;1700;1828;331,1;342,1;128;255
vpja49;22;1854;2018;391,1;392,9;164;255
vpja49;22;2033;2121;377,2;417,7;88;255
vpja49;22;2192;2416;-122,9;307,9;224;255255000
vpja49;22;2536;2747;79,6999999999998;-96,9;211;255000
vpja49;22;2906;3049;82,9999999999998;-102,7;143;255000
vpja49;22;3245;3565;-445,1;-149,5;320;0
vpja49;22;3588;3785;-496,9;-177,1;197;0
vpja49;22;3832;4041;-241,6;-224,5;209;0
vpja49;22;4067;4246;-168,3;-237;179;0
vpja49;22;4276;4565;-254;-304,6;289;0
vpja49;22;4614;4833;-467,7;-157,4;219;0
vpja49;22;5004;5233;-125,4;305,6;229;255255000
vpja49;22;5258;5503;-202,1;295,9;245;255255000
vpja49;22;5568;5830;353,1;385,5;262;255
vpja49;22;5854;6058;391,5;356,1;204;255
vpja49;22;6080;6273;355,5;404,8;193;255
vpja49;22;6334;6489;-176,8;312,2;155;255255000
vpja49;22;6512;6548;-218,4;303;36;255255000
vpja49;22;6611;6829;340,4;377,1;218;255
vpja49;22;6849;6961;386,2;379,2;112;255
vpja49;22;7113;7325;-439,4;144,5;212;0
vpja49;22;7350;7468;-460,5;75,4;118;0
vpja49;22;7516;7800;-334,1;-188,7;284;0
vpja49;22;7827;8108;-244,9;-224,5;281;0
vpja49;22;8256;8790;-487,7;-164;534;0
vpja49;22;8800;8891;-491,4;-150,5;91;0
vpja49;22;9094;9740;-387,9;-20,6;646;0
vpja49;23;205;369;-55,6999999999999;-91,2;164;255000
vpja49;23;381;1377;-86;-87,7;996;255000
vpja49;23;1550;2158;-81,1999999999999;-92,2;608;255000
vpja49;23;2172;2387;-77;-106,5;215;255000
vpja49;23;2444;2561;-410,8;121,6;117;0
vpja49;23;2585;2786;-453,4;156,2;201;255
vpja49;23;2980;3316;126,5;115;336;255255000
vpja49;23;3475;3507;-139,5;200;32;0
vpja49;23;3742;3789;-122,7;221,2;47;2,55e+08
vpja49;23;3843;4033;-69,6999999999999;-98,3000000000001;190;255000
vpja49;23;4044;4729;-85,8;-96,8000000000001;685;255000
vpja49;23;4791;5014;-357,6;-351,8;223;0
vpja49;23;5040;5165;-450,1;-353,8;125;0
vpja49;23;5216;5520;-104,9;-354,5;304;0
vpja49;23;5680;5783;211,8;-166,9;103;0
vpja49;23;5829;6081;301,5;73;252;0
vpja49;23;6108;6301;383,9;112;193;0
vpja49;23;6343;6747;166;184,8;404;0
vpja49;23;6784;6887;329,6;95;103;0
vpja49;23;6925;7367;547,6;46,6999999999999;442;0
vpja49;23;7419;7681;144,9;98,9;262;255255000
vpja49;23;7708;7991;214,7;117,4;283;255255000
vpja49;23;8064;8219;-443,3;167,8;155;255
vpja49;23;8243;8433;-485,7;157,5;190;0
vpja49;23;8633;8792;-450,7;-248,5;159;0
vpja49;23;8814;8912;-431,4;-301,1;98;0
vpja49;23;8947;9107;-492,3;-155,6;160;0
vpja49;23;9119;9360;-477;-131,1;241;0
vpja49;23;9405;9660;-467,1;-346,2;255;0
vpja49;23;9704;9843;-664,3;-168,6;139;NA
vpja49;23;9857;10000;-662,8;-143,7;143;NA
vpja49;24;133;181;-2,5;4,90000000000009;48;2,55e+08
vpja49;24;204;335;43,5;-47,6;131;255000
vpja49;24;351;595;52,7;-29,4999999999999;244;255000
vpja49;24;608;1030;52,5999999999999;-48,9999999999999;422;255000
vpja49;24;1038;1604;63;-34,1;566;255000
vpja49;24;1614;1825;67,5999999999999;-43,3;211;255000
vpja49;24;1868;2156;285,7;101,2;288;255
vpja49;24;2373;2590;47,7;162,8;217;2,55e+08
vpja49;24;2602;3238;57;184;636;255255000
vpja49;24;3259;3432;16,5999999999999;171,4;173;255255000
vpja49;24;3490;3547;8,39999999999998;-123,3;57;0
vpja49;24;3574;4146;-29,5;-180,8;572;0
vpja49;24;4203;4436;380,9;-163,2;233;0
vpja49;24;4462;4745;304;-168,3;283;0
vpja49;24;4968;5037;463,9;123,3;69;0
vpja49;24;5085;5215;334,3;-156,6;130;0
vpja49;24;5234;5381;301,2;-169,4;147;0
vpja49;24;5432;5776;-21,4000000000001;-191,7;344;0
vpja49;24;5804;5948;34,8999999999999;-64,1;144;255000
vpja49;24;5964;6594;55,5999999999999;-35,6999999999999;630;255000
vpja49;24;6805;6879;50,7;-46,6;74;255000
vpja49;24;7131;7255;-536,3;142,8;124;0
vpja49;24;7461;7682;-235,9;304,7;221;0
vpja49;24;7727;7818;-28;319,8;91;0
vpja49;24;8108;8321;55;477,8;213;0
vpja49;24;8365;8505;-129,6;411,5;140;0
vpja49;24;8805;8923;-147,8;493,4;118;NA
vpja49;24;8977;9140;-88,3000000000001;591;163;NA
vpja49;24;9210;9499;-178,2;1047,2;289;NA
vpja49;24;9542;9620;-279,8;1002,9;78;NA
vpja49;25;130;189;10,9803927364865;-26,5807194284448;59;2,55e+08
vpja49;25;228;480;52,6803927364865;-205,080719428445;252;255000
vpja49;25;501;856;45,1803927364865;-224,580719428445;355;255000
vpja49;25;917;1107;-347,019607263514;162,919280571555;190;255255000
vpja49;25;1176;1445;303,280392736486;211,019280571555;269;255
vpja49;25;1465;1506;330,580392736486;208,619280571555;41;255
vpja49;25;1724;2067;68,3803927364866;-232,780719428445;343;255000
vpja49;25;2271;2450;65,9803927364865;-183,380719428445;179;255000
vpja49;25;2496;2788;17,0803927364864;17,9192805715552;292;2,55e+08
vpja49;25;2813;2932;14,8803927364864;-41,0807194284448;119;2,55e+08
vpja49;25;3131;3217;47,5803927364864;-82,9807194284448;86;2,55e+08
vpja49;25;3252;3635;42,2803927364864;-240,680719428445;383;255000
vpja49;25;3800;3937;-247,419607263514;-26,3807194284448;137;0
vpja49;25;3973;4206;-369,219607263514;42,8192805715552;233;0
vpja49;25;4408;4572;-215,819607263513;78,4192805715552;164;0
vpja49;25;4610;4832;-362,419607263514;109,019280571555;222;255255000
vpja49;25;4902;5044;41,2803927364864;-212,980719428445;142;255000
vpja49;25;5373;5583;-481,919607263514;-107,480719428445;210;0
vpja49;25;5792;5981;5,08039273648649;-215,380719428445;189;255000
vpja49;25;6036;6357;137,980392736486;105,219280571555;321;0
vpja49;25;6401;6576;331,280392736486;182,519280571555;175;255
vpja49;25;6645;6862;530,480392736486;-213,180719428445;217;0
vpja49;25;7070;7215;65,8803927364866;-222,380719428445;145;255000
vpja49;25;7287;7483;587,680392736487;-245,780719428445;196;0
vpja49;25;7675;7896;42,0803927364864;-203,580719428445;221;255000
vpja49;25;8080;8172;11,4803927364865;-72,0807194284448;92;2,55e+08
vpja49;25;8210;8632;44,7803927364864;-225,980719428445;422;255000
vpja49;25;8832;8992;-208,519607263514;-33,9807194284448;160;0
vpja49;25;9037;9331;-397,019607263514;146,119280571555;294;255255000
vpja49;25;9560;9897;-321,219607263514;100,119280571555;337;255255000
vpja49;25;9920;9999;-297,719607263514;41,4192805715552;79;0
vpja49;26;211;245;-4,79999999999995;29,9000000000001;34;0
vpja49;26;290;334;-52;-221,7;44;2,55e+08
vpja49;26;365;456;-34,8;-300,3;91;2,55e+08
vpja49;26;475;1546;-26,8;-318;1071;2,55e+08
vpja49;26;1619;1809;319,7;212,7;190;255
vpja49;26;1838;1971;361,7;302,4;133;255
vpja49;26;1985;2083;380;317,6;98;255
vpja49;26;2157;2473;130,3;-224,1;316;0
vpja49;26;2526;2732;-196,4;-187,2;206;0
vpja49;26;2776;3157;-390,6;-232,3;381;0
vpja49;26;3215;3346;-375,8;90,1;131;255255000
vpja49;26;3558;3597;-201,8;128,6;39;255255000
vpja49;26;3682;3918;457,8;-88,6999999999999;236;0
vpja49;26;3949;4130;454,1;-226,9;181;0
vpja49;26;4215;4441;-388,5;-279,6;226;0
vpja49;26;4468;4822;-516,2;-316,2;354;0
vpja49;26;4848;4955;-471,8;-255,4;107;0
vpja49;26;5137;5337;-309;134,7;200;255255000
vpja49;26;5363;5641;-251,9;179,6;278;255255000
vpja49;26;5705;5904;304,3;264,8;199;255
vpja49;26;5985;6102;-29,4;-246,4;117;2,55e+08
vpja49;26;6127;6753;-28,9;-309,5;626;2,55e+08
vpja49;26;6811;6996;-37,7;42,2;185;2,55e+08
vpja49;26;7025;7200;-53,6;142,6;175;2,55e+08
vpja49;26;7415;7560;-263;-231,8;145;0
vpja49;26;7585;8073;-215,4;-212,6;488;0
vpja49;26;8113;8398;-249,9;-350,1;285;0
vpja49;26;8441;8669;-31,5;-333,4;228;255000
vpja49;26;8681;9100;-21,7;-306,8;419;2,55e+08
vpja49;26;9110;9440;-25,9;-291,2;330;2,55e+08
vpja49;26;9479;10000;-13,6;-139,2;521;2,55e+08
