vp;trial;timest;timeend;x;y;duration;roi
vpja75;1;279;642;133,7;-164,8;363;255000
vpja75;1;661;1016;156,8;-132,2;355;255000
vpja75;1;1074;1283;80,8;223;209;255
vpja75;1;1352;1590;-374;103,6;238;255255000
vpja75;1;1608;1962;-383,4;83,4;354;255255000
vpja75;1;1978;2034;-379,3;112,2;56;255255000
vpja75;1;2195;2223;-360,9;110,7;28;255255000
vpja75;1;2272;2409;18,2;103,9;137;2,55e+08
vpja75;1;2443;2578;154,3;58,5;135;2,55e+08
vpja75;1;2600;2776;164,8;17,6;176;2,55e+08
vpja75;1;2823;3011;144,9;-176,8;188;255000
vpja75;1;3032;3320;175,9;-193,4;288;255000
vpja75;1;3338;3443;160,9;-182,4;105;255000
vpja75;1;3492;3623;407,8;-333,6;131;0
vpja75;1;3644;3886;441,2;-329,2;242;0
vpja75;1;3960;4077;487,5;224,8;117;0
vpja75;1;4133;4256;233,8;358,2;123;0
vpja75;1;4291;4425;132,2;219,3;134;0
vpja75;1;4459;4653;162,3;100,1;194;2,55e+08
vpja75;1;4686;4793;163,3;8,70000000000005;107;2,55e+08
vpja75;1;4847;4995;77;233,4;148;255
vpja75;1;5008;5129;76,2;214,5;121;255
vpja75;1;5187;5360;136,2;-160,1;173;255000
vpja75;1;5384;5577;134,7;-195,6;193;255000
vpja75;1;5599;6102;160;-191,7;503;255000
vpja75;1;6131;6371;130,1;-153,3;240;255000
vpja75;1;6386;7535;127,4;-130,4;1149;255000
vpja75;1;7560;7858;132,3;-175;298;255000
vpja75;1;7874;8269;158,5;-178,3;395;255000
vpja75;1;8330;8542;72,1000000000001;132,7;212;2,55e+08
vpja75;1;8585;8720;64,9000000000001;248,6;135;255
vpja75;1;8793;8975;-372,8;131,6;182;255255000
vpja75;1;8999;9268;-374,4;80,4;269;255255000
vpja75;1;9284;10000;-384,9;81,5;716;255255000
vpja75;2;58;232;8,20000000000005;14,2;174;2,55e+08
vpja75;2;287;394;2,70000000000005;-240,1;107;255000
vpja75;2;419;1159;-20,6;-277;740;255000
vpja75;2;1226;1486;-244,4;138,2;260;255
vpja75;2;1550;1795;-8,29999999999995;-279,8;245;255000
vpja75;2;1811;2210;-25,6;-272,7;399;255000
vpja75;2;2239;2428;-102,6;-349,6;189;0
vpja75;2;2464;2593;-26,2;-254,5;129;255000
vpja75;2;2661;2961;260,7;73,4000000000001;300;0
vpja75;2;2991;3142;275,9;-29,5999999999999;151;0
vpja75;2;3165;3296;274,9;-60,5;131;0
vpja75;2;3374;3543;-189,8;-12,1999999999999;169;0
vpja75;2;3590;4075;-209,7;110,8;485;255
vpja75;2;4090;4291;-191,1;125,6;201;255
vpja75;2;4317;4563;-229,8;155,6;246;255
vpja75;2;4665;4779;357,9;143,6;114;255255000
vpja75;2;4804;4979;396,1;111,4;175;255255000
vpja75;2;5013;5139;458,7;-24,6999999999999;126;0
vpja75;2;5164;5473;503,7;-65;309;0
vpja75;2;5502;5746;443,8;-151,5;244;0
vpja75;2;5789;5899;451;-66,8;110;0
vpja75;2;5923;6123;497,2;-68,8;200;0
vpja75;2;6203;6432;-36,6;-250,8;229;255000
vpja75;2;6452;6625;-18,2;-227;173;255000
vpja75;2;6650;6809;-31,1;-277,5;159;255000
vpja75;2;6825;7431;-9,29999999999995;-269,5;606;255000
vpja75;2;7451;7541;-33,8;-257,3;90;255000
vpja75;2;7610;7814;-236,8;114;204;255
vpja75;2;7865;8118;-245,5;-57,1999999999999;253;0
vpja75;2;8173;8315;-429,3;-27,8;142;0
vpja75;2;8373;8493;-523,2;127,7;120;0
vpja75;2;8528;8681;-580,2;194,9;153;0
vpja75;2;8772;8822;-204,9;-218,1;50;0
vpja75;2;9026;9141;9,60000000000002;-262,6;115;255000
vpja75;2;9174;9490;-16,2;-273,4;316;255000
vpja75;2;9503;9730;-24,7;-263,2;227;255000
vpja75;2;9752;10000;3,20000000000005;-261,7;248;255000
vpja75;3;211;309;34,5;-177,8;98;255000
vpja75;3;336;651;83,8;-245,6;315;255000
vpja75;3;658;1019;94;-268,6;361;255000
vpja75;3;1043;1269;102,2;-221,5;226;255000
vpja75;3;1320;1756;369,1;-247,7;436;0
vpja75;3;1782;1949;326,1;-325,5;167;0
vpja75;3;2006;2141;88,4000000000001;-274,1;135;255000
vpja75;3;2212;2492;306,1;123;280;255
vpja75;3;2510;2760;315;113,7;250;255
vpja75;3;2792;3031;164,8;98,1;239;2,55e+08
vpja75;3;3059;3524;313;142,7;465;255
vpja75;3;3541;3700;333,5;119,3;159;0
vpja75;3;3777;3969;-287,2;166,1;192;255255000
vpja75;3;3991;4234;-252,9;165,3;243;255255000
vpja75;3;4256;4535;-280,6;141,2;279;255255000
vpja75;3;4558;4739;-241,7;166,4;181;255255000
vpja75;3;4922;5045;-257,2;137,4;123;255255000
vpja75;3;5066;5337;-280,9;133,2;271;255255000
vpja75;3;5363;5563;-241,1;171,3;200;255255000
vpja75;3;5589;5833;-278;131,9;244;255255000
vpja75;3;5854;6072;-242,5;160,3;218;255255000
vpja75;3;6098;6378;-274,9;122,5;280;255255000
vpja75;3;6407;6652;-242,9;164,6;245;255255000
vpja75;3;6676;6922;-276,7;134,6;246;255255000
vpja75;3;6941;7190;-247,6;154,8;249;255255000
vpja75;3;7197;7608;-243,6;166,8;411;255255000
vpja75;3;7628;7802;-274,4;145,2;174;255255000
vpja75;3;7823;8105;-298,5;141,9;282;255255000
vpja75;3;8120;8378;-308,9;148,8;258;255255000
vpja75;3;8403;8530;-249,6;174,6;127;255255000
vpja75;3;8593;8734;63,3000000000001;-193,7;141;255000
vpja75;3;8762;8988;78,8;-270;226;255000
vpja75;3;9140;9826;89,8;-260,2;686;255000
vpja75;3;9849;9999;90;-209,2;150;255000
vpja75;4;212;302;21,1412371134022;-214,918556701031;90;255000
vpja75;4;345;567;32,3412371134021;-312,518556701031;222;255000
vpja75;4;576;819;24,8412371134021;-320,418556701031;243;255000
vpja75;4;891;1041;-298,358762886598;77,1814432989692;150;0
vpja75;4;1060;1274;-304,558762886598;108,881443298969;214;0
vpja75;4;1338;1462;360,541237113402;235,481443298969;124;0
vpja75;4;1487;1988;333,841237113402;195,481443298969;501;0
vpja75;4;1999;2088;324,941237113402;191,481443298969;89;255
vpja75;4;2290;2334;359,441237113402;143,981443298969;44;0
vpja75;4;2351;2683;325,741237113402;183,381443298969;332;255
vpja75;4;2692;3018;319,741237113402;209,581443298969;326;255
vpja75;4;3100;3297;-284,758762886598;145,581443298969;197;0
vpja75;4;3318;3467;-303,958762886598;121,681443298969;149;255255000
vpja75;4;3509;3694;-24,3587628865978;-111,018556701031;185;2,55e+08
vpja75;4;3744;4127;27,3412371134021;-296,718556701031;383;255000
vpja75;4;4149;4459;50,1412371134022;-256,518556701031;310;255000
vpja75;4;4484;4808;25,6412371134022;-282,918556701031;324;255000
vpja75;4;4831;5125;47,0412371134022;-241,318556701031;294;255000
vpja75;4;5152;5520;34,1412371134022;-293,318556701031;368;255000
vpja75;4;5542;5797;47,9412371134022;-253,118556701031;255;255000
vpja75;4;5843;6018;192,641237113402;-225,018556701031;175;0
vpja75;4;6067;6288;55,8412371134021;-286,818556701031;221;255000
vpja75;4;6310;6680;39,2412371134021;-295,318556701031;370;255000
vpja75;4;6706;7054;69,2412371134021;-256,018556701031;348;255000
vpja75;4;7072;7268;56,5412371134022;-236,018556701031;196;255000
vpja75;4;7314;7497;200,941237113402;-242,018556701031;183;0
vpja75;4;7553;7680;309,141237113402;-427,318556701031;127;0
vpja75;4;7787;7825;511,441237113402;243,581443298969;38;0
vpja75;4;8043;8077;528,041237113402;310,681443298969;34;0
vpja75;4;8108;8170;616,841237113402;218,181443298969;62;0
vpja75;4;8205;8366;599,341237113402;283,181443298969;161;0
vpja75;4;8411;8837;613,041237113402;389,481443298969;426;0
vpja75;4;8853;9138;615,941237113402;416,481443298969;285;0
vpja75;4;9209;9467;322,841237113402;164,281443298969;258;0
vpja75;4;9485;9757;343,941237113402;183,481443298969;272;0
vpja75;5;194;288;-121,188771929825;-133,318947368421;94;2,55e+08
vpja75;5;315;1095;-151,388771929825;-180,018947368421;780;255000
vpja75;5;1223;1411;461,511228070175;301,281052631579;188;255
vpja75;5;1439;1598;484,911228070175;266,481052631579;159;255
vpja75;5;1636;1891;444,611228070175;383,381052631579;255;0
vpja75;5;2018;2070;4,01122807017521;263,181052631579;52;2,55e+08
vpja75;5;2264;2403;-315,488771929825;-27,2189473684211;139;0
vpja75;5;2447;2610;-358,688771929825;74,6810526315788;163;0
vpja75;5;2648;2850;-390,788771929825;102,981052631579;202;0
vpja75;5;2905;3055;-447,288771929825;257,681052631579;150;0
vpja75;5;3098;3244;-424,688771929825;341,281052631579;146;0
vpja75;5;3263;3411;-403,388771929825;337,981052631579;148;0
vpja75;5;3443;3701;-397,488771929825;236,081052631579;258;0
vpja75;5;3734;3955;-396,888771929825;353,181052631579;221;0
vpja75;5;3979;4096;-429,388771929825;348,981052631579;117;0
vpja75;5;4141;4302;-519,288771929825;339,181052631579;161;0
vpja75;5;4329;4576;-442,588771929825;368,681052631579;247;0
vpja75;5;4595;4791;-430,288771929825;336,981052631579;196;0
vpja75;5;4825;5095;-536,688771929825;303,981052631579;270;0
vpja75;5;5147;5318;-455,888771929825;90,7810526315789;171;0
vpja75;5;5352;5511;-450,488771929825;-43,1189473684211;159;255255000
vpja75;5;5552;5776;-161,688771929825;-166,118947368421;224;255000
vpja75;5;5830;5988;-316,088771929825;-212,018947368421;158;0
vpja75;5;6035;6293;17,6112280701752;-376,518947368421;258;0
vpja75;5;6325;6490;96,4112280701753;-390,018947368421;165;0
vpja75;5;6508;6605;120,711228070175;-379,218947368421;97;0
vpja75;5;6655;7131;443,411228070175;-445,818947368421;476;0
vpja75;5;7197;7361;388,411228070175;-41,0189473684212;164;0
vpja75;5;7402;7536;340,311228070175;46,9810526315788;134;0
vpja75;5;7600;7832;25,1112280701752;272,881052631579;232;0
vpja75;5;7861;7965;46,2112280701753;218,381052631579;104;0
vpja75;5;8004;8099;-12,7887719298247;208,781052631579;95;2,55e+08
vpja75;5;8133;8315;-11,9887719298248;73,1810526315788;182;2,55e+08
vpja75;5;8369;8546;-141,488771929825;-150,518947368421;177;255000
vpja75;5;8567;8994;-153,588771929825;-166,418947368421;427;255000
vpja75;5;9128;9262;465,711228070175;292,881052631579;134;255
vpja75;5;9509;9597;513,811228070175;244,981052631579;88;255
vpja75;5;9632;9984;410,711228070175;379,581052631579;352;0
vpja75;6;182;262;-10,6;-186,2;80;2,55e+08
vpja75;6;303;699;-18,4;-282,2;396;255000
vpja75;6;758;930;-327,3;52,9;172;255
vpja75;6;954;989;-337,8;94,1;35;255
vpja75;6;1053;1533;295,5;134,3;480;0
vpja75;6;1554;1716;269,1;142,4;162;255255000
vpja75;6;1781;1904;7,30000000000007;-238,5;123;255000
vpja75;6;1930;2213;-22,4;-283,8;283;255000
vpja75;6;2221;2672;-28,6999999999999;-284;451;255000
vpja75;6;2826;2941;-293,5;90,9;115;255
vpja75;6;2967;3298;-331,8;98,4;331;255
vpja75;6;3536;3615;357,3;116,9;79;0
vpja75;6;3649;3753;304,4;135,4;104;0
vpja75;6;3796;4011;576,3;29;215;0
vpja75;6;4055;4106;549,2;-235,3;51;0
vpja75;6;4187;4273;66,3000000000001;-292,3;86;0
vpja75;6;4311;4556;-20,4;-277,7;245;255000
vpja75;6;4575;4829;-26,6999999999999;-288,5;254;255000
vpja75;6;4843;5429;-5,5;-282,4;586;255000
vpja75;6;5454;5654;-24,6;-277,5;200;255000
vpja75;6;5670;5866;-5,19999999999993;-276,7;196;255000
vpja75;6;5918;6154;-27,1;-102,4;236;2,55e+08
vpja75;6;6177;6371;11,9;-111,4;194;2,55e+08
vpja75;6;6398;6612;71,4;-84,7;214;2,55e+08
vpja75;6;6652;6904;2,30000000000007;-256,7;252;255000
vpja75;6;6924;7217;-20,1999999999999;-277,1;293;255000
vpja75;6;7229;7527;-30,5;-269,2;298;255000
vpja75;6;7541;7714;-12,6;-271,4;173;255000
vpja75;6;7887;8015;-16;-238,6;128;255000
vpja75;6;8063;8185;39,9;-92,8;122;2,55e+08
vpja75;6;8244;8420;501,3;-91,2;176;0
vpja75;6;8446;8545;537,5;-59;99;0
vpja75;6;8759;8893;647,8;-27,5;134;NA
vpja75;6;9010;9142;-480,2;-23,8000000000001;132;0
vpja75;6;9189;9336;-572,7;57;147;0
vpja75;6;9356;9528;-588,3;58,8;172;0
vpja75;6;9553;9837;-542,8;41,8;284;0
vpja75;6;9852;9981;-549,8;52,8;129;0
vpja75;7;185;291;-26,8350515463918;-217,60206185567;106;255000
vpja75;7;319;512;-43,1350515463918;-300,90206185567;193;255000
vpja75;7;586;720;413,964948453608;195,29793814433;134;255
vpja75;7;744;921;440,164948453608;158,09793814433;177;255
vpja75;7;1014;1153;-428,635051546392;298,39793814433;139;255255000
vpja75;7;1181;1472;-406,435051546392;226,29793814433;291;255255000
vpja75;7;1496;1629;-385,835051546392;267,59793814433;133;255255000
vpja75;7;1748;1823;376,764948453608;210,19793814433;75;255
vpja75;7;1849;1989;440,464948453608;235,69793814433;140;255
vpja75;7;2021;2089;464,264948453608;157,29793814433;68;255
vpja75;7;2218;2358;2,16494845360819;-299,50206185567;140;255000
vpja75;7;2383;2627;-36,8350515463918;-310,60206185567;244;255000
vpja75;7;2660;2874;-6,83505154639181;-228,90206185567;214;255000
vpja75;7;2884;3014;-15,6350515463918;-234,50206185567;130;255000
vpja75;7;3041;3360;-34,7350515463918;-293,20206185567;319;255000
vpja75;7;3368;3476;-44,1350515463918;-295,30206185567;108;255000
vpja75;7;3496;3743;-14,2350515463918;-292,40206185567;247;255000
vpja75;7;3767;4078;-37,8350515463918;-310,70206185567;311;255000
vpja75;7;4099;4224;-39,4350515463917;-278,60206185567;125;255000
vpja75;7;4246;4451;-20,2350515463918;-239,20206185567;205;255000
vpja75;7;4502;4779;-25,0350515463917;-53,6020618556702;277;2,55e+08
vpja75;7;4807;4976;-25,1350515463918;-111,60206185567;169;2,55e+08
vpja75;7;5031;5210;368,964948453608;2,09793814432987;179;0
vpja75;7;5276;5530;154,264948453608;-363,70206185567;254;0
vpja75;7;5556;5857;99,2649484536083;-417,20206185567;301;0
vpja75;7;5890;5993;214,264948453608;-380,30206185567;103;0
vpja75;7;6082;6154;-377,235051546392;-252,90206185567;72;0
vpja75;7;6208;6345;-532,835051546392;-202,10206185567;137;0
vpja75;7;6414;6537;-459,335051546392;56,0979381443299;123;0
vpja75;7;6573;6786;-312,335051546392;36,0979381443299;213;0
vpja75;7;6812;6915;-251,335051546392;43,9979381443299;103;0
vpja75;7;6952;7101;28,6649484536082;80,8979381443298;149;2,55e+08
vpja75;7;7150;7345;421,264948453608;224,69793814433;195;255
vpja75;7;7373;7712;440,764948453608;162,19793814433;339;255
vpja75;7;7742;7890;449,864948453608;257,79793814433;148;255
vpja75;7;7974;8182;-386,435051546392;272,39793814433;208;255255000
vpja75;7;8212;8331;-369,935051546392;196,19793814433;119;255255000
vpja75;7;8388;8518;-72,7350515463918;105,09793814433;130;2,55e+08
vpja75;7;8586;8770;-33,0350515463917;-279,90206185567;184;255000
vpja75;7;8794;9079;-36,9350515463917;-304,10206185567;285;255000
vpja75;7;9097;9170;-20,0350515463917;-291,40206185567;73;255000
vpja75;7;9342;9549;-34,0350515463917;-175,60206185567;207;2,55e+08
vpja75;7;9596;9727;3,16494845360819;-57,3020618556701;131;2,55e+08
vpja75;7;9782;10000;-26,4350515463917;-290,00206185567;218;255000
vpja75;8;78;174;-2,16849315068475;3,96164383561643;96;0
vpja75;8;253;350;-348,768493150685;-287,438356164384;97;255000
vpja75;8;391;561;-414,468493150685;-262,938356164384;170;255000
vpja75;8;579;716;-384,968493150685;-267,138356164384;137;255000
vpja75;8;777;847;-479,668493150685;180,761643835616;70;2,55e+08
vpja75;8;897;1164;-516,768493150685;315,961643835616;267;255
vpja75;8;1238;1447;100,731506849315;199,561643835616;209;255255000
vpja75;8;1469;1933;96,2315068493151;179,561643835616;464;255255000
vpja75;8;1950;2128;124,431506849315;193,061643835616;178;255255000
vpja75;8;2151;2341;91,7315068493151;179,461643835616;190;255255000
vpja75;8;2414;2598;-362,568493150685;-234,238356164384;184;255000
vpja75;8;2625;2964;-396,268493150685;-275,638356164384;339;255000
vpja75;8;3028;3466;-591,468493150685;-266,938356164384;438;0
vpja75;8;3561;3773;253,631506849315;-58,4383561643835;212;0
vpja75;8;3832;3995;422,631506849315;-214,538356164384;163;0
vpja75;8;4012;4174;437,931506849315;-200,338356164384;162;0
vpja75;8;4201;4447;446,931506849315;-243,938356164384;246;0
vpja75;8;4528;4715;-24,7684931506848;-130,138356164384;187;0
vpja75;8;4764;4862;-48,8684931506848;-8,93835616438355;98;0
vpja75;8;4930;5127;-353,368493150685;-272,938356164384;197;255000
vpja75;8;5160;5381;-378,268493150685;-278,938356164384;221;255000
vpja75;8;5410;5863;-389,968493150685;-234,938356164384;453;255000
vpja75;8;5987;6119;-476,768493150685;366,061643835616;132;255
vpja75;8;6149;6337;-475,668493150685;290,561643835616;188;255
vpja75;8;6598;6702;-457,368493150685;271,561643835616;104;0
vpja75;8;6771;6931;-403,568493150685;-252,138356164384;160;255000
vpja75;8;6994;7217;100,831506849315;159,061643835616;223;255255000
vpja75;8;7251;7492;82,5315068493153;192,961643835616;241;255255000
vpja75;8;7518;7752;106,631506849315;181,861643835616;234;255255000
vpja75;8;7773;8038;92,5315068493153;201,061643835616;265;255255000
vpja75;8;8062;8212;55,1315068493152;206,961643835616;150;255255000
vpja75;8;8236;8606;93,1315068493152;194,661643835616;370;255255000
vpja75;8;8624;8838;82,5315068493153;223,861643835616;214;255255000
vpja75;8;8862;9159;102,531506849315;207,561643835616;297;255255000
vpja75;8;9178;9412;79,8315068493152;217,961643835616;234;255255000
vpja75;8;9431;9617;69,7315068493151;189,261643835616;186;255255000
vpja75;8;9638;10000;101,131506849315;193,061643835616;362;255255000
vpja75;9;242;355;129,028057553957;-228,943165467626;113;255000
vpja75;9;362;424;148,128057553957;-241,143165467626;62;255000
vpja75;9;449;592;123,428057553957;-242,543165467626;143;255000
vpja75;9;659;897;-248,771942446043;33,356834532374;238;255
vpja75;9;922;1041;-305,371942446043;30,856834532374;119;255
vpja75;9;1101;1348;143,028057553957;-206,543165467626;247;255000
vpja75;9;1371;1899;136,428057553957;-242,843165467626;528;255000
vpja75;9;1974;2165;-271,971942446043;-243,843165467626;191;0
vpja75;9;2203;2302;-73,7719424460431;-176,343165467626;99;0
vpja75;9;2512;2539;443,128057553957;187,656834532374;27;255255000
vpja75;9;2555;2725;420,328057553957;232,356834532374;170;255255000
vpja75;9;2818;2980;-170,371942446043;101,656834532374;162;255
vpja75;9;3044;3231;370,028057553957;228,256834532374;187;255255000
vpja75;9;3467;3589;178,628057553957;-165,543165467626;122;2,55e+08
vpja75;9;3624;3761;115,628057553957;-252,243165467626;137;255000
vpja75;9;3819;4002;-42,7719424460431;-390,043165467626;183;0
vpja75;9;4023;4282;-13,8719424460431;-382,043165467626;259;0
vpja75;9;4292;4596;-0,671942446043204;-385,143165467626;304;0
vpja75;9;4622;4769;-35,2719424460431;-390,643165467626;147;0
vpja75;9;4793;4943;-2,57194244604318;-389,643165467626;150;0
vpja75;9;5000;5406;459,428057553957;-387,343165467626;406;0
vpja75;9;5426;5637;475,128057553957;-392,243165467626;211;0
vpja75;9;5667;5799;597,028057553957;-370,043165467626;132;0
vpja75;9;5878;6021;-53,7719424460431;-395,543165467626;143;0
vpja75;9;6054;6314;-24,4719424460432;-394,143165467626;260;0
vpja75;9;6328;6723;-7,97194244604316;-378,743165467626;395;0
vpja75;9;6746;6968;-28,6719424460432;-379,143165467626;222;0
vpja75;9;6988;7222;-5,27194244604311;-376,343165467626;234;0
vpja75;9;7245;7511;-24,0719424460432;-383,843165467626;266;0
vpja75;9;7526;7868;0,428057553956819;-380,843165467626;342;0
vpja75;9;7920;8147;459,828057553957;-357,443165467626;227;0
vpja75;9;8170;8459;475,328057553957;-377,243165467626;289;0
vpja75;9;8491;8825;613,728057553957;-361,843165467626;334;0
vpja75;9;8859;9222;469,928057553957;-382,543165467626;363;0
vpja75;9;9255;9447;489,928057553957;-280,843165467626;192;0
vpja75;9;9472;9650;567,228057553957;-272,443165467626;178;0
vpja75;9;9668;9893;596,228057553957;-279,743165467626;225;0
vpja75;9;9946;10000;604,828057553957;-99,8431654676259;54;0
vpja75;10;200;268;-321;-126,1;68;0
vpja75;10;315;538;-454,9;-149,4;223;255000
vpja75;10;554;693;-441,9;-147,5;139;255000
vpja75;10;750;868;6,5;71,6;118;255
vpja75;10;932;1063;-425,5;-148,5;131;255000
vpja75;10;1086;1385;-455,8;-152,3;299;255000
vpja75;10;1413;1674;-431,9;-103,8;261;255000
vpja75;10;1740;1899;-11;-385,2;159;0
vpja75;10;1929;2077;54,8;-454,7;148;0
vpja75;10;2135;2411;522,6;-331,1;276;0
vpja75;10;2577;2673;-97,3;32,5;96;0
vpja75;10;2722;3011;-272,2;36,5;289;255255000
vpja75;10;3034;3175;-289,1;74,1999999999999;141;255255000
vpja75;10;3213;3436;-10,6;59;223;255
vpja75;10;3459;3608;3,79999999999995;18,3;149;0
vpja75;10;3665;3894;-271,4;25,4;229;255255000
vpja75;10;3967;4134;-575,1;470,2;167;0
vpja75;10;4156;4273;-561,8;426,9;117;0
vpja75;10;4432;4603;0,100000000000023;-262,4;171;0
vpja75;10;4636;4731;-37,2;-247,4;95;0
vpja75;10;4783;5009;-227,2;-273,8;226;0
vpja75;10;5032;5545;-198,7;-268,9;513;0
vpja75;10;5597;5936;41,4;-412,7;339;0
vpja75;10;5964;6129;144,6;-432,3;165;0
vpja75;10;6151;6393;181,5;-427,1;242;0
vpja75;10;6443;6636;447,6;-386,7;193;0
vpja75;10;6692;6875;501,4;-188,1;183;0
vpja75;10;6901;7149;474,6;-155,1;248;0
vpja75;10;7292;7397;-399,9;-157,7;105;255000
vpja75;10;7428;7700;-430,9;-149;272;255000
vpja75;10;7721;8049;-427,6;-110,4;328;255000
vpja75;10;8070;8218;-443,9;-145,3;148;255000
vpja75;10;8273;8395;-500,4;96,3;122;2,55e+08
vpja75;10;8452;8677;-10,2;84,1999999999999;225;255
vpja75;10;8707;8826;17,7;9;119;0
vpja75;10;8866;8997;141,6;122,2;131;0
vpja75;10;9017;9387;163,2;99,4;370;0
vpja75;10;9416;9530;71,2;111,6;114;255
vpja75;10;9614;9782;-435,1;-147,2;168;255000
vpja75;10;9920;10000;-445,2;-154,4;80;255000
vpja75;11;62;159;8,69999999999993;-8,80000000000007;97;2,55e+08
vpja75;11;214;351;124,7;-128,1;137;255000
vpja75;11;384;659;164,1;-155,4;275;255000
vpja75;11;719;854;380,7;310,2;135;255
vpja75;11;883;992;305,1;360,5;109;255
vpja75;11;1056;1218;-122,4;246,3;162;255255000
vpja75;11;1256;1483;-189;259,8;227;255255000
vpja75;11;1493;1641;-202;265,2;148;255255000
vpja75;11;1668;1998;-126,9;281,9;330;255255000
vpja75;11;2015;2468;-139,9;282,9;453;255255000
vpja75;11;2486;2625;-180,3;263,1;139;255255000
vpja75;11;2647;3010;-209,8;265,3;363;255255000
vpja75;11;3048;3292;-76,9;242,3;244;255255000
vpja75;11;3318;3626;-116,8;278,6;308;255255000
vpja75;11;3795;4008;-323,5;-186,4;213;0
vpja75;11;4056;4277;-162,6;-297,7;221;0
vpja75;11;4319;4485;39,9;-278,7;166;0
vpja75;11;4508;4628;88,3000000000001;-279,7;120;0
vpja75;11;4676;4937;163,8;-147;261;255000
vpja75;11;4948;5124;164,1;-159;176;255000
vpja75;11;5176;5304;357;96,1999999999999;128;0
vpja75;11;5333;5446;444,1;146,4;113;0
vpja75;11;5655;5846;104,8;85,4;191;2,55e+08
vpja75;11;5899;6077;136,6;-147,9;178;255000
vpja75;11;6097;6579;142,5;-150,2;482;255000
vpja75;11;6611;6706;242,2;-165,4;95;0
vpja75;11;6746;7010;167,7;-153,1;264;255000
vpja75;11;7026;7291;147,4;-143,5;265;255000
vpja75;11;7473;7538;375,1;289,1;65;255
vpja75;11;7576;7731;296,1;390,3;155;255
vpja75;11;7766;7880;414,5;312,5;114;255
vpja75;11;8123;8227;-80,4;215,4;104;255255000
vpja75;11;8273;8466;-180,6;244,6;193;255255000
vpja75;11;8533;8689;131,7;-94,5;156;2,55e+08
vpja75;11;8729;9021;149;-163;292;255000
vpja75;11;9032;9334;144,2;-144,7;302;255000
vpja75;11;9393;9598;81,1999999999999;61,1999999999999;205;2,55e+08
vpja75;11;9654;9858;-138,4;-30,2;204;0
vpja75;11;9890;9974;-164,3;-56,1;84;0
vpja75;12;210;267;-34,5;-224,5;57;2,55e+08
vpja75;12;312;426;-25,9;-327,6;114;255000
vpja75;12;452;1058;-4,79999999999995;-360,4;606;255000
vpja75;12;1129;1306;-397,1;-275,2;177;0
vpja75;12;1375;1529;196;-251,4;154;0
vpja75;12;1600;1809;352,6;215,3;209;255
vpja75;12;1838;2032;391,8;301,4;194;0
vpja75;12;2091;2221;542,5;-50,5;130;0
vpja75;12;2252;2473;533,8;-151;221;0
vpja75;12;2493;2596;532,7;-177,8;103;0
vpja75;12;2659;2882;218,8;-317,3;223;0
vpja75;12;2914;3044;107,8;-294,7;130;0
vpja75;12;3074;3222;14,3;-345;148;0
vpja75;12;3291;3465;-363,4;-351;174;0
vpja75;12;3511;3785;-432,1;-263;274;0
vpja75;12;3812;4037;-510;-350,5;225;0
vpja75;12;4064;4258;-452;-298,1;194;0
vpja75;12;4316;4512;-373,9;-3,5;196;255255000
vpja75;12;4548;4717;-324,6;-19,2;169;255255000
vpja75;12;4756;4936;-43,6;73,4;180;2,55e+08
vpja75;12;4965;5339;-52,3;153,6;374;2,55e+08
vpja75;12;5405;5504;-44,9;-287,3;99;2,55e+08
vpja75;12;5543;5673;-34,9;-354,1;130;255000
vpja75;12;5684;6132;-17,5;-352,5;448;255000
vpja75;12;6186;6433;-36,7;-152;247;2,55e+08
vpja75;12;6459;6586;-23,6;-112,5;127;2,55e+08
vpja75;12;6640;6861;-48,1;-255,3;221;2,55e+08
vpja75;12;6884;7202;-67,8;-244,5;318;2,55e+08
vpja75;12;7223;7432;-33,4;-228,9;209;2,55e+08
vpja75;12;7458;7738;-68,2;-250,8;280;2,55e+08
vpja75;12;7889;8064;-13,4;-340,4;175;255000
vpja75;12;8072;8208;-1,20000000000005;-342,8;136;255000
vpja75;12;8282;8495;-17,9;0,5;213;2,55e+08
vpja75;12;8544;8699;-40,9;127,6;155;2,55e+08
vpja75;12;8722;9087;-36,6;158,1;365;2,55e+08
vpja75;12;9212;9240;360,9;177,8;28;0
vpja75;12;9456;9619;-302,9;145,6;163;255255000
vpja75;12;9657;9779;-362,9;222;122;0
vpja75;12;9857;10000;-422,1;-217,8;143;0
vpja75;13;208;283;-6,30000000000007;-185,3;75;2,55e+08
vpja75;13;327;610;-16,2;-319,7;283;255000
vpja75;13;620;834;-13,7;-304,2;214;255000
vpja75;13;888;1166;-25,4000000000001;-48,8000000000001;278;255
vpja75;13;1191;1365;-30,5;-97,3000000000001;174;255
vpja75;13;1425;1661;53,5;145,1;236;2,55e+08
vpja75;13;1760;1878;-164,4;136,2;118;0
vpja75;13;1930;2166;-211,7;-29,3000000000001;236;255255000
vpja75;13;2188;2331;-242;-48,5;143;255255000
vpja75;13;2387;2432;-238;-249,7;45;0
vpja75;13;2598;2852;-136;-285,5;254;0
vpja75;13;2903;2997;49,6999999999999;-295,2;94;0
vpja75;13;3063;3210;356,6;-118,4;147;0
vpja75;13;3247;3472;403,6;-63,2;225;0
vpja75;13;3497;3674;464;-46,3000000000001;177;0
vpja75;13;3712;3909;458,7;-222,3;197;0
vpja75;13;3932;4170;516,8;-199,9;238;0
vpja75;13;4196;4312;463,4;-291,6;116;0
vpja75;13;4424;4688;-563,4;36,8;264;0
vpja75;13;4718;4883;-476;-15;165;0
vpja75;13;4913;5126;-486,5;-15;213;0
vpja75;13;5186;5327;-186,4;332,1;141;0
vpja75;13;5381;5601;27,8;387,6;220;2,55e+08
vpja75;13;5635;5726;50,3;418;91;2,55e+08
vpja75;13;5782;5937;38,6999999999999;146,6;155;2,55e+08
vpja75;13;6002;6133;-7,10000000000002;-268,1;131;255000
vpja75;13;6159;6729;-19,9000000000001;-317,7;570;255000
vpja75;13;6785;6945;-35,5;-48,7;160;255
vpja75;13;6974;7150;-34,9000000000001;-105,6;176;255
vpja75;13;7204;7552;-17,1;-312,3;348;255000
vpja75;13;7611;8025;-32,3000000000001;-92,9000000000001;414;255
vpja75;13;8079;8227;74,3;63,4;148;2,55e+08
vpja75;13;8249;8497;72,3;41,6999999999999;248;2,55e+08
vpja75;13;8507;8704;62,5999999999999;48,6999999999999;197;2,55e+08
vpja75;13;8759;8935;45,9;275;176;2,55e+08
vpja75;13;8982;9207;51,4;402,6;225;2,55e+08
vpja75;13;9231;9368;45;431,5;137;2,55e+08
vpja75;13;9431;9615;-153;211,6;184;0
vpja75;13;9645;10000;-211,8;132,4;355;0
vpja75;14;181;367;-66;-151,2;186;255000
vpja75;14;427;555;43,3;156,3;128;0
vpja75;14;581;734;14,2;165,5;153;255
vpja75;14;746;911;2,60000000000002;168,2;165;0
vpja75;14;957;1164;-59,6;-148;207;255000
vpja75;14;1186;1490;-66,3;-172,5;304;255000
vpja75;14;1544;1639;71,0999999999999;-261,7;95;0
vpja75;14;1721;1784;-192;121,5;63;0
vpja75;14;1828;2007;-287,8;101,8;179;255255000
vpja75;14;2059;2246;-202,5;324,8;187;0
vpja75;14;2269;2329;-210,8;359,2;60;0
vpja75;14;2398;2540;-425,2;-87;142;0
vpja75;14;2601;2701;-70;-164,2;100;255000
vpja75;14;2780;3005;-439;-117,3;225;0
vpja75;14;3039;3173;-402,9;-103,3;134;0
vpja75;14;3219;3444;-375,5;-22,0999999999999;225;0
vpja75;14;3470;3661;-396,4;-13,5999999999999;191;0
vpja75;14;3673;3933;-401,4;-23,9;260;0
vpja75;14;4022;4242;31,5;-293,1;220;0
vpja75;14;4389;4528;-46,8;-154,7;139;255000
vpja75;14;4590;4983;284,9;70,8000000000001;393;0
vpja75;14;5042;5170;182,7;277,6;128;0
vpja75;14;5223;5265;23,4;218,7;42;0
vpja75;14;5439;5718;-54,7;-182,8;279;255000
vpja75;14;5731;6112;-57,2;-168;381;255000
vpja75;14;6173;6401;-89,7;58,5;228;2,55e+08
vpja75;14;6434;6592;19,6;156,3;158;0
vpja75;14;6617;7051;12,6;177;434;0
vpja75;14;7100;7410;-23,5;305,1;310;0
vpja75;14;7439;7927;-117,3;301,6;488;0
vpja75;14;7956;8071;-44,9;320,5;115;0
vpja75;14;8130;8330;-258,5;132,7;200;255255000
vpja75;14;8354;8647;-281;133,5;293;255255000
vpja75;14;8673;8969;-297,9;137,1;296;255255000
vpja75;14;8987;9240;-284,1;118,8;253;255255000
vpja75;14;9256;9398;-291,4;142,8;142;255255000
vpja75;14;9454;9735;-0,200000000000045;179,1;281;0
vpja75;14;9745;9932;-4,5;181,2;187;255
vpja75;15;193;266;-49,125;-287,225;73;2,55e+08
vpja75;15;296;557;-62,225;-399,725;261;255000
vpja75;15;571;812;-56,525;-424,225;241;255000
vpja75;15;823;1111;-35,325;-420,625;288;255000
vpja75;15;1202;1240;-45,725;-339,925;38;255000
vpja75;15;1367;1544;-50,9250000000001;-362,925;177;255000
vpja75;15;1586;1766;-46,4250000000001;-419,825;180;255000
vpja75;15;1783;2148;-21,725;-415,325;365;255000
vpja75;15;2183;2334;-42,325;-397,725;151;255000
vpja75;15;2422;2629;-421,225;250,675;207;255
vpja75;15;2681;2876;-485,925;419,175;195;0
vpja75;15;2894;3008;-460,225;424,475;114;255
vpja75;15;3211;3385;-84,825;-382,525;174;255000
vpja75;15;3414;3632;-44,025;-403,125;218;255000
vpja75;15;3650;3937;-26,9250000000001;-422,325;287;255000
vpja75;15;3988;4136;-18,625;-243,025;148;2,55e+08
vpja75;15;4187;4299;66,3749999999999;-147,825;112;2,55e+08
vpja75;15;4403;4497;-461,725;402,475;94;0
vpja75;15;4538;4666;-523,925;417,375;128;255
vpja75;15;4754;4910;377,475;371,375;156;0
vpja75;15;4960;5686;540,675;369,375;726;255255000
vpja75;15;5926;6234;582,175;301,275;308;0
vpja75;15;6323;6426;23,475;-292,825;103;2,55e+08
vpja75;15;6475;6579;-32,4250000000001;-390,225;104;255000
vpja75;15;6640;6845;-294,525;-327,325;205;0
vpja75;15;6882;7218;-44,625;-395,825;336;255000
vpja75;15;7243;7514;-23,325;-427,825;271;255000
vpja75;15;7557;7741;-25,325;-347,125;184;255000
vpja75;15;7823;7946;126,875;-154,625;123;2,55e+08
vpja75;15;8025;8126;376,775;260,875;101;0
vpja75;15;8192;8398;535,475;361,175;206;255255000
vpja75;15;8410;8584;552,775;378,475;174;255255000
vpja75;15;8604;8786;528,275;388,475;182;255255000
vpja75;15;8903;8934;-480,625;429,675;31;255
vpja75;15;8950;9003;-457,325;387,775;53;0
vpja75;15;9045;9158;-532,725;430,175;113;255
vpja75;15;9323;9490;-71,625;-357,125;167;255000
vpja75;15;9527;9684;-56,725;-407,025;157;255000
vpja75;15;9708;10000;-24,4250000000001;-431,725;292;255000
vpja75;16;196;355;-200;-189,4;159;255000
vpja75;16;380;1067;-222,2;-229,2;687;255000
vpja75;16;1084;1281;-217,5;-194,7;197;2,55e+08
vpja75;16;1333;1505;-45,1;96,3;172;255
vpja75;16;1538;1674;-53,3000000000001;30,4;136;255
vpja75;16;1704;1969;-158,8;11,5999999999999;265;2,55e+08
vpja75;16;2007;2212;-58,3000000000001;26;205;255
vpja75;16;2275;2424;-441,8;67,3;149;255255000
vpja75;16;2469;2713;-532,2;63,5999999999999;244;255255000
vpja75;16;2739;2946;-463,3;82,1999999999999;207;255255000
vpja75;16;2992;3138;-448,5;184,5;146;0
vpja75;16;3182;3365;-501;211,5;183;0
vpja75;16;3434;3611;21,5999999999999;125,8;177;0
vpja75;16;3657;3785;151,2;72,6999999999999;128;0
vpja75;16;3828;4011;399,4;-77,7;183;0
vpja75;16;4052;4183;582,2;-134,9;131;0
vpja75;16;4208;4332;616,2;-158;124;0
vpja75;16;4531;4603;42;66,5999999999999;72;0
vpja75;16;4643;4832;-34,9000000000001;47,8;189;255
vpja75;16;4860;5058;-42,3000000000001;-4;198;255
vpja75;16;5111;5277;-55,8000000000001;141,2;166;255
vpja75;16;5340;5518;-222,7;-213,5;178;255000
vpja75;16;5541;5999;-218,3;-233,5;458;255000
vpja75;16;6059;6303;-195,3;71,6999999999999;244;2,55e+08
vpja75;16;6361;6486;-208,5;-258,1;125;255000
vpja75;16;6503;6826;-209,9;-234,7;323;255000
vpja75;16;6850;7118;-208,6;-198,5;268;255000
vpja75;16;7127;7280;-220,1;-203,5;153;255000
vpja75;16;7298;7468;-228,4;-226,7;170;255000
vpja75;16;7494;7796;-228,9;-271,4;302;255000
vpja75;16;7820;8122;-228;-229,2;302;255000
vpja75;16;8157;8331;-222,7;-153,1;174;2,55e+08
vpja75;16;8356;8593;-216,5;-112,7;237;2,55e+08
vpja75;16;8624;8850;-274,9;-45;226;2,55e+08
vpja75;16;8879;8978;-185,9;-3,80000000000007;99;2,55e+08
vpja75;16;9032;9604;-223,7;-229,2;572;255000
vpja75;16;9617;9834;-214,8;-215,8;217;255000
vpja75;16;9897;10000;-217,3;57,0999999999999;103;2,55e+08
vpja75;17;186;271;-91,3833910034601;-145,193771626298;85;255000
vpja75;17;300;499;-119,68339100346;-103,793771626298;199;255000
vpja75;17;772;836;-115,18339100346;-114,693771626298;64;255000
vpja75;17;872;1144;-119,98339100346;-106,693771626298;272;255000
vpja75;17;1170;1358;-92,2833910034602;-80,3937716262976;188;255000
vpja75;17;1378;1564;-110,48339100346;-100,793771626298;186;255000
vpja75;17;1580;2018;-117,78339100346;-113,293771626298;438;255000
vpja75;17;2070;2280;119,11660899654;71,9062283737024;210;255
vpja75;17;2342;2718;-114,38339100346;-115,293771626298;376;255000
vpja75;17;2779;2949;170,51660899654;90,7062283737024;170;255
vpja75;17;3004;3156;-53,8833910034601;179,806228373702;152;0
vpja75;17;3195;3390;141,41660899654;106,906228373702;195;255
vpja75;17;3450;3586;-79,1833910034602;-108,293771626298;136;0
vpja75;17;3610;3894;-98,8833910034601;-115,593771626298;284;255000
vpja75;17;3903;4524;-113,98339100346;-104,793771626298;621;255000
vpja75;17;4541;4801;-108,88339100346;-87,6937716262976;260;2,55e+08
vpja75;17;4861;5065;-122,68339100346;-394,593771626298;204;0
vpja75;17;5125;5301;-357,58339100346;-377,693771626298;176;0
vpja75;17;5386;5612;-457,08339100346;162,606228373702;226;255255000
vpja75;17;5636;5754;-414,78339100346;153,406228373702;118;255255000
vpja75;17;5890;6106;-465,98339100346;145,706228373702;216;255255000
vpja75;17;6157;6326;-459,48339100346;315,406228373702;169;0
vpja75;17;6354;6444;-374,88339100346;255,906228373702;90;0
vpja75;17;6478;6800;-452,08339100346;158,006228373702;322;255255000
vpja75;17;6825;6880;-390,48339100346;145,306228373702;55;255255000
vpja75;17;6919;7170;-80,0833910034602;72,5062283737025;251;2,55e+08
vpja75;17;7204;7405;112,31660899654;75,4062283737024;201;255
vpja75;17;7441;7680;181,41660899654;114,406228373702;239;255
vpja75;17;7704;7854;219,21660899654;100,306228373702;150;255
vpja75;17;7873;8052;246,31660899654;106,706228373702;179;0
vpja75;17;8083;8239;172,91660899654;189,006228373702;156;0
vpja75;17;8271;8467;180,41660899654;102,206228373702;196;255
vpja75;17;8494;8660;236,71660899654;98,8062283737024;166;0
vpja75;17;8685;8862;282,61660899654;110,806228373702;177;0
vpja75;17;8892;9116;197,51660899654;108,806228373702;224;255
vpja75;17;9156;9490;344,21660899654;7,7062283737024;334;0
vpja75;17;9544;9675;141,41660899654;71,4062283737024;131;255
vpja75;17;9735;9870;-97,2833910034602;-85,5937716262976;135;255000
vpja75;17;9894;10000;-113,18339100346;-109,293771626298;106;255000
vpja75;18;9;138;7;1;129;0
vpja75;18;195;277;-139,8;-209;82;2,55e+08
vpja75;18;316;525;-219,6;-274,7;209;255000
vpja75;18;545;809;-233,4;-271,3;264;255000
vpja75;18;829;957;-217,8;-245,3;128;255000
vpja75;18;1020;1205;-209;222;185;0
vpja75;18;1229;1360;-223;186,4;131;2,55e+08
vpja75;18;1394;1635;-121,5;305;241;255
vpja75;18;1656;1757;-119,9;272,4;101;255
vpja75;18;1821;2170;-459,2;295,3;349;255255000
vpja75;18;2235;2518;-136,6;343,3;283;0
vpja75;18;2563;2672;-248,2;177,7;109;2,55e+08
vpja75;18;2707;2964;-417,7;272;257;255255000
vpja75;18;3187;3656;-221;-274,9;469;255000
vpja75;18;3704;3847;126,9;-255,6;143;0
vpja75;18;3920;4080;-202,7;-289;160;255000
vpja75;18;4110;4454;-222,8;-273,7;344;255000
vpja75;18;4464;4612;-217,4;-281,1;148;255000
vpja75;18;4635;4861;-200,3;-236,2;226;255000
vpja75;18;4887;5126;-224,4;-272,2;239;255000
vpja75;18;5152;5390;-234,4;-315;238;255000
vpja75;18;5414;5668;-215,8;-325,4;254;255000
vpja75;18;5710;6025;-218,4;-248,6;315;255000
vpja75;18;6054;6285;-217,6;-234,1;231;255000
vpja75;18;6299;6509;-211;-248,3;210;255000
vpja75;18;6534;7127;-218,6;-271,1;593;255000
vpja75;18;7157;7449;-208,1;-210,2;292;2,55e+08
vpja75;18;7480;7786;-220,3;-274,2;306;255000
vpja75;18;7815;8109;-227,2;-204;294;2,55e+08
vpja75;18;8136;8402;-206,2;-228,9;266;255000
vpja75;18;8429;8662;-214,7;-272,4;233;255000
vpja75;18;8736;8909;-126,4;309;173;255
vpja75;18;8960;9088;-214;167;128;2,55e+08
vpja75;18;9134;9379;-124,6;289,3;245;255
vpja75;18;9401;9640;-103,6;259,1;239;255
vpja75;18;9676;9847;-125,2;145;171;2,55e+08
vpja75;18;9872;10000;-97,8;170,9;128;2,55e+08
vpja75;19;211;307;34,7599290780141;-236,483687943262;96;2,55e+08
vpja75;19;334;432;43,1599290780142;-306,183687943262;98;255000
vpja75;19;520;932;48,3599290780141;-306,983687943262;412;255000
vpja75;19;1426;1586;-38,5400709219858;-12,0836879432624;160;255
vpja75;19;1629;1872;44,8599290780141;-308,083687943262;243;255000
vpja75;19;1988;2094;440,659929078014;10,2163120567376;106;0
vpja75;19;2135;2361;468,059929078014;100,016312056738;226;255255000
vpja75;19;2384;2543;450,559929078014;136,716312056738;159;255255000
vpja75;19;2571;2760;463,059929078014;80,7163120567376;189;255255000
vpja75;19;2775;2996;472,259929078014;62,2163120567376;221;255255000
vpja75;19;3027;3339;473,559929078014;125,416312056738;312;255255000
vpja75;19;3366;3675;469,159929078014;77,6163120567376;309;255255000
vpja75;19;3704;3868;462,259929078014;135,916312056738;164;255255000
vpja75;19;3896;4103;469,759929078014;78,7163120567376;207;255255000
vpja75;19;4124;4345;478,159929078014;57,0163120567377;221;255255000
vpja75;19;4373;4582;457,759929078014;121,316312056738;209;255255000
vpja75;19;4695;4864;-141,040070921986;44,9163120567376;169;255
vpja75;19;4932;5099;-438,140070921986;83,9163120567376;167;0
vpja75;19;5138;5245;-181,940070921986;80,2163120567376;107;255
vpja75;19;5296;5432;-458,540070921986;20,6163120567376;136;0
vpja75;19;5468;5627;-549,840070921986;10,8163120567376;159;0
vpja75;19;5672;5774;-204,240070921986;-76,6836879432624;102;0
vpja75;19;5822;6001;31,4599290780142;-294,983687943262;179;255000
vpja75;19;6025;6276;43,2599290780141;-323,083687943262;251;255000
vpja75;19;6293;6535;60,6599290780142;-325,083687943262;242;255000
vpja75;19;6667;6786;-143,440070921986;77,6163120567376;119;255
vpja75;19;6827;6988;-12,5400709219858;-66,1836879432624;161;2,55e+08
vpja75;19;7048;7174;49,1599290780142;-263,283687943262;126;255000
vpja75;19;7201;7503;46,1599290780142;-320,283687943262;302;255000
vpja75;19;7516;7914;59,1599290780142;-312,983687943262;398;255000
vpja75;19;7938;8613;42,1599290780142;-277,383687943262;675;255000
vpja75;19;8646;8829;79,1599290780142;-200,083687943262;183;2,55e+08
vpja75;19;8857;9010;71,7599290780141;-249,283687943262;153;2,55e+08
vpja75;19;9052;9488;48,0599290780142;-324,683687943262;436;255000
vpja75;19;9507;10000;27,0599290780142;-311,483687943262;493;255000
vpja75;20;193;366;-13,1;-263,6;173;255000
vpja75;20;392;539;3,09999999999991;-327,9;147;255000
vpja75;20;562;1051;57,6999999999999;-333,7;489;255000
vpja75;20;1077;1255;3;-309,8;178;255000
vpja75;20;1285;1650;12,6999999999999;-232,9;365;255000
vpja75;20;1678;1773;7,29999999999995;-302;95;255000
vpja75;20;1877;2000;313,6;343,7;123;255
vpja75;20;2030;2183;295,9;293,4;153;0
vpja75;20;2230;2465;34;106,5;235;2,55e+08
vpja75;20;2489;2582;67,7;113,2;93;2,55e+08
vpja75;20;2791;3185;324,9;295,3;394;0
vpja75;20;3325;3493;-482,3;317,7;168;255255000
vpja75;20;3531;3757;-485,1;387,6;226;255255000
vpja75;20;3786;4042;-481,3;301,3;256;255255000
vpja75;20;4092;4294;-425,9;187,1;202;0
vpja75;20;4416;4590;-23,7;-300;174;255000
vpja75;20;4614;4833;12;-322;219;255000
vpja75;20;4901;5093;310,4;-67,8;192;0
vpja75;20;5119;5233;299;-22,7;114;0
vpja75;20;5284;5593;549,6;67,1;309;0
vpja75;20;5607;5703;551,1;85,4;96;0
vpja75;20;5744;5910;572,2;12,2;166;0
vpja75;20;5939;6107;511,1;89,9;168;0
vpja75;20;6134;6262;451,8;103,8;128;0
vpja75;20;6289;6407;408,4;76,5;118;0
vpja75;20;6496;6637;306,7;346,8;141;0
vpja75;20;6664;6778;287,4;298,7;114;255
vpja75;20;6848;6994;-4;90,7;146;2,55e+08
vpja75;20;7032;7223;62,0999999999999;115,7;191;2,55e+08
vpja75;20;7301;7458;14,0999999999999;-262,3;157;255000
vpja75;20;7495;7813;-4,90000000000009;-331;318;255000
vpja75;20;7839;8133;44,4;-324;294;255000
vpja75;20;8181;8426;19,0999999999999;-232,7;245;255000
vpja75;20;8500;8880;-352,1;-281,1;380;0
vpja75;20;8927;9180;5,59999999999991;-285,5;253;255000
vpja75;20;9207;9398;40,0999999999999;-305,8;191;255000
vpja75;20;9423;9644;58,6999999999999;-315,9;221;255000
vpja75;20;9719;9934;232,4;189,1;215;0
vpja75;21;186;260;-18,3000000000001;-40,6999999999999;74;2,55e+08
vpja75;21;311;507;-49,9;-206,5;196;255000
vpja75;21;516;699;-52,5;-205,4;183;255000
vpja75;21;722;830;-28,7;-200,5;108;255000
vpja75;21;854;970;-41,3000000000001;-161,5;116;255000
vpja75;21;1523;1812;-332,7;84,1;289;255
vpja75;21;1843;2125;-274;179,1;282;255
vpja75;21;2155;2333;-330;112,8;178;255
vpja75;21;2354;2663;-333,7;78,8000000000001;309;255
vpja75;21;2683;3084;-310,1;92,3000000000001;401;255
vpja75;21;3175;3334;300,8;228,3;159;255255000
vpja75;21;3369;3562;373,4;220,6;193;255255000
vpja75;21;3592;3774;396,5;245,1;182;255255000
vpja75;21;3797;3972;368,8;269,1;175;255255000
vpja75;21;3995;4318;309,7;260,9;323;255255000
vpja75;21;4383;4552;-43,5;-170,9;169;255000
vpja75;21;4578;4821;-60,1;-220,5;243;255000
vpja75;21;4841;5148;-30,8000000000001;-212,1;307;255000
vpja75;21;5203;5368;-65,6;-7,69999999999993;165;2,55e+08
vpja75;21;5419;5651;-39;-195,7;232;255000
vpja75;21;5674;5885;-63,8000000000001;-215;211;255000
vpja75;21;5914;6172;-46,9;-165,8;258;255000
vpja75;21;6180;6362;-51;-158,1;182;255000
vpja75;21;6390;6586;-63,6;-208,7;196;255000
vpja75;21;6594;6713;-68,7;-213,4;119;255000
vpja75;21;6735;6972;-33;-209,4;237;255000
vpja75;21;6996;7208;-66,9;-212,9;212;255000
vpja75;21;7270;7456;-301,7;53,8000000000001;186;0
vpja75;21;7512;7680;-500,4;-4;168;0
vpja75;21;7722;7888;-371,1;149,2;166;255
vpja75;21;7916;8318;-271,4;171,3;402;255
vpja75;21;8353;8525;-302,1;87,8000000000001;172;255
vpja75;21;8886;8988;-69,4;-142;102;255000
vpja75;21;9029;9275;-63,8000000000001;-218,6;246;255000
vpja75;21;9284;9519;-73,6;-213,5;235;255000
vpja75;21;9538;9584;-52,9;-206;46;255000
vpja75;21;9638;9806;-276,7;-210,7;168;0
vpja75;21;9864;10000;-437,5;-32,8;136;0
vpja75;22;185;279;-163,848638132296;-238,152529182879;94;0
vpja75;22;306;552;-223,148638132296;-241,452529182879;246;255000
vpja75;22;563;1387;-232,748638132296;-251,052529182879;824;255000
vpja75;22;1440;1506;-251,748638132296;-79,4525291828794;66;2,55e+08
vpja75;22;1565;1740;255,051361867704;18,7474708171205;175;255
vpja75;22;1767;2001;313,351361867704;12,2474708171205;234;255
vpja75;22;2076;2249;-222,348638132296;173,847470817121;173;255255000
vpja75;22;2273;2455;-236,948638132296;135,847470817121;182;255255000
vpja75;22;2474;2760;-238,448638132296;162,347470817121;286;255255000
vpja75;22;2819;2960;-71,9486381322957;-214,152529182879;141;0
vpja75;22;2993;3154;43,2513618677042;-256,952529182879;161;0
vpja75;22;3209;3522;-171,148638132296;-270,352529182879;313;0
vpja75;22;3588;3702;-554,848638132296;-215,052529182879;114;0
vpja75;22;3733;3925;-576,248638132296;-320,052529182879;192;0
vpja75;22;3953;4029;-503,048638132296;-389,952529182879;76;0
vpja75;22;4197;4243;581,551361867704;-249,352529182879;46;0
vpja75;22;4415;4625;587,651361867704;-196,052529182879;210;0
vpja75;22;4654;4939;637,751361867704;-280,752529182879;285;0
vpja75;22;4991;5138;560,351361867704;-179,352529182879;147;0
vpja75;22;5234;5443;-240,648638132296;-240,052529182879;209;255000
vpja75;22;5466;5643;-230,448638132296;-249,152529182879;177;255000
vpja75;22;5670;5814;-168,248638132296;-275,552529182879;144;0
vpja75;22;5852;6046;-210,048638132296;-264,952529182879;194;255000
vpja75;22;6070;6692;-222,448638132296;-253,752529182879;622;255000
vpja75;22;6750;6947;-149,248638132296;-67,9525291828794;197;0
vpja75;22;6979;7129;-267,748638132296;-161,452529182879;150;2,55e+08
vpja75;22;7157;7343;-239,948638132296;-247,252529182879;186;255000
vpja75;22;7394;7612;-295,248638132296;-76,9525291828794;218;2,55e+08
vpja75;22;7660;7997;-242,948638132296;-244,852529182879;337;255000
vpja75;22;8018;8282;-234,148638132296;-264,252529182879;264;255000
vpja75;22;8312;8753;-313,048638132296;-280,052529182879;441;255000
vpja75;22;8782;9107;-226,648638132296;-243,852529182879;325;255000
vpja75;22;9136;9319;-184,148638132296;-287,652529182879;183;0
vpja75;22;9347;9587;-226,248638132296;-257,552529182879;240;255000
vpja75;22;9654;9966;-527,148638132296;-370,452529182879;312;0
vpja75;23;200;304;-69,260569105691;-173,478455284553;104;255000
vpja75;23;330;521;-97,3605691056911;-202,578455284553;191;255000
vpja75;23;529;750;-100,760569105691;-216,378455284553;221;255000
vpja75;23;1239;1392;-92,060569105691;-189,978455284553;153;255000
vpja75;23;1417;1669;-104,060569105691;-228,778455284553;252;255000
vpja75;23;1903;2061;-269,660569105691;104,921544715447;158;255
vpja75;23;2229;2254;-305,560569105691;90,0215447154471;25;0
vpja75;23;2320;2350;-303,860569105691;90,6215447154472;30;0
vpja75;23;2520;2774;95,3394308943089;82,9215447154472;254;255255000
vpja75;23;2800;2990;144,639430894309;50,3215447154472;190;0
vpja75;23;3013;3305;113,439430894309;86,2215447154472;292;0
vpja75;23;3318;3612;109,839430894309;70,2215447154472;294;255255000
vpja75;23;4343;4409;-104,660569105691;-180,178455284553;66;255000
vpja75;23;4530;4644;-93,060569105691;-223,078455284553;114;255000
vpja75;23;4700;4837;336,639430894309;-110,378455284553;137;0
vpja75;23;4863;5137;370,839430894309;-74,9784552845529;274;0
vpja75;23;5188;5316;607,339430894309;-53,8784552845528;128;0
vpja75;23;5366;5558;630,239430894309;-210,078455284553;192;0
vpja75;23;5584;5769;618,939430894309;-266,278455284553;185;0
vpja75;23;5778;6152;631,339430894309;-275,078455284553;374;0
vpja75;23;6265;6326;616,639430894309;154,021544715447;61;0
vpja75;23;6345;6407;605,639430894309;200,321544715447;62;0
vpja75;23;6452;6676;616,739430894309;321,021544715447;224;0
vpja75;23;6811;6943;-78,3605691056911;-159,578455284553;132;255000
vpja75;23;6969;7249;-85,4605691056911;-205,778455284553;280;255000
vpja75;23;7262;7878;-93,060569105691;-210,878455284553;616;255000
vpja75;23;7897;8109;-109,760569105691;-214,578455284553;212;255000
vpja75;23;8125;8407;-93,060569105691;-210,278455284553;282;255000
vpja75;23;8431;8624;-108,860569105691;-212,578455284553;193;255000
vpja75;23;8645;8853;-81,3605691056911;-211,378455284553;208;255000
vpja75;23;8875;9235;-96,8605691056911;-205,778455284553;360;255000
vpja75;23;9252;9466;-83,4605691056911;-191,878455284553;214;255000
vpja75;23;9482;9553;-90,060569105691;-206,478455284553;71;255000
vpja75;23;9668;9870;-98,060569105691;-195,778455284553;202;255000
vpja75;23;9935;10000;65,6394308943089;79,2215447154472;65;255255000
vpja75;24;67;176;-5,80000000000007;2,90000000000009;109;0
vpja75;24;228;347;-87,3000000000001;-199,5;119;255000
vpja75;24;373;635;-56,7;-256,4;262;255000
vpja75;24;662;1005;-61,4000000000001;-204,1;343;255000
vpja75;24;1087;1222;165,5;175,6;135;255
vpja75;24;1244;1470;191,3;159,8;226;255
vpja75;24;1527;1785;-49,9000000000001;-62,9;258;2,55e+08
vpja75;24;1834;2013;172,3;143,3;179;255
vpja75;24;2037;2203;211,2;165,1;166;255
vpja75;24;2268;2468;-193,7;236,8;200;255255000
vpja75;24;2488;2861;-181;255,7;373;255255000
vpja75;24;2917;3018;-128,3;-149,2;101;2,55e+08
vpja75;24;3050;3177;-85,6;-272,2;127;255000
vpja75;24;3203;3464;-36,6;-271,8;261;255000
vpja75;24;3496;3763;-55,8000000000001;-198,6;267;255000
vpja75;24;3803;4124;-46,7;-259,3;321;255000
vpja75;24;4181;4385;-69,2;-44,3;204;2,55e+08
vpja75;24;4414;4561;-130;-109,8;147;2,55e+08
vpja75;24;4591;4733;-100,6;-27,6999999999999;142;2,55e+08
vpja75;24;4753;5063;-82,5;-46,3;310;2,55e+08
vpja75;24;5211;5435;-537,9;-238;224;0
vpja75;24;5486;5624;-597,7;-141;138;0
vpja75;24;5672;5954;-590,5;-242,6;282;0
vpja75;24;5981;6254;-572,7;-325,4;273;0
vpja75;24;6277;6455;-558,8;-360,4;178;0
vpja75;24;6713;6886;189,6;195,9;173;0
vpja75;24;6939;7063;216,7;89,8000000000001;124;0
vpja75;24;7113;7294;342,5;-135;181;0
vpja75;24;7340;7508;357,5;-234,8;168;0
vpja75;24;7560;7720;448,5;-64,5;160;0
vpja75;24;7801;8253;-51,8000000000001;-251;452;255000
vpja75;24;8286;8448;-63,6;-200,4;162;255000
vpja75;24;8475;8695;-46,1;-245,1;220;255000
vpja75;24;8724;9308;-58,1;-183,2;584;255000
vpja75;24;9341;9697;-162,9;-241,7;356;255000
vpja75;24;9724;9824;-198;-265;100;255000
vpja75;24;9856;10000;-95,4000000000001;-335,1;144;255000
vpja75;25;192;312;43,7985915492956;-46,6042253521126;120;255000
vpja75;25;338;889;78,1985915492955;-45,4042253521126;551;255000
vpja75;25;899;1150;72,6985915492955;-54,0042253521126;251;255000
vpja75;25;1158;1258;83,1985915492955;-53,0042253521126;100;255000
vpja75;25;1307;1541;315,398591549296;95,8957746478874;234;255
vpja75;25;1566;1771;311,398591549296;62,8957746478874;205;0
vpja75;25;1796;2142;319,398591549296;99,8957746478874;346;255
vpja75;25;2202;2357;99,6985915492955;160,495774647887;155;2,55e+08
vpja75;25;2393;2646;40,8985915492956;164,695774647887;253;0
vpja75;25;2665;2839;36,3985915492956;176,895774647887;174;255255000
vpja75;25;2869;3011;98,4985915492955;169,995774647887;142;255255000
vpja75;25;3108;3259;72,9985915492955;-55,2042253521126;151;255000
vpja75;25;3278;3415;85,7985915492957;-57,6042253521126;137;255000
vpja75;25;3464;3666;267,498591549295;64,9957746478874;202;255
vpja75;25;3722;3903;69,0985915492956;-55,3042253521126;181;255000
vpja75;25;3916;4288;80,2985915492957;-51,8042253521126;372;255000
vpja75;25;4345;4531;282,498591549295;69,4957746478874;186;255
vpja75;25;4588;4759;321,298591549296;-101,004225352113;171;0
vpja75;25;4803;4978;407,298591549296;-161,404225352113;175;0
vpja75;25;5000;5043;423,698591549296;-186,104225352113;43;0
vpja75;25;5071;5351;353,598591549296;-191,804225352113;280;0
vpja75;25;5362;5489;350,198591549296;-171,804225352113;127;0
vpja75;25;5518;5753;435,298591549296;-173,304225352113;235;0
vpja75;25;5825;5955;-11,5014084507044;-179,304225352113;130;0
vpja75;25;6037;6158;-499,601408450704;113,695774647887;121;0
vpja75;25;6200;6512;-556,401408450704;161,895774647887;312;0
vpja75;25;6560;6640;-531,601408450704;295,695774647887;80;0
vpja75;25;6699;6829;-362,101408450704;156,995774647887;130;0
vpja75;25;6882;6991;-308,301408450704;-24,2042253521126;109;0
vpja75;25;7041;7202;-317,101408450704;-327,004225352113;161;0
vpja75;25;7228;7419;-325,101408450704;-397,804225352113;191;0
vpja75;25;7443;7685;-311,101408450704;-422,004225352113;242;0
vpja75;25;7768;8035;527,998591549295;-398,604225352113;267;0
vpja75;25;8082;8237;547,198591549296;-290,104225352113;155;0
vpja75;25;8419;8639;22,1985915492955;-196,304225352113;220;0
vpja75;25;8690;8804;73,5985915492956;-48,9042253521126;114;255000
vpja75;25;8821;9025;86,6985915492955;-49,9042253521126;204;255000
vpja75;25;9035;9209;95,5985915492956;-50,6042253521126;174;0
vpja75;25;9256;9423;366,198591549296;-201,904225352113;167;0
vpja75;25;9461;9661;433,598591549296;-181,004225352113;200;0
vpja75;25;9732;9918;343,598591549296;-157,004225352113;186;0
vpja75;26;21;162;-14,0000000000001;25,1;141;2,55e+08
vpja75;26;218;317;134,1;-223,9;99;255000
vpja75;26;324;371;148,2;-232,9;47;255000
vpja75;26;399;570;133,7;-302,8;171;255000
vpja75;26;594;926;188,4;-305,8;332;255000
vpja75;26;1001;1192;193,4;296,5;191;255
vpja75;26;1217;1400;191,6;341,7;183;255
vpja75;26;1437;1717;-4,30000000000018;270,2;280;2,55e+08
vpja75;26;1763;1907;238,1;368;144;2,55e+08
vpja75;26;1941;2108;199,8;328,4;167;255
vpja75;26;2149;2379;460,3;291,8;230;0
vpja75;26;2459;2695;195,4;319,2;236;255
vpja75;26;2749;2849;30,3999999999999;228;100;2,55e+08
vpja75;26;2927;3162;-358,1;294,5;235;255255000
vpja75;26;3192;3340;-290,4;394,9;148;0
vpja75;26;3373;3561;-74,5000000000001;437,9;188;0
vpja75;26;3598;3927;52,4999999999999;389,6;329;0
vpja75;26;3972;4141;231,7;373,5;169;255
vpja75;26;4202;4238;98,4999999999999;115,5;36;2,55e+08
vpja75;26;4300;4479;-119,2;-151,3;179;0
vpja75;26;4509;4711;-78,7000000000002;-256,5;202;0
vpja75;26;4779;4893;-438,7;-239;114;0
vpja75;26;4919;5169;-502,6;-293,2;250;0
vpja75;26;5208;5361;-411,6;-175,3;153;0
vpja75;26;5417;5619;81,5999999999998;-290,7;202;255000
vpja75;26;5645;5883;118,9;-307;238;255000
vpja75;26;5918;6085;178,9;-284,1;167;255000
vpja75;26;6114;6298;165,6;-241,5;184;255000
vpja75;26;6363;6508;304,7;63,6;145;2,55e+08
vpja75;26;6554;6721;190,6;-0,299999999999955;167;2,55e+08
vpja75;26;6751;6923;160,9;-91,7;172;2,55e+08
vpja75;26;6976;7164;145,4;-306,8;188;255000
vpja75;26;7189;7626;124;-314,8;437;255000
vpja75;26;7680;7839;-7,30000000000018;-290,8;159;0
vpja75;26;7891;8244;154;-306,1;353;255000
vpja75;26;8273;8626;162,6;-237,1;353;255000
vpja75;26;8655;8849;136,3;-305,6;194;255000
vpja75;26;8872;9032;186,4;-314,6;160;255000
vpja75;26;9109;9349;170;324,6;240;255
vpja75;26;9367;9514;187,5;316,6;147;255
vpja75;26;9539;9699;151;313,4;160;255
vpja75;26;9723;9982;132,3;314,6;259;255
