vp;trial;timest;timeend;x;y;duration;roi
vpja85;1;289;416;83,1999999999999;-225,2;127;255000
vpja85;1;438;818;102,1;-257,8;380;255000
vpja85;1;860;984;222,6;-110,5;124;0
vpja85;1;1027;1214;80,6999999999999;-248,5;187;255000
vpja85;1;1267;1479;366,5;128;212;255
vpja85;1;1538;1702;85,8000000000001;-215,8;164;255000
vpja85;1;1724;1812;48,5;-228,9;88;255000
vpja85;1;1890;2081;-440,7;195,6;191;255255000
vpja85;1;2118;2342;-446,5;7,39999999999998;224;0
vpja85;1;2368;2549;-393;-58,8;181;0
vpja85;1;2593;2721;-495,7;8,39999999999998;128;0
vpja85;1;2773;3015;-593,6;-302,2;242;0
vpja85;1;3069;3326;-369,7;-100,7;257;0
vpja85;1;3340;3485;-376;-79,8;145;0
vpja85;1;3532;3685;-382,6;-363,1;153;0
vpja85;1;3715;3840;-275,7;-412,5;125;0
vpja85;1;3893;4156;143,9;-257,2;263;255000
vpja85;1;4174;4290;110,7;-252,7;116;255000
vpja85;1;4434;4523;357,9;8,80000000000007;89;0
vpja85;1;4552;4799;379,3;94,3000000000001;247;255
vpja85;1;4824;4973;313,9;126,6;149;255
vpja85;1;5003;5294;407,4;192,6;291;255
vpja85;1;5317;5741;351,9;187,2;424;255
vpja85;1;5768;5906;381,3;251,7;138;255
vpja85;1;5955;6112;386,4;-45,6;157;0
vpja85;1;6136;6200;336,3;-63,4;64;0
vpja85;1;6241;6462;117;1,60000000000002;221;2,55e+08
vpja85;1;6495;6643;3,39999999999998;25,1;148;2,55e+08
vpja85;1;6700;6885;-383;185,7;185;255255000
vpja85;1;6925;7052;-424,3;44,1;127;0
vpja85;1;7092;7344;-373,8;-119,7;252;0
vpja85;1;7430;7676;539,2;-85,1;246;0
vpja85;1;7719;8165;567,1;-244,6;446;0
vpja85;1;8183;8530;536,3;-231,7;347;0
vpja85;1;8566;8717;547,3;-389,9;151;0
vpja85;1;8760;8843;339,4;-260;83;0
vpja85;1;8895;9047;614;-446,7;152;0
vpja85;1;9068;9282;628,2;-465,8;214;0
vpja85;1;9294;9411;607,9;-456,7;117;0
vpja85;1;9548;9760;-242,6;-464,9;212;0
vpja85;1;9787;10000;-318,3;-432,2;213;0
vpja85;2;272;542;-286,6;-175,5;270;255000
vpja85;2;559;741;-286,8;-208,7;182;255000
vpja85;2;755;905;-285,4;-229,3;150;255000
vpja85;2;979;1387;104,7;272,5;408;255
vpja85;2;1466;1703;-464,3;340,6;237;255255000
vpja85;2;1787;2001;166,7;299,2;214;255
vpja85;2;2026;2329;101,3;296,5;303;255
vpja85;2;2350;2520;140,7;298,2;170;255
vpja85;2;2570;2722;278,2;245,2;152;0
vpja85;2;2808;2966;-461,1;410,7;158;255255000
vpja85;2;2988;3168;-489,7;392,8;180;255255000
vpja85;2;3434;3557;-292,4;-143;123;255000
vpja85;2;3583;3805;-301,6;-201,9;222;255000
vpja85;2;3824;4265;-277,5;-221,7;441;255000
vpja85;2;4312;4604;-552,8;-175,5;292;0
vpja85;2;4630;4743;-587,5;-122,7;113;0
vpja85;2;4804;5101;-215,1;-278,3;297;255000
vpja85;2;5139;5486;-298,3;-216,2;347;255000
vpja85;2;5530;5849;-535,1;-178,4;319;0
vpja85;2;5871;5974;-570,4;-200,7;103;0
vpja85;2;6104;6162;-179,7;-341,5;58;0
vpja85;2;6239;6420;439;-263,6;181;0
vpja85;2;6458;6608;574,5;-123,3;150;0
vpja85;2;6628;6908;597,5;-101,3;280;0
vpja85;2;6947;7125;449,9;16,4;178;0
vpja85;2;7156;7465;431,3;137,7;309;0
vpja85;2;7483;7695;465,9;149;212;0
vpja85;2;7709;7926;440,5;140,5;217;0
vpja85;2;7964;8084;376,9;42;120;0
vpja85;2;8128;8350;325,6;-240,6;222;0
vpja85;2;8386;8519;192,8;-287,8;133;0
vpja85;2;8578;9066;-201,1;-349,1;488;0
vpja85;2;9087;9245;-162,9;-371,1;158;0
vpja85;2;9273;9410;-219,2;-319,7;137;0
vpja85;2;9449;9625;-353,1;-416,1;176;255000
vpja85;2;9674;9859;-494,6;-265,6;185;0
vpja85;2;9888;10000;-527,4;-192,1;112;0
vpja85;3;221;384;106,4;-256;163;255000
vpja85;3;406;665;109,2;-298,8;259;255000
vpja85;3;678;867;134,5;-301,8;189;255000
vpja85;3;902;1083;31,5;-249,6;181;255000
vpja85;3;1116;1327;122,1;-281,2;211;255000
vpja85;3;1397;1551;-334,3;-40,2;154;0
vpja85;3;1593;1705;-434,7;122,6;112;255255000
vpja85;3;1748;1969;-436,4;270,1;221;255255000
vpja85;3;1983;2347;-427;253,3;364;255255000
vpja85;3;2355;2550;-434,7;250;195;255255000
vpja85;3;2619;2905;-259,4;-160,1;286;0
vpja85;3;2928;3234;-277,7;-138,2;306;0
vpja85;3;3283;3351;-148,2;113,2;68;0
vpja85;3;3391;3542;43,3000000000001;135,7;151;2,55e+08
vpja85;3;3594;3853;-235,2;200,2;259;0
vpja85;3;3930;4231;351;346;301;255
vpja85;3;4412;4480;327;637,3;68;NA
vpja85;3;4502;4526;385,3;547,3;24;NA
vpja85;3;4557;4764;431,7;288;207;0
vpja85;3;4794;5047;498,6;207,4;253;0
vpja85;3;5080;5289;363,6;168,8;209;2,55e+08
vpja85;3;5339;5524;305;350,5;185;255
vpja85;3;5562;5736;375,5;184,8;174;2,55e+08
vpja85;3;5794;5891;164,9;-104,8;97;2,55e+08
vpja85;3;5932;6103;127,2;-265;171;255000
vpja85;3;6120;6510;132,8;-298,9;390;255000
vpja85;3;6580;6908;-218,2;-214,1;328;0
vpja85;3;7131;7329;-252,7;24,5;198;0
vpja85;3;7354;7624;-278,5;49,1999999999999;270;0
vpja85;3;7661;7848;-283,3;157,3;187;0
vpja85;3;7880;8035;-280,1;61,1;155;0
vpja85;3;8047;8294;-275,9;49,6999999999999;247;0
vpja85;3;8326;8483;-361;92,3;157;0
vpja85;3;8517;8729;-428,4;212,8;212;255255000
vpja85;3;8750;8979;-417,8;262,3;229;255255000
vpja85;3;8993;9518;-435,6;280,4;525;255255000
vpja85;3;9539;9754;-473,5;279,7;215;255255000
vpja85;3;9768;9920;-488,9;268,2;152;255255000
vpja85;3;9955;10000;-444;122,3;45;255255000
vpja85;4;243;359;-24,8;-233,3;116;255000
vpja85;4;377;621;-23,1;-264,3;244;255000
vpja85;4;634;745;-3,5;-261,6;111;255000
vpja85;4;807;911;326,6;165,7;104;255
vpja85;4;934;1110;341,6;207,9;176;255
vpja85;4;1159;1252;23,1;164,2;93;2,55e+08
vpja85;4;1298;1652;323;199,2;354;255
vpja85;4;1667;1846;348,9;211,6;179;255
vpja85;4;1936;2078;-358,1;215,8;142;255255000
vpja85;4;2143;2283;-13,8;-232,8;140;255000
vpja85;4;2304;2452;-11,6999999999999;-267,8;148;255000
vpja85;4;2470;2793;14,4;-273,6;323;255000
vpja85;4;2811;3053;-13,3;-277,4;242;255000
vpja85;4;3144;3287;353;220;143;255
vpja85;4;3353;3544;11;-249;191;255000
vpja85;4;3562;3870;-3,19999999999993;-267,3;308;255000
vpja85;4;3883;4050;14,8000000000001;-263,5;167;255000
vpja85;4;4261;4404;-366,5;123,7;143;255255000
vpja85;4;4442;4631;-348,4;192,2;189;255255000
vpja85;4;4657;4990;-398,2;249;333;255255000
vpja85;4;5001;5199;-385,1;258,2;198;255255000
vpja85;4;5221;5401;-358,9;209,4;180;255255000
vpja85;4;5426;5616;-393,6;253;190;255255000
vpja85;4;5639;5760;-410,4;284;121;255255000
vpja85;4;5819;5999;-542,2;-130,3;180;0
vpja85;4;6040;6149;-530;35;109;0
vpja85;4;6220;6469;52,7;-373,3;249;0
vpja85;4;6504;6614;182,3;-349,2;110;0
vpja85;4;6654;7260;347,3;-327,8;606;0
vpja85;4;7269;7486;358,2;-314,6;217;0
vpja85;4;7504;7745;332,5;-291,7;241;0
vpja85;4;7767;7941;287,8;-291,7;174;0
vpja85;4;7968;8061;362,5;-305;93;0
vpja85;4;8111;8369;519,2;-3,29999999999995;258;0
vpja85;4;8395;8617;615,2;-21,4;222;0
vpja85;4;8661;8855;540;135,1;194;0
vpja85;4;8889;9142;502,2;265,9;253;0
vpja85;4;9180;9399;350,7;257,2;219;255
vpja85;4;9421;9642;341,8;214,7;221;255
vpja85;4;9667;9867;274,8;189,3;200;0
vpja85;4;9917;10000;0,5;84,7;83;2,55e+08
vpja85;5;219;300;-7,448797250859;-214,954295532646;81;2,55e+08
vpja85;5;330;469;-10,3487972508591;-314,554295532646;139;255000
vpja85;5;621;701;84,1512027491409;-115,854295532646;80;2,55e+08
vpja85;5;732;939;-10,7487972508591;10,045704467354;207;2,55e+08
vpja85;5;994;1097;19,851202749141;296,545704467354;103;2,55e+08
vpja85;5;1141;1308;38,051202749141;429,345704467354;167;2,55e+08
vpja85;5;1319;1609;28,351202749141;438,945704467354;290;2,55e+08
vpja85;5;1676;1821;479,751202749141;8,54570446735397;145;0
vpja85;5;1847;2095;410,951202749141;-27,6542955326461;248;0
vpja85;5;2136;2261;305,751202749141;-149,954295532646;125;0
vpja85;5;2335;2477;-245,148797250859;24,145704467354;142;255255000
vpja85;5;2509;2650;-103,448797250859;6,84570446735393;141;2,55e+08
vpja85;5;2675;2804;-49,448797250859;-37,454295532646;129;255
vpja85;5;2856;3042;-7,84879725085909;-298,254295532646;186;255000
vpja85;5;3088;3214;-177,348797250859;-61,954295532646;126;0
vpja85;5;3254;3380;-65,548797250859;-75,354295532646;126;255
vpja85;5;3426;3608;-1,84879725085909;-283,254295532646;182;255000
vpja85;5;3626;3802;-6,84879725085909;-302,454295532646;176;255000
vpja85;5;3839;4090;-133,148797250859;-217,054295532646;251;0
vpja85;5;4121;4433;-61,648797250859;-99,5542955326461;312;255
vpja85;5;4467;4763;-212,948797250859;-25,754295532646;296;255255000
vpja85;5;4804;4946;-52,648797250859;-53,1542955326461;142;255
vpja85;5;5016;5203;-536,448797250859;67,745704467354;187;0
vpja85;5;5229;5336;-481,548797250859;-6,15429553264607;107;0
vpja85;5;5393;5587;-224,248797250859;-248,954295532646;194;0
vpja85;5;5632;5792;-102,548797250859;-244,954295532646;160;0
vpja85;5;5825;5990;-210,148797250859;-200,054295532646;165;0
vpja85;5;6032;6184;-73,448797250859;-312,554295532646;152;0
vpja85;5;6213;6342;20,1512027491409;-317,454295532646;129;255000
vpja85;5;6391;6536;319,751202749141;-320,054295532646;145;0
vpja85;5;6588;6862;344,451202749141;-89,6542955326461;274;0
vpja85;5;6885;7103;314,551202749141;-55,454295532646;218;0
vpja85;5;7135;7440;419,751202749141;-68,5542955326461;305;0
vpja85;5;7457;7650;455,551202749141;-59,754295532646;193;0
vpja85;5;7674;7868;522,751202749141;-63,454295532646;194;0
vpja85;5;7908;8100;488,851202749141;-230,454295532646;192;0
vpja85;5;8121;8296;464,451202749141;-263,654295532646;175;0
vpja85;5;8343;8557;509,651202749141;-83,1542955326461;214;0
vpja85;5;8583;8769;561,151202749141;-38,0542955326461;186;0
vpja85;5;8803;9132;410,751202749141;-32,0542955326461;329;0
vpja85;5;9161;9356;308,251202749141;-28,754295532646;195;0
vpja85;5;9389;9587;248,851202749141;-117,554295532646;198;0
vpja85;5;9611;9790;203,451202749141;-75,0542955326461;179;0
vpja85;5;9843;9959;362,151202749141;-257,454295532646;116;0
vpja85;6;202;370;-65,8;-220;168;255000
vpja85;6;404;499;6,89999999999998;-187,2;95;0
vpja85;6;530;634;-57,9;-273,7;104;255000
vpja85;6;688;791;179,8;101;103;0
vpja85;6;812;1022;186,5;141,2;210;255
vpja85;6;1034;1160;202,8;155,9;126;255
vpja85;6;1598;1735;-83,6;123,7;137;2,55e+08
vpja85;6;1788;2120;-55,2;-238,8;332;255000
vpja85;6;2136;2358;-62,5;-264,4;222;255000
vpja85;6;2380;2634;-69,3;-218,6;254;255000
vpja85;6;2665;3033;-135;-121,4;368;2,55e+08
vpja85;6;3071;3269;-146,4;-243,3;198;255000
vpja85;6;3282;3578;-164,3;-253,6;296;255000
vpja85;6;3611;3829;-75,5;-268,9;218;255000
vpja85;6;3846;4053;-49,7;-266,2;207;255000
vpja85;6;4207;4433;-19,6;-239,5;226;255000
vpja85;6;4457;4814;-56,6;-250,6;357;255000
vpja85;6;4874;5144;-201,2;17,9;270;2,55e+08
vpja85;6;5188;5447;-370,1;71,6;259;2,55e+08
vpja85;6;5455;5665;-379,9;73,7;210;2,55e+08
vpja85;6;5689;5894;-315,3;72,3000000000001;205;0
vpja85;6;5916;6161;-252,1;74,6;245;2,55e+08
vpja85;6;6185;6375;-180,6;76,5;190;2,55e+08
vpja85;6;6399;6751;-137,5;125,7;352;2,55e+08
vpja85;6;6772;6887;-140,2;184,1;115;0
vpja85;6;6914;7191;-196,3;248,4;277;255255000
vpja85;6;7246;7421;-457,8;291,7;175;0
vpja85;6;7497;7664;160,6;190,4;167;0
vpja85;6;7688;7882;193,8;163,1;194;255
vpja85;6;7922;8089;271,8;16,5;167;0
vpja85;6;8127;8345;179,4;128,5;218;255
vpja85;6;8360;8530;196,3;151,5;170;255
vpja85;6;8575;8731;-36,7;137;156;2,55e+08
vpja85;6;8775;9040;193,5;155;265;255
vpja85;6;9058;9367;167,3;141,1;309;255
vpja85;6;9379;9708;179,7;131,7;329;255
vpja85;6;9723;9873;193,1;149,5;150;255
vpja85;6;9932;10000;-18,4;-224,7;68;0
vpja85;7;260;365;-42;-305,8;105;2,55e+08
vpja85;7;389;672;-71,7;-357,1;283;255000
vpja85;7;736;1041;-422,4;-269;305;0
vpja85;7;1065;1158;-465,6;-268,8;93;0
vpja85;7;1232;1496;127,6;-303,4;264;0
vpja85;7;1528;1649;216,3;-272;121;0
vpja85;7;1701;2045;546,4;-174,1;344;0
vpja85;7;2110;2218;177,5;-194;108;0
vpja85;7;2304;2488;-436,5;-213,1;184;0
vpja85;7;2514;2684;-454;-271,1;170;0
vpja85;7;2720;2842;-417,2;-378,8;122;0
vpja85;7;2874;3268;-436;-482,4;394;NA
vpja85;7;3325;3478;-387,1;-250,4;153;0
vpja85;7;3545;3695;-350,4;174,2;150;255
vpja85;7;3723;3863;-403;250,3;140;255
vpja85;7;3882;4221;-428,7;264,3;339;255
vpja85;7;4286;4399;-69,1;-266,3;113;2,55e+08
vpja85;7;4439;4643;-58,5;-352,8;204;255000
vpja85;7;4651;4937;-66,3000000000001;-363,2;286;255000
vpja85;7;5011;5159;-324,4;151;148;0
vpja85;7;5228;5286;247,1;162,5;58;255255000
vpja85;7;5351;5545;-269,2;197,1;194;0
vpja85;7;5578;5768;-377;192,8;190;255
vpja85;7;5811;5968;-247,3;69,9;157;0
vpja85;7;6017;6213;-378,1;167,7;196;255
vpja85;7;6266;6384;-143,9;-94,7;118;0
vpja85;7;6425;6535;-45,7;-144,9;110;2,55e+08
vpja85;7;6583;6711;-65,3000000000001;-316,2;128;255000
vpja85;7;6734;6970;-63,1;-352,9;236;255000
vpja85;7;7006;7265;-179,5;-172,9;259;0
vpja85;7;7287;7394;-152,7;-151,5;107;0
vpja85;7;7458;7659;-372,4;224,3;201;255
vpja85;7;7684;7845;-416,5;256,6;161;255
vpja85;7;7870;8231;-395,9;202;361;255
vpja85;7;8253;8933;-427,5;188,9;680;255
vpja85;7;8954;9098;-392,8;200,7;144;255
vpja85;7;9152;9403;-382,1;-138,3;251;0
vpja85;7;9433;9629;-410,6;-202,5;196;0
vpja85;7;9668;9845;-347,6;-291,9;177;0
vpja85;7;9877;10000;-213,7;-235,1;123;0
vpja85;8;187;314;165,8;-96,6;127;255000
vpja85;8;339;486;168,5;-155;147;255000
vpja85;8;1088;1254;154,3;-144,1;166;255000
vpja85;8;1271;1469;174,8;-165;198;255000
vpja85;8;1521;1923;-148,9;-277,4;402;0
vpja85;8;1976;2110;-150,4;-126,4;134;0
vpja85;8;2149;2297;-297,7;-361;148;0
vpja85;8;2318;2638;-320,6;-399,2;320;0
vpja85;8;2664;2873;-235;-408,7;209;0
vpja85;8;2946;3144;405;-337,5;198;0
vpja85;8;3374;3478;364;86,1;104;0
vpja85;8;3529;3685;-23;210,2;156;0
vpja85;8;3717;3862;-150,7;243,7;145;255
vpja85;8;3886;4148;-204,5;256,6;262;255
vpja85;8;4173;4412;-137,5;262,8;239;255
vpja85;8;4824;4848;-132,1;318,9;24;255
vpja85;8;4873;5089;-127,7;319;216;255
vpja85;8;5540;5720;113,1;169,5;180;2,55e+08
vpja85;8;5771;5856;-86,6999999999999;239,5;85;255
vpja85;8;5949;6061;37,6;120,6;112;2,55e+08
vpja85;8;6101;6134;110,8;7,70000000000005;33;2,55e+08
vpja85;8;6190;6386;-106,4;273,3;196;255
vpja85;8;6409;6522;-151,9;296,9;113;255
vpja85;8;6581;6719;142,1;99,4000000000001;138;2,55e+08
vpja85;8;6764;6970;-116,1;270;206;255
vpja85;8;7077;7121;-145,9;251,9;44;255
vpja85;8;7373;7536;180,8;-138,1;163;255000
vpja85;8;7559;8085;176,5;-170,3;526;255000
vpja85;8;8150;8339;-89,6999999999999;208,9;189;255
vpja85;8;8365;8405;-142,9;242,4;40;255
vpja85;8;9150;9308;350;320,6;158;255255000
vpja85;8;9350;9535;567,4;437,9;185;0
vpja85;8;9558;9708;615,6;456,7;150;0
vpja85;8;9750;9890;460;171,5;140;255255000
vpja85;8;9960;10000;541,5;-332,4;40;0
vpja85;9;29;182;9,10000000000002;-3,10000000000002;153;2,55e+08
vpja85;9;236;576;19,1;-297,8;340;255000
vpja85;9;593;866;40;-312,2;273;255000
vpja85;9;944;1078;275,6;260,1;134;0
vpja85;9;1124;1456;436,3;41,4;332;0
vpja85;9;1550;1762;309,7;311,7;212;0
vpja85;9;1779;1908;333,3;348,1;129;255
vpja85;9;1960;2104;-7,70000000000005;75,1999999999999;144;2,55e+08
vpja85;9;2153;2285;10,5;-278,2;132;255000
vpja85;9;2308;2467;39,7;-320,7;159;255000
vpja85;9;2480;2675;54,8;-325,3;195;255000
vpja85;9;2729;2950;-152,3;27,8;221;2,55e+08
vpja85;9;3001;3188;65,9;91,1999999999999;187;2,55e+08
vpja85;9;3232;3455;-36,5;-62,8000000000001;223;2,55e+08
vpja85;9;3500;3907;36,3;-301,4;407;255000
vpja85;9;3955;4138;305,2;-70,4000000000001;183;0
vpja85;9;4198;4378;303,7;250,7;180;0
vpja85;9;4422;4635;463,6;97,5;213;0
vpja85;9;4666;4930;572,6;69,6999999999999;264;0
vpja85;9;4974;5116;384,5;293,9;142;0
vpja85;9;5142;5314;321,3;338,2;172;255
vpja85;9;5395;5606;-404,4;353,1;211;0
vpja85;9;5631;5816;-474,6;355,2;185;255255000
vpja85;9;5830;6033;-494,7;378,2;203;255255000
vpja85;9;6062;6252;-484,8;316,1;190;255255000
vpja85;9;6341;6548;-490,1;-211;207;0
vpja85;9;6576;6757;-388,2;-240,7;181;0
vpja85;9;6787;7045;-451,6;-346,4;258;0
vpja85;9;7085;7317;-349,6;-371,3;232;0
vpja85;9;7353;7467;-451,4;-355,8;114;0
vpja85;9;7554;7819;479;-345,2;265;0
vpja85;9;7840;7996;514,2;-355,5;156;0
vpja85;9;8029;8428;446,1;-450,3;399;0
vpja85;9;8439;8727;443,2;-459,4;288;0
vpja85;9;8781;8879;558,3;-181;98;0
vpja85;9;8927;9212;593,6;111,8;285;0
vpja85;9;9232;9447;544,4;100,9;215;0
vpja85;9;9474;9643;544,2;37,8;169;0
vpja85;9;9664;9771;558,6;-2,70000000000005;107;0
vpja85;9;9804;10000;431,8;91,6999999999999;196;0
vpja85;10;203;342;-184,631316725979;-213,951601423487;139;255000
vpja85;10;362;641;-220,231316725979;-238,351601423488;279;255000
vpja85;10;692;855;-141,331316725979;87,6483985765125;163;2,55e+08
vpja85;10;889;1051;-52,3313167259787;263,848398576513;162;2,55e+08
vpja85;10;1066;1486;-69,5313167259787;284,948398576513;420;2,55e+08
vpja85;10;1527;1911;-39,3313167259787;79,4483985765125;384;255
vpja85;10;1930;2024;-63,6313167259788;50,8483985765125;94;255
vpja85;10;2069;2271;-190,131316725979;-231,451601423487;202;255000
vpja85;10;2287;2466;-215,631316725979;-233,951601423487;179;255000
vpja85;10;2479;2866;-200,131316725979;-239,451601423487;387;255000
vpja85;10;2927;3128;-33,9313167259787;9,7483985765125;201;255
vpja85;10;3166;3291;-27,6313167259788;104,448398576513;125;255
vpja85;10;3352;3528;-477,131316725979;91,8483985765125;176;255255000
vpja85;10;3581;3668;-209,031316725979;61,3483985765125;87;2,55e+08
vpja85;10;3729;4063;-526,731316725979;67,8483985765125;334;255255000
vpja85;10;4082;4302;-555,731316725979;61,8483985765125;220;255255000
vpja85;10;4330;4543;-469,331316725979;59,7483985765125;213;255255000
vpja85;10;4567;4632;-440,831316725979;51,3483985765125;65;255255000
vpja85;10;4728;4923;618,568683274021;-115,151601423487;195;0
vpja85;10;4948;5058;611,368683274021;-154,551601423488;110;0
vpja85;10;5113;5328;300,368683274021;-83,8516014234875;215;0
vpja85;10;5357;5475;399,368683274021;-66,6516014234875;118;0
vpja85;10;5534;5768;472,268683274021;-360,951601423487;234;0
vpja85;10;5788;5907;483,868683274021;-387,451601423487;119;0
vpja85;10;5978;6175;10,5686832740213;-36,3516014234875;197;255
vpja85;10;6202;6483;-52,9313167259787;18,6483985765125;281;255
vpja85;10;6494;6929;-49,1313167259788;37,6483985765125;435;255
vpja85;10;6964;7163;39,1686832740213;6,14839857651248;199;255
vpja85;10;7186;7355;-28,3313167259787;1,44839857651255;169;255
vpja85;10;7383;7632;-90,1313167259788;-11,4516014234875;249;255
vpja85;10;7646;8107;-107,531316725979;-35,4516014234875;461;0
vpja85;10;8150;8284;-10,2313167259787;-59,3516014234875;134;255
vpja85;10;8319;8513;-85,9313167259787;22,2483985765125;194;255
vpja85;10;8562;8906;-85,9313167259787;198,048398576512;344;0
vpja85;10;8927;9162;-91,2313167259787;244,948398576513;235;0
vpja85;10;9185;9348;-47,3313167259787;266,348398576513;163;0
vpja85;10;9371;10000;-76,5313167259787;286,048398576512;629;2,55e+08
vpja85;11;225;355;-55,2;-153,9;130;255000
vpja85;11;381;528;-66,9;-197,7;147;255000
vpja85;11;589;725;2,60000000000002;134,7;136;0
vpja85;11;745;1043;-10,4;168,4;298;0
vpja85;11;1071;1142;59,5;170,6;71;255
vpja85;11;1180;1447;-127,9;293;267;0
vpja85;11;1491;1805;-24,6;121,6;314;0
vpja85;11;1828;2176;10,9;162,3;348;255
vpja85;11;2190;2547;-5,5;166,8;357;0
vpja85;11;2574;2765;-28,3;115,7;191;0
vpja85;11;2799;2849;-33,3;-24,9;50;2,55e+08
vpja85;11;2902;3084;11,5;173,3;182;255
vpja85;11;3130;3360;-31,9;56,6999999999999;230;2,55e+08
vpja85;11;3381;3561;-30,2;98,6999999999999;180;0
vpja85;11;3585;3739;-8,79999999999995;55,6;154;2,55e+08
vpja85;11;3791;3970;-50,4;-157,7;179;255000
vpja85;11;3985;4395;-54,5;-178,9;410;255000
vpja85;11;4442;4590;-26,3;24,5;148;2,55e+08
vpja85;11;4634;4767;-6,79999999999995;147,2;133;0
vpja85;11;4814;5128;-275,3;140,5;314;255255000
vpja85;11;5168;5340;-171,5;276,5;172;0
vpja85;11;5374;5560;-37,9;273,5;186;0
vpja85;11;5588;5668;-119,2;265,2;80;0
vpja85;11;5706;5870;-6;160,5;164;0
vpja85;11;5936;6147;-463,4;255,5;211;0
vpja85;11;6197;6360;-377,6;-16,4;163;0
vpja85;11;6397;6455;-396,7;-99,1;58;0
vpja85;11;6483;6739;-457,2;-132;256;0
vpja85;11;6813;7279;78,3;-314,8;466;0
vpja85;11;7356;7545;-405;-146,6;189;0
vpja85;11;7570;7797;-460,6;-138,8;227;0
vpja85;11;7825;8021;-423,9;-219,8;196;0
vpja85;11;8086;8293;19,6;-283,2;207;0
vpja85;11;8342;8614;256,9;-236,1;272;0
vpja85;11;8772;8804;533,8;628,4;32;NA
vpja85;11;8936;9238;395,8;-59,1;302;0
vpja85;11;9301;9596;30,4;150,6;295;0
vpja85;11;9617;9939;-3,70000000000005;177,4;322;255
vpja85;11;9952;10000;15;169,3;48;255
vpja85;12;18;141;13,4952876174974;-3,35146655309836;123;2,55e+08
vpja85;12;182;240;24,9952876174974;-179,251466553098;58;2,55e+08
vpja85;12;267;431;47,0952876174974;-256,851466553098;164;255000
vpja85;12;448;546;50,7952876174974;-280,251466553098;98;255000
vpja85;12;602;840;281,995287617497;132,948533446902;238;0
vpja85;12;920;1077;36,6952876174975;-279,151466553098;157;255000
vpja85;12;1099;1291;63,9952876174974;-295,251466553098;192;255000
vpja85;12;1360;1533;248,195287617497;123,748533446902;173;0
vpja85;12;1559;1665;300,895287617498;149,148533446902;106;255
vpja85;12;1736;1867;-291,804712382503;154,048533446902;131;0
vpja85;12;1953;2169;339,895287617498;152,948533446902;216;255
vpja85;12;2194;2314;287,195287617497;154,448533446902;120;255
vpja85;12;2360;2526;296,495287617497;-55,1514665530983;166;0
vpja85;12;2567;2659;292,895287617498;81,2485334469017;92;0
vpja85;12;2695;2843;300,795287617497;150,148533446902;148;255
vpja85;12;2889;3082;139,695287617497;15,2485334469017;193;2,55e+08
vpja85;12;3109;3309;56,9952876174974;-36,6514665530983;200;2,55e+08
vpja85;12;3355;3648;48,6952876174975;-289,751466553098;293;255000
vpja85;12;3686;3951;-51,9047123825026;-381,151466553098;265;0
vpja85;12;3975;4149;-89,3047123825025;-429,251466553098;174;0
vpja85;12;4157;4405;-95,8047123825025;-435,551466553098;248;0
vpja85;12;4434;4614;-14,2047123825026;-407,751466553098;180;0
vpja85;12;4646;4978;-107,004712382503;-340,351466553098;332;0
vpja85;12;4998;5421;-138,604712382503;-324,851466553098;423;0
vpja85;12;5482;5641;-238,604712382503;12,2485334469017;159;0
vpja85;12;5671;6184;-325,804712382503;131,248533446902;513;255255000
vpja85;12;6204;7014;-339,204712382503;153,848533446902;810;255255000
vpja85;12;7023;7461;-317,604712382503;156,348533446902;438;255255000
vpja85;12;7472;7996;-332,704712382503;159,548533446902;524;255255000
vpja85;12;8079;8312;470,995287617497;267,048533446902;233;0
vpja85;12;8343;8575;541,295287617497;377,848533446902;232;0
vpja85;12;8622;8767;317,595287617497;171,748533446902;145;255
vpja85;12;8809;8954;369,595287617497;-47,3514665530984;145;0
vpja85;12;8999;9128;323,595287617497;-233,751466553098;129;0
vpja85;12;9160;9336;304,795287617497;-332,551466553098;176;0
vpja85;12;9361;9545;292,495287617497;-404,851466553098;184;0
vpja85;12;9552;9772;293,895287617498;-416,151466553098;220;0
vpja85;12;9812;9973;128,595287617497;-336,051466553098;161;0
vpja85;13;186;331;-234,2;-117,7;145;255000
vpja85;13;352;458;-274,1;-148,8;106;255000
vpja85;13;839;1039;287,3;-47,6999999999999;200;0
vpja85;13;1088;1233;24,3;116,9;145;0
vpja85;13;1301;1452;-551,2;34,2;151;0
vpja85;13;1502;1681;-252,8;-102,4;179;255000
vpja85;13;1704;1927;-257,2;-138,7;223;255000
vpja85;13;1977;2105;-459,5;-220,6;128;0
vpja85;13;2379;2588;-143,9;164;209;0
vpja85;13;2615;2850;-170,6;96,4;235;2,55e+08
vpja85;13;2901;3112;-110,4;211,6;211;0
vpja85;13;3165;3405;127,7;173,6;240;0
vpja85;13;3445;4105;-29,2;250,4;660;0
vpja85;13;4120;4309;-55,4;246,7;189;255
vpja85;13;4361;4537;249,6;83,6;176;255255000
vpja85;13;4592;4896;-72,4;200;304;0
vpja85;13;5108;5239;-250,3;-12,1;131;2,55e+08
vpja85;13;5267;5507;-274,2;-130,9;240;255000
vpja85;13;5530;5794;-237,9;-141;264;255000
vpja85;13;5811;6021;-266,9;-134,4;210;255000
vpja85;13;6058;6198;-393,9;-233,1;140;0
vpja85;13;6237;6438;-509,1;-346,9;201;0
vpja85;13;6529;6654;442,5;-156;125;0
vpja85;13;6682;6887;508,2;-91,5;205;0
vpja85;13;6910;7327;559;-108,9;417;0
vpja85;13;7382;7618;598,9;238,4;236;0
vpja85;13;7674;7852;319,8;17,3000000000001;178;0
vpja85;13;7881;8081;231,1;-70,5;200;0
vpja85;13;8123;8360;40,5;-100,1;237;0
vpja85;13;8397;8576;-94,9;-114,1;179;0
vpja85;13;8614;8945;-236;-136,2;331;255000
vpja85;13;8968;9267;-176,2;-132,3;299;0
vpja85;13;9301;9458;-289,4;-133,5;157;255000
vpja85;13;9504;9729;-473,7;-94;225;0
vpja85;13;9756;9876;-576;-64,1999999999999;120;0
vpja85;13;9924;10000;-275,7;-138,5;76;255000
vpja85;14;217;305;-55,6319587628865;-118,250515463918;88;255000
vpja85;14;580;772;-434,631958762886;92,6494845360825;192;0
vpja85;14;802;1017;-501,331958762887;119,949484536082;215;255
vpja85;14;1071;1238;-216,731958762887;203,449484536082;167;2,55e+08
vpja85;14;1281;1404;-408,331958762887;181,149484536082;123;255
vpja85;14;1429;1586;-463,331958762887;129,549484536082;157;255
vpja85;14;1612;2039;-537,231958762887;140,749484536082;427;255
vpja85;14;2048;2257;-551,531958762886;146,249484536082;209;255
vpja85;14;2299;2519;-468,531958762887;9,64948453608247;220;0
vpja85;14;2569;2688;-445,931958762887;128,149484536082;119;255
vpja85;14;2750;2988;-440,431958762887;-360,550515463918;238;0
vpja85;14;3016;3109;-388,631958762886;-374,650515463918;93;0
vpja85;14;3168;3386;-72,9319587628866;-405,050515463918;218;0
vpja85;14;3435;3663;77,5680412371136;-381,050515463918;228;0
vpja85;14;3717;3856;275,068041237114;-67,2505154639175;139;0
vpja85;14;3882;4004;323,668041237113;-15,4505154639176;122;0
vpja85;14;4042;4312;153,168041237113;100,149484536082;270;255255000
vpja85;14;4358;4525;-62,9319587628866;-125,550515463918;167;255000
vpja85;14;4539;4933;-74,8319587628865;-142,450515463918;394;255000
vpja85;14;4978;5211;134,768041237113;96,5494845360824;233;255255000
vpja85;14;5236;5430;197,968041237113;109,049484536082;194;255255000
vpja85;14;5447;5561;222,468041237113;115,749484536082;114;0
vpja85;14;5587;6021;146,968041237113;115,649484536082;434;255255000
vpja85;14;6041;6200;167,768041237113;95,0494845360824;159;0
vpja85;14;6224;6357;228,768041237113;110,949484536082;133;0
vpja85;14;6414;6470;542,368041237114;129,049484536082;56;0
vpja85;14;6496;6689;611,568041237114;142,049484536082;193;0
vpja85;14;6736;6917;342,068041237114;119,149484536082;181;0
vpja85;14;6945;7168;352,268041237113;32,4494845360824;223;0
vpja85;14;7189;7341;397,468041237113;59,3494845360824;152;0
vpja85;14;7386;7568;623,368041237114;-85,1505154639176;182;0
vpja85;14;7587;7733;613,868041237114;-123,250515463918;146;0
vpja85;14;7814;7977;20,4680412371134;100,249484536082;163;0
vpja85;14;8000;8024;15,7680412371135;107,349484536082;24;0
vpja85;14;8046;8089;13,5680412371134;111,349484536082;43;0
vpja85;14;8819;8924;-73,3319587628865;-87,5505154639176;105;255000
vpja85;14;8948;9204;-66,2319587628865;-129,250515463918;256;255000
vpja85;14;9550;10000;-350,231958762887;73,7494845360825;450;0
vpja85;15;217;367;122,895287617498;-245,551466553098;150;255000
vpja85;15;387;737;87,5952876174973;-264,651466553098;350;255000
vpja85;15;813;1014;-430,204712382503;81,0485334469016;201;255
vpja85;15;1066;1308;-139,704712382503;-114,351466553098;242;0
vpja85;15;1375;1658;-439,504712382503;82,9485334469017;283;255
vpja85;15;1679;1885;-418,504712382503;51,3485334469017;206;255
vpja85;15;1911;2159;-451,604712382503;9,44853344690171;248;0
vpja85;15;2202;2391;-446,104712382503;101,548533446902;189;255
vpja85;15;2410;2580;-419,204712382503;101,948533446902;170;255
vpja85;15;2934;3022;-424,204712382503;111,448533446902;88;255
vpja85;15;3072;3205;-399,904712382503;-57,6514665530983;133;0
vpja85;15;3268;3465;119,495287617497;-243,251466553098;197;255000
vpja85;15;3507;3657;-67,9047123825026;-173,451466553098;150;0
vpja85;15;3699;3874;-114,904712382503;-308,651466553098;175;0
vpja85;15;3905;4075;-123,304712382503;-404,751466553098;170;0
vpja85;15;4100;4296;-83,8047123825025;-411,151466553098;196;0
vpja85;15;4316;4474;-54,2047123825026;-409,851466553098;158;0
vpja85;15;4543;4772;520,895287617498;-384,551466553098;229;0
vpja85;15;4803;5096;403,195287617497;-402,251466553098;293;0
vpja85;15;5115;5247;396,095287617497;-370,551466553098;132;0
vpja85;15;5315;5547;-67,6047123825026;-137,351466553098;232;0
vpja85;15;5598;5714;-410,004712382503;53,8485334469017;116;255
vpja85;15;5775;5934;135,895287617498;-242,651466553098;159;255000
vpja85;15;5957;6187;103,595287617497;-258,751466553098;230;255000
vpja85;15;6249;6599;194,095287617497;-29,0514665530983;350;2,55e+08
vpja85;15;6625;6817;153,195287617497;-68,4514665530984;192;2,55e+08
vpja85;15;6862;7076;-79,5047123825026;-131,551466553098;214;0
vpja85;15;7115;7399;-204,604712382503;-133,651466553098;284;0
vpja85;15;7422;7574;-156,404712382503;-140,251466553098;152;0
vpja85;15;7627;7784;-400,704712382503;48,3485334469017;157;255
vpja85;15;7820;8119;-429,504712382503;-82,0514665530983;299;0
vpja85;15;8138;8402;-426,304712382503;-107,851466553098;264;0
vpja85;15;8424;8606;-389,804712382503;-105,651466553098;182;0
vpja85;15;8626;8814;-361,104712382503;-102,651466553098;188;0
vpja85;15;8861;9034;-184,904712382503;-122,451466553098;173;0
vpja85;15;9058;9301;-124,904712382503;-138,451466553098;243;0
vpja85;15;9324;9519;-84,6047123825026;-149,451466553098;195;0
vpja85;15;9556;9727;10,9952876174974;-193,051466553098;171;0
vpja85;15;9756;10000;-68,9047123825026;-161,151466553098;244;0
vpja85;16;203;306;-2,10000000000002;-139,9;103;255000
vpja85;16;331;563;-18,1;-199,7;232;255000
vpja85;16;959;1271;275,5;194,7;312;255255000
vpja85;16;1289;1551;239,3;195,5;262;255255000
vpja85;16;1591;1867;69;206,1;276;0
vpja85;16;2391;2567;-18,2;-167,3;176;255000
vpja85;16;2585;2797;-26;-196,5;212;255000
vpja85;16;2885;2913;49,7;109,7;28;2,55e+08
vpja85;16;2953;3121;207;173,9;168;255255000
vpja85;16;3583;3744;2,5;-179,5;161;255000
vpja85;16;3764;4164;-28,4;-202,9;400;255000
vpja85;16;4180;4308;-12,4;-199,6;128;255000
vpja85;16;4333;4529;-73,6;-191,6;196;0
vpja85;16;4585;4748;221,4;111,7;163;0
vpja85;16;4786;4896;329,1;114,8;110;0
vpja85;16;4950;5387;469,1;-107,9;437;0
vpja85;16;5549;5827;333,9;-203,6;278;0
vpja85;16;5859;6079;209,1;-234,8;220;0
vpja85;16;6133;6388;-23,7;-213,7;255;255000
vpja85;16;6425;6549;-157,1;-200,3;124;0
vpja85;16;6594;6892;-16,4;-205,2;298;255000
vpja85;16;6915;7375;-33,5;-183,4;460;255000
vpja85;16;7391;7675;-60;-181,1;284;0
vpja85;16;7701;7922;-13;-177,2;221;255000
vpja85;16;8129;8340;-59,3;-178,2;211;0
vpja85;16;8360;8765;-39,9;-194,5;405;255000
vpja85;16;8793;8967;-37;-233,9;174;255000
vpja85;16;9014;9123;201,3;-255,2;109;0
vpja85;16;9173;9512;-8,79999999999995;-220;339;255000
vpja85;16;9535;9743;-34,4;-185,4;208;255000
vpja85;16;9765;10000;-12,2;-184,9;235;255000
vpja85;17;242;347;-10,9432989690722;-257,611340206186;105;255000
vpja85;17;367;577;1,75670103092784;-278,411340206186;210;255000
vpja85;17;647;746;-388,543298969072;63,1886597938144;99;0
vpja85;17;770;1065;-371,443298969072;116,288659793814;295;255255000
vpja85;17;1115;1226;-594,143298969072;83,4886597938143;111;0
vpja85;17;1514;1675;269,956701030928;81,9886597938143;161;255
vpja85;17;1748;1900;-375,343298969072;141,488659793814;152;0
vpja85;17;1963;2135;-7,74329896907216;-273,811340206186;172;255000
vpja85;17;2153;2427;-0,84329896907218;-299,111340206186;274;255000
vpja85;17;2475;2715;59,7567010309278;-129,511340206186;240;2,55e+08
vpja85;17;2752;2817;15,3567010309278;-237,611340206186;65;255000
vpja85;17;2946;3208;319,156701030928;79,3886597938143;262;0
vpja85;17;3258;3433;561,856701030928;-1,61134020618567;175;0
vpja85;17;3494;3620;214,056701030928;88,4886597938143;126;255
vpja85;17;3646;3952;265,956701030928;84,5886597938144;306;255
vpja85;17;3988;4142;382,056701030928;53,1886597938144;154;0
vpja85;17;4171;4287;290,956701030928;85,8886597938143;116;255
vpja85;17;4339;4521;538,556701030928;-11,2113402061856;182;0
vpja85;17;4563;4698;546,456701030928;-86,7113402061856;135;0
vpja85;17;4749;4945;524,056701030928;-231,311340206186;196;0
vpja85;17;4970;5305;463,356701030928;-265,011340206186;335;0
vpja85;17;5328;5475;409,056701030928;-263,111340206186;147;0
vpja85;17;5516;5647;572,656701030928;-316,411340206186;131;0
vpja85;17;5689;5939;600,556701030928;-101,311340206186;250;0
vpja85;17;5971;6249;607,956701030928;13,2886597938144;278;0
vpja85;17;6309;6588;579,056701030928;297,088659793814;279;0
vpja85;17;6612;6789;536,856701030928;242,388659793814;177;0
vpja85;17;6839;7005;371,756701030928;505,688659793814;166;NA
vpja85;17;7019;7181;346,756701030928;491,788659793814;162;NA
vpja85;17;7230;7372;79,5567010309278;443,988659793814;142;2,55e+08
vpja85;17;7448;7621;-466,843298969072;466,888659793814;173;0
vpja85;17;7652;7825;-535,443298969072;411,188659793814;173;0
vpja85;17;7868;8048;-556,243298969072;248,388659793814;180;0
vpja85;17;8087;8240;-558,343298969072;95,3886597938143;153;0
vpja85;17;8261;8413;-607,543298969072;60,5886597938144;152;0
vpja85;17;8462;8634;-479,143298969072;-73,7113402061856;172;0
vpja85;17;8668;8739;-526,343298969072;-122,211340206186;71;0
vpja85;17;8780;8933;-605,143298969072;49,1886597938144;153;0
vpja85;17;8945;9307;-617,243298969072;54,2886597938144;362;0
vpja85;17;9340;9655;-569,543298969072;44,3886597938143;315;0
vpja85;17;9681;9947;-620,743298969072;67,6886597938144;266;0
vpja85;17;9956;10000;-619,443298969072;62,0886597938144;44;0
vpja85;18;177;313;43,9952876174974;-39,7514665530983;136;255000
vpja85;18;329;438;63,4952876174974;-72,8514665530984;109;255000
vpja85;18;699;911;54,3952876174974;185,348533446902;212;255
vpja85;18;961;1069;46,9952876174974;-40,3514665530984;108;255000
vpja85;18;1094;1225;57,5952876174974;-72,4514665530984;131;255000
vpja85;18;1274;1433;348,495287617497;-162,151466553098;159;0
vpja85;18;1448;1596;322,295287617497;-170,451466553098;148;0
vpja85;18;1642;1762;269,195287617497;10,7485334469017;120;0
vpja85;18;1812;2056;54,2952876174974;186,848533446902;244;255
vpja85;18;2079;2258;80,4952876174974;201,048533446902;179;255
vpja85;18;2299;2433;46,6952876174975;51,9485334469017;134;2,55e+08
vpja85;18;2480;2817;58,0952876174974;-61,2514665530983;337;255000
vpja85;18;2825;3049;48,7952876174974;-70,2514665530983;224;255000
vpja85;18;3077;3211;3,69528761749746;-156,151466553098;134;0
vpja85;18;3250;3504;88,5952876174973;-266,351466553098;254;0
vpja85;18;3565;3809;-277,004712382503;-282,151466553098;244;0
vpja85;18;3865;4008;-538,904712382503;68,7485334469017;143;0
vpja85;18;4043;4303;-574,804712382503;132,748533446902;260;0
vpja85;18;4339;4571;-437,504712382503;179,448533446902;232;0
vpja85;18;4814;4939;-64,0047123825026;159,648533446902;125;0
vpja85;18;5009;5127;-456,204712382503;272,348533446902;118;0
vpja85;18;5198;5342;255,195287617497;108,648533446902;144;0
vpja85;18;5370;5541;313,195287617497;81,3485334469017;171;255255000
vpja85;18;5605;5871;413,695287617497;-193,651466553098;266;0
vpja85;18;5927;6126;11,1952876174975;-181,751466553098;199;0
vpja85;18;6166;6271;105,595287617497;-142,951466553098;105;0
vpja85;18;6306;6652;-28,6047123825026;-217,151466553098;346;0
vpja85;18;6674;6911;-7,20471238250263;-209,251466553098;237;0
vpja85;18;6953;7165;127,795287617497;-233,051466553098;212;0
vpja85;18;7189;7367;174,295287617497;-200,451466553098;178;0
vpja85;18;7407;7587;347,895287617498;-186,851466553098;180;0
vpja85;18;7617;7747;426,995287617497;-194,551466553098;130;0
vpja85;18;7784;8217;523,295287617497;-302,451466553098;433;0
vpja85;18;8257;8483;419,795287617497;-197,151466553098;226;0
vpja85;18;8518;8698;523,595287617497;-204,151466553098;180;0
vpja85;18;8770;8929;364,595287617497;107,448533446902;159;0
vpja85;18;8987;9215;187,495287617497;483,348533446902;228;NA
vpja85;18;9245;9421;64,4952876174974;449,548533446902;176;0
vpja85;18;9510;9789;324,195287617497;108,748533446902;279;255255000
vpja85;18;9800;10000;311,195287617497;92,4485334469017;200;255255000
vpja85;19;206;301;-125,7;-204,7;95;255000
vpja85;19;327;511;-169,9;-270,9;184;255000
vpja85;19;565;722;-473,8;46,4;157;0
vpja85;19;759;931;-467,1;249,7;172;255
vpja85;19;1189;1209;-234,7;210,6;20;0
vpja85;19;1255;1374;-471,5;21,4;119;0
vpja85;19;1436;1543;-153,4;-219,6;107;255000
vpja85;19;1569;1741;-150,3;-257,3;172;255000
vpja85;19;1755;2046;-169,3;-260,5;291;255000
vpja85;19;2095;2316;-465,9;20,8000000000001;221;0
vpja85;19;2363;2616;-403;-253,5;253;0
vpja85;19;2661;3080;-452,5;-11,9;419;0
vpja85;19;3106;3352;-480,7;44,1;246;0
vpja85;19;3374;3505;-522,1;46,4;131;0
vpja85;19;3694;3765;-538,2;39,3000000000001;71;0
vpja85;19;3781;4067;-505,9;29,5;286;0
vpja85;19;4080;4578;-532,3;29,9;498;0
vpja85;19;4606;4771;-541,2;-22,5;165;0
vpja85;19;4829;4959;-468,9;243,7;130;255
vpja85;19;5188;5367;-419,8;355,9;179;255
vpja85;19;5574;5820;406,6;186,9;246;0
vpja85;19;5858;6171;346,9;266;313;0
vpja85;19;6184;6427;323,6;253,4;243;0
vpja85;19;6452;6689;310,2;338,4;237;0
vpja85;19;6720;6925;293,3;431;205;0
vpja85;19;6941;7322;292;459,9;381;0
vpja85;19;7345;7601;299,4;403,8;256;0
vpja85;19;7632;7858;388,1;357,4;226;0
vpja85;19;7897;8032;470,8;255,5;135;0
vpja85;19;8078;8221;465;3,30000000000007;143;0
vpja85;19;8248;8370;467,6;84;122;0
vpja85;19;8426;8612;425;-126,4;186;255255000
vpja85;19;8694;8864;296,1;-362,6;170;0
vpja85;19;8912;9307;55,8000000000001;-363,2;395;0
vpja85;19;9389;9553;-364,7;-275,7;164;0
vpja85;19;9628;9866;305,9;251,9;238;0
vpja85;19;9889;10000;317,7;229,9;111;0
vpja85;20;203;358;-226,6;-223,3;155;255000
vpja85;20;378;579;-262,7;-259,3;201;255000
vpja85;20;1234;1353;-462;280,9;119;255255000
vpja85;20;1750;1973;-451,1;290;223;255255000
vpja85;20;1986;2187;-470,5;284,8;201;255255000
vpja85;20;3325;3421;-189,7;-173;96;2,55e+08
vpja85;20;3463;3626;-246,6;-270,1;163;255000
vpja85;20;3671;3983;-15,4000000000001;-281,7;312;0
vpja85;20;3997;4119;-34,9000000000001;-280,8;122;0
vpja85;20;4162;4326;-236;-245,7;164;255000
vpja85;20;4335;4573;-243,4;-256,7;238;255000
vpja85;20;4648;4800;335,9;-14;152;0
vpja85;20;4826;4934;413,8;18,6;108;0
vpja85;20;4980;5122;235,7;-194,7;142;0
vpja85;20;5163;5469;302,4;-350,1;306;0
vpja85;20;5526;5645;429,6;-25;119;0
vpja85;20;5712;5922;-15,8000000000001;-195,5;210;0
vpja85;20;5950;6162;-106,7;-231,9;212;0
vpja85;20;6187;6567;-43;-281,4;380;0
vpja85;20;6614;6741;-279,7;-325,2;127;0
vpja85;20;6783;6977;-430,1;-375,5;194;0
vpja85;20;7024;7196;-532;-199,2;172;0
vpja85;20;7232;7421;-572,4;-47,4;189;0
vpja85;20;7477;7669;-386,1;186,5;192;0
vpja85;20;7688;7839;-361,2;191,6;151;0
vpja85;20;7881;8045;-492,8;238,4;164;0
vpja85;20;8119;8189;-543,5;-244,5;70;0
vpja85;20;8217;8435;-580,4;-383;218;0
vpja85;20;8465;8596;-467,4;-390;131;0
vpja85;20;8762;8788;349,6;51,6999999999999;26;0
vpja85;20;8797;8912;335,2;-0,399999999999977;115;0
vpja85;20;8985;9018;-353,2;314,8;33;0
vpja85;20;9157;9314;-472,6;296,8;157;255255000
vpja85;20;9399;9590;476;494,4;191;NA
vpja85;20;9602;9772;499,5;499,1;170;NA
vpja85;20;9805;9964;495,3;436,6;159;0
vpja85;21;18;155;-9,17647058823525;-4,10000000000002;137;0
vpja85;21;192;409;-84,1764705882352;-180,4;217;255000
vpja85;21;418;555;-83,6764705882352;-192,1;137;255000
vpja85;21;602;842;99,8235294117648;82,7;240;0
vpja85;21;894;1116;317,523529411765;-20,5;222;0
vpja85;21;1161;1463;101,023529411765;86,5;302;0
vpja85;21;1487;1711;62,0235294117648;111,3;224;255
vpja85;21;2003;2192;78,6235294117647;119,2;189;0
vpja85;21;2212;2470;104,723529411765;116,9;258;0
vpja85;21;3329;3477;-465,676470588235;216,2;148;0
vpja85;21;3904;3992;626,023529411765;543,1;88;NA
vpja85;21;4052;4104;567,823529411765;143;52;0
vpja85;21;4154;4295;573,723529411765;-132,7;141;0
vpja85;21;4325;4514;596,323529411765;-215,7;189;0
vpja85;21;4539;4734;593,223529411765;-262,2;195;0
vpja85;21;4783;4927;327,723529411765;-85,4;144;0
vpja85;21;4988;5148;617,223529411765;-269,8;160;0
vpja85;21;5194;5419;361,223529411765;-94,4;225;0
vpja85;21;5432;5802;343,423529411765;-97;370;0
vpja85;21;5887;6065;-104,976470588235;-190,1;178;255000
vpja85;21;6087;6230;-77,4764705882353;-205;143;255000
vpja85;21;6283;6538;-428,876470588235;-257,9;255;0
vpja85;21;6563;6770;-483,476470588235;-310,9;207;0
vpja85;21;6847;6983;298,623529411765;-103,4;136;0
vpja85;21;7008;7209;343,423529411765;-87,8;201;0
vpja85;21;7245;7411;320,323529411765;81;166;0
vpja85;21;7477;7593;-104,376470588235;173,6;116;0
vpja85;21;7670;7769;-446,876470588235;252,7;99;0
vpja85;21;7814;8000;-564,176470588235;363,2;186;0
vpja85;21;8031;8166;-449,276470588235;357,4;135;0
vpja85;21;8212;8297;-280,576470588235;141,8;85;0
vpja85;21;8340;8515;-119,776470588235;-159;175;255000
vpja85;21;8539;8755;-90,5764705882353;-206,6;216;255000
vpja85;21;8785;8931;-117,576470588235;-120,4;146;2,55e+08
vpja85;21;8949;9188;-131,176470588235;-92,2;239;2,55e+08
vpja85;21;9240;9476;117,523529411765;106,2;236;255
vpja85;21;9489;9648;141,723529411765;105,6;159;255
vpja85;21;9671;10000;88,1235294117647;102;329;255
vpja85;22;226;379;12,186301369863;-163,652054794521;153;255000
vpja85;22;1305;1424;-560,213698630137;174,547945205479;119;255255000
vpja85;22;1512;1655;48,886301369863;-122,452054794521;143;255000
vpja85;22;1680;1963;17,686301369863;-151,952054794521;283;255000
vpja85;22;2019;2250;7,58630136986301;152,647945205479;231;255
vpja85;22;2282;2483;-73,313698630137;231,647945205479;201;255
vpja85;22;2501;2813;-96,613698630137;228,347945205479;312;255
vpja85;22;2838;3054;-120,013698630137;163,947945205479;216;2,55e+08
vpja85;22;3098;3257;27,686301369863;-61,2520547945205;159;255000
vpja85;22;3290;3430;25,986301369863;92,1479452054795;140;2,55e+08
vpja85;22;3465;3700;-66,513698630137;207,847945205479;235;255
vpja85;22;3714;3961;-86,013698630137;222,347945205479;247;255
vpja85;22;4023;4236;-544,913698630137;207,947945205479;213;255255000
vpja85;22;4268;4375;-503,013698630137;150,547945205479;107;255255000
vpja85;22;4440;4595;-461,613698630137;-174,052054794521;155;0
vpja85;22;4634;4809;-355,013698630137;-140,752054794521;175;0
vpja85;22;4913;5086;-400,213698630137;77,6479452054795;173;0
vpja85;22;5144;5359;-1,01369863013701;-182,652054794521;215;255000
vpja85;22;5382;5578;34,986301369863;-157,852054794521;196;255000
vpja85;22;5617;5975;61,7863013698629;-300,352054794521;358;255000
vpja85;22;5999;6190;122,286301369863;-259,552054794521;191;255000
vpja85;22;6217;6424;55,886301369863;-180,452054794521;207;255000
vpja85;22;6475;6669;351,086301369863;-279,252054794521;194;0
vpja85;22;6682;6939;334,686301369863;-283,052054794521;257;0
vpja85;22;6960;6993;395,186301369863;-274,652054794521;33;0
vpja85;22;7175;7276;522,886301369863;-46,4520547945206;101;0
vpja85;22;7328;7584;589,886301369863;159,747945205479;256;0
vpja85;22;7599;7713;608,386301369863;148,847945205479;114;0
vpja85;22;7765;8086;607,886301369863;386,847945205479;321;0
vpja85;22;8105;8271;561,786301369863;379,647945205479;166;0
vpja85;22;8338;8475;111,086301369863;-40,1520547945206;137;2,55e+08
vpja85;22;8506;8812;48,986301369863;-147,552054794521;306;255000
vpja85;22;8822;9507;41,086301369863;-148,552054794521;685;255000
vpja85;22;9524;9782;23,486301369863;-133,352054794521;258;255000
vpja85;22;9802;10000;57,486301369863;-135,352054794521;198;255000
vpja85;23;217;307;-2,70471238250263;-217,951466553098;90;255000
vpja85;23;332;583;-23,3047123825025;-280,151466553098;251;255000
vpja85;23;637;844;-258,104712382503;133,648533446902;207;255
vpja85;23;1077;1338;-261,604712382503;-18,8514665530984;261;0
vpja85;23;1367;1651;-236,304712382503;70,7485334469017;284;255
vpja85;23;1672;2293;-237,404712382503;117,748533446902;621;255
vpja85;23;2333;2464;-290,504712382503;63,4485334469017;131;0
vpja85;23;2499;2717;-262,104712382503;-64,6514665530983;218;0
vpja85;23;2759;3022;-420,204712382503;-15,0514665530983;263;0
vpja85;23;3045;3244;-453,904712382503;-34,1514665530983;199;0
vpja85;23;3264;3487;-472,304712382503;-55,9514665530984;223;0
vpja85;23;3509;3587;-455,804712382503;-23,9514665530984;78;0
vpja85;23;3620;3761;-285,604712382503;-53,6514665530983;141;0
vpja85;23;3809;3976;-477,704712382503;74,6485334469016;167;0
vpja85;23;4072;4140;322,395287617498;153,748533446902;68;255255000
vpja85;23;4170;4320;431,895287617498;83,2485334469017;150;0
vpja85;23;4351;4727;491,995287617497;-41,1514665530983;376;0
vpja85;23;4779;4951;402,995287617497;171,548533446902;172;255255000
vpja85;23;4984;5167;306,295287617497;193,848533446902;183;255255000
vpja85;23;5198;5365;228,695287617497;171,448533446902;167;255255000
vpja85;23;5413;5584;407,495287617497;155,848533446902;171;255255000
vpja85;23;5620;5746;513,195287617497;69,4485334469017;126;0
vpja85;23;5804;6031;471,895287617498;-267,251466553098;227;0
vpja85;23;6076;6196;269,295287617497;-323,351466553098;120;0
vpja85;23;6239;6538;424,895287617498;-347,251466553098;299;0
vpja85;23;6678;6957;489,695287617497;-374,051466553098;279;0
vpja85;23;7032;7314;35,4952876174974;-380,051466553098;282;0
vpja85;23;7338;7485;15,9952876174974;-342,751466553098;147;255000
vpja85;23;7508;7696;-10,7047123825026;-396,251466553098;188;0
vpja85;23;7725;7894;-101,004712382503;-380,951466553098;169;0
vpja85;23;7926;8183;-202,604712382503;-358,151466553098;257;0
vpja85;23;8228;8447;-372,004712382503;-297,051466553098;219;0
vpja85;23;8479;8793;-458,804712382503;-285,551466553098;314;0
vpja85;23;8823;9078;-523,404712382503;-312,351466553098;255;0
vpja85;23;9100;9361;-541,004712382503;-356,751466553098;261;0
vpja85;23;9376;10000;-537,504712382503;-380,451466553098;624;0
vpja85;24;210;301;-410,2;-68,9000000000001;91;0
vpja85;24;329;630;-468,6;-159,8;301;255000
vpja85;24;683;884;-90,4;-253,7;201;0
vpja85;24;921;1078;2,60000000000002;-338,1;157;0
vpja85;24;1149;1313;41,2;21,4;164;255
vpja85;24;1336;1484;-4,10000000000002;13,6999999999999;148;255
vpja85;24;1536;1748;-262,4;98;212;255255000
vpja85;24;1795;1918;-9,89999999999998;26,6999999999999;123;0
vpja85;24;1979;2074;389,7;-67,4000000000001;95;0
vpja85;24;2137;2303;-49,8;58,0999999999999;166;0
vpja85;24;2371;2501;505,2;-98,6;130;0
vpja85;24;2672;2818;102,3;-404,8;146;0
vpja85;24;2842;3212;62,8;-434,3;370;0
vpja85;24;3232;3468;39,8;-411,1;236;0
vpja85;24;3507;3758;113,6;-424,3;251;0
vpja85;24;3803;3965;-24,9;-282,7;162;0
vpja85;24;3987;4104;-48,9;-257,1;117;0
vpja85;24;4145;4383;-211,6;-266,4;238;0
vpja85;24;4422;4713;-19,3;-249,7;291;0
vpja85;24;4764;4935;151,5;-398,2;171;0
vpja85;24;4956;5046;185,4;-414;90;0
vpja85;24;5096;5240;529,8;-359,5;144;0
vpja85;24;5268;5463;569,8;-450,8;195;0
vpja85;24;5508;5669;587,3;-182,5;161;0
vpja85;24;5689;5837;611,9;-155,2;148;0
vpja85;24;5869;6146;487,5;-155,1;277;0
vpja85;24;6197;6344;593,6;118,3;147;0
vpja85;24;6377;6565;597,5;208,7;188;0
vpja85;24;6606;6741;426,9;303,4;135;0
vpja85;24;7015;7152;-535,7;424,9;137;0
vpja85;24;7409;7573;-440,9;212,3;164;0
vpja85;24;7604;7670;-383,3;158,2;66;255255000
vpja85;24;7747;7898;-509,4;38,5999999999999;151;2,55e+08
vpja85;24;7946;8143;-470,7;-164,5;197;255000
vpja85;24;8161;8477;-457,5;-162,2;316;255000
vpja85;24;8516;8687;-478,1;-328,3;171;0
vpja85;24;8728;9017;-412,3;-456,5;289;0
vpja85;24;9030;9055;-388,5;-446,3;25;0
vpja85;24;9161;9270;-410,2;-389,3;109;0
vpja85;24;9339;9566;-253,8;110,5;227;255255000
vpja85;24;9593;9755;-344;67,3;162;0
vpja85;24;9784;9959;-266,8;-55,7;175;0
vpja85;25;200;304;144,1;-250,9;104;255000
vpja85;25;331;534;157,3;-315,1;203;255000
vpja85;25;588;999;-104;31,3;411;255255000
vpja85;25;1021;1146;-135,6;64,6999999999999;125;255255000
vpja85;25;1205;1436;355,4;110,3;231;255
vpja85;25;1455;1804;339,8;95,8;349;255
vpja85;25;1815;2034;359,9;99,1999999999999;219;255
vpja85;25;2043;2425;372,3;107,1;382;255
vpja85;25;2462;2505;257,5;100,5;43;255
vpja85;25;2554;2687;-27,1;79,9;133;0
vpja85;25;2713;3128;-105,2;72,5;415;255255000
vpja85;25;3147;3265;-73,6999999999999;76,3;118;255255000
vpja85;25;3579;3883;385,1;59,8;304;255
vpja85;25;3897;4095;398,4;64,1999999999999;198;0
vpja85;25;4161;4291;154,8;-277,8;130;255000
vpja85;25;4310;4721;152,7;-319;411;255000
vpja85;25;4732;5045;168;-319,8;313;255000
vpja85;25;5078;5291;140,8;-200,6;213;2,55e+08
vpja85;25;5312;5450;133;-243,4;138;2,55e+08
vpja85;25;5482;5647;157,8;-329;165;255000
vpja85;25;5713;5814;405,2;-20,3000000000001;101;0
vpja85;25;5840;6047;477,5;1,79999999999995;207;0
vpja85;25;6065;6234;505,3;18,1999999999999;169;0
vpja85;25;6262;6873;574,9;35,0999999999999;611;0
vpja85;25;6898;7087;461,9;26,4;189;0
vpja85;25;7101;7396;443,9;7,09999999999991;295;255
vpja85;25;7475;7770;-333,4;49,5999999999999;295;0
vpja85;25;7791;7930;-332,8;11,4;139;0
vpja85;25;7958;8273;-397;65,3;315;0
vpja85;25;8311;8724;-508,8;53,4;413;0
vpja85;25;8744;8915;-543;68,4;171;0
vpja85;25;8938;9762;-462,5;77,4;824;0
vpja85;25;9784;9963;-499,8;74,0999999999999;179;0
vpja85;26;193;277;-2,25813148788939;-261,312456747405;84;2,55e+08
vpja85;26;318;484;-34,0581314878893;-381,612456747405;166;255000
vpja85;26;559;703;-498,058131487889;278,487543252595;144;0
vpja85;26;733;877;-504,358131487889;395,387543252595;144;255
vpja85;26;957;1253;364,241868512111;353,587543252595;296;255255000
vpja85;26;1535;1685;-495,358131487889;375,787543252595;150;255
vpja85;26;1731;1898;-348,858131487889;163,087543252595;167;0
vpja85;26;1961;2083;-25,3581314878894;150,987543252595;122;2,55e+08
vpja85;26;2129;2230;186,641868512111;152,787543252595;101;0
vpja85;26;2417;2454;507,841868512111;361,987543252595;37;255255000
vpja85;26;2502;2682;514,441868512111;63,9875432525952;180;0
vpja85;26;2727;2836;514,041868512111;275,487543252595;109;0
vpja85;26;2933;3041;-429,658131487889;406,287543252595;108;0
vpja85;26;3064;3248;-484,358131487889;388,987543252595;184;0
vpja85;26;3340;3517;-438,458131487889;-184,512456747405;177;0
vpja85;26;3546;3816;-396,758131487889;-261,912456747405;270;0
vpja85;26;3850;3949;-356,458131487889;-278,212456747405;99;0
vpja85;26;3996;4232;-576,458131487889;-310,612456747405;236;0
vpja85;26;4282;4409;-469,958131487889;-156,812456747405;127;0
vpja85;26;4434;4591;-410,058131487889;-120,112456747405;157;0
vpja85;26;4607;5011;-436,458131487889;-117,912456747405;404;0
vpja85;26;5083;5314;268,741868512111;-241,012456747405;231;0
vpja85;26;5348;5534;379,241868512111;-295,712456747405;186;0
vpja85;26;5564;5693;266,341868512111;-269,412456747405;129;0
vpja85;26;5740;5900;-6,15813148788936;-417,912456747405;160;255000
vpja85;26;5922;6123;-47,6581314878894;-418,312456747405;201;255000
vpja85;26;6142;6485;-72,3581314878894;-418,012456747405;343;255000
vpja85;26;6520;6706;-212,658131487889;-340,512456747405;186;0
vpja85;26;6744;6989;-332,258131487889;-312,312456747405;245;0
vpja85;26;7016;7319;-349,958131487889;-368,212456747405;303;0
vpja85;26;7353;7504;-486,358131487889;-389,012456747405;151;0
vpja85;26;7529;7669;-556,058131487889;-431,812456747405;140;0
vpja85;26;7780;8128;546,041868512111;-143,012456747405;348;0
vpja85;26;8156;8318;605,841868512111;-97,9124567474049;162;0
vpja85;26;8356;8539;595,941868512111;-286,812456747405;183;0
vpja85;26;8561;8806;602,341868512111;-320,712456747405;245;0
vpja85;26;8837;9112;562,041868512111;-223,712456747405;275;0
vpja85;26;9147;9315;593,841868512111;-294,712456747405;168;0
vpja85;26;9365;9571;632,741868512111;-32,2124567474049;206;0
vpja85;26;9618;9794;611,241868512111;-302,612456747405;176;0
vpja85;26;9866;10000;269,641868512111;88,7875432525951;134;0
