vp;trial;timest;timeend;x;y;duration;roi
vpja32;1;181;295;-34,9;78,2;114;0
vpja32;1;339;578;-272,2;-181,5;239;255000
vpja32;1;630;726;-231,2;172,8;96;2,55e+08
vpja32;1;767;1240;-474,1;329,6;473;255255000
vpja32;1;1306;1732;156,7;283,2;426;255
vpja32;1;1814;2103;400,8;202,3;289;0
vpja32;1;2124;2209;402;100,4;85;0
vpja32;1;2283;2420;-340,5;-228,5;137;255000
vpja32;1;2454;2623;-284,2;-200,3;169;255000
vpja32;1;2663;2890;-507,4;-181;227;0
vpja32;1;2926;3141;-570,8;-115;215;0
vpja32;1;3156;3421;-590,3;-103,4;265;0
vpja32;1;3448;3713;-515,6;-166,6;265;0
vpja32;1;3720;3848;-524,5;-170,2;128;0
vpja32;1;3888;4192;-497,7;-282,5;304;0
vpja32;1;4246;4462;-199,2;-299;216;0
vpja32;1;4486;4638;-225,9;-270,5;152;255000
vpja32;1;4666;4765;-189,5;-313,1;99;0
vpja32;1;4820;5025;-478,9;-205,5;205;0
vpja32;1;5046;5281;-513,1;-190;235;0
vpja32;1;5324;5682;-262,5;-224,9;358;255000
vpja32;1;5734;6030;-491,4;-315,6;296;0
vpja32;1;6056;6351;-553,2;-299,9;295;0
vpja32;1;6396;6629;-246,4;-387,4;233;0
vpja32;1;6674;6827;-160;-349;153;0
vpja32;1;6849;6910;-187,8;-333,3;61;0
vpja32;1;7093;7195;-514,5;-134,1;102;2,55e+08
vpja32;1;7227;7378;-564,7;-118,4;151;0
vpja32;1;7424;7594;-244,5;-204,6;170;255000
vpja32;1;7670;7795;500,6;-114,9;125;0
vpja32;1;7830;8014;583;-94,6999999999999;184;0
vpja32;1;8039;8241;608,4;-127,7;202;0
vpja32;1;8259;8484;598,5;-97,8;225;0
vpja32;1;8532;8772;427,2;-203;240;0
vpja32;1;8820;9102;113,9;-310;282;0
vpja32;1;9149;9305;-218,5;-287,7;156;255000
vpja32;1;9342;9576;-272,4;-220,1;234;255000
vpja32;1;9599;9852;-238,1;-206,1;253;255000
vpja32;1;9894;10000;-254,1;-351,2;106;255000
vpja32;2;267;517;20,3096428571429;-101,847857142857;250;255000
vpja32;2;535;598;-2,29035714285715;-82,0478571428572;63;255000
vpja32;2;643;879;-78,5903571428571;215,652142857143;236;255
vpja32;2;903;1118;-56,8903571428571;171,352142857143;215;2,55e+08
vpja32;2;1141;1367;-4,0903571428571;151,652142857143;226;255
vpja32;2;1394;1950;-76,6903571428571;225,152142857143;556;255
vpja32;2;2005;2197;-538,690357142857;185,952142857143;192;255255000
vpja32;2;2217;2428;-531,890357142857;152,952142857143;211;255255000
vpja32;2;2494;2673;-29,6903571428571;-99,3478571428572;179;255000
vpja32;2;2706;3099;36,5096428571429;-113,747857142857;393;255000
vpja32;2;3121;3212;16,4096428571429;-121,247857142857;91;255000
vpja32;2;3254;3423;69,309642857143;-264,047857142857;169;255000
vpja32;2;3471;3875;323,309642857143;-254,047857142857;404;0
vpja32;2;3935;4081;-123,090357142857;-318,647857142857;146;0
vpja32;2;4102;4312;-160,290357142857;-329,547857142857;210;0
vpja32;2;4365;4501;68,7096428571429;-155,447857142857;136;255000
vpja32;2;4582;4851;-323,090357142857;61,9521428571428;269;0
vpja32;2;4929;5112;306,209642857143;229,852142857143;183;0
vpja32;2;5156;5323;501,209642857143;332,652142857143;167;0
vpja32;2;5348;5503;557,909642857143;366,252142857143;155;0
vpja32;2;5525;5817;500,509642857143;440,152142857143;292;0
vpja32;2;5897;6092;391,509642857143;-19,9478571428572;195;0
vpja32;2;6138;6303;102,909642857143;-100,947857142857;165;2,55e+08
vpja32;2;6327;6487;39,4096428571429;-125,547857142857;160;255000
vpja32;2;6504;6697;22,5096428571429;-113,947857142857;193;255000
vpja32;2;6734;6936;48,5096428571429;43,7521428571429;202;2,55e+08
vpja32;2;6959;7307;33,9096428571429;72,4521428571428;348;2,55e+08
vpja32;2;7353;7535;-60,6903571428571;235,152142857143;182;255
vpja32;2;7553;7731;-70,6903571428571;214,952142857143;178;255
vpja32;2;7783;7984;-520,190357142857;173,152142857143;201;255255000
vpja32;2;8001;8237;-546,790357142857;162,652142857143;236;255255000
vpja32;2;8291;8613;-349,890357142857;-145,847857142857;322;0
vpja32;2;8656;8814;-148,090357142857;-335,347857142857;158;0
vpja32;2;9032;9285;-176,290357142857;-334,547857142857;253;0
vpja32;2;9298;9534;-175,590357142857;-351,347857142857;236;0
vpja32;2;9726;10000;-172,090357142857;-337,147857142857;274;0
vpja32;3;452;646;-327,3;-125;194;255000
vpja32;3;659;1172;-350,5;-122,9;513;255000
vpja32;3;1228;1430;38,6999999999999;54;202;255255000
vpja32;3;1462;1939;86,3000000000001;42,1;477;255255000
vpja32;3;1957;2254;59,1;32,4000000000001;297;0
vpja32;3;2299;2474;-247,5;79,3000000000001;175;255
vpja32;3;2497;2613;-265,4;44,5;116;255
vpja32;3;2653;2795;-322,4;-175,4;142;255000
vpja32;3;2815;2972;-340,1;-149,6;157;255000
vpja32;3;2979;3170;-338;-140;191;255000
vpja32;3;3177;3357;-329,5;-129;180;255000
vpja32;3;3417;3824;-504,8;413,3;407;0
vpja32;3;3903;4054;-139,5;-142,8;151;0
vpja32;3;4087;4262;-112,5;-214;175;0
vpja32;3;4290;4502;-202,1;-237,3;212;0
vpja32;3;4520;4654;-229,1;-231,2;134;0
vpja32;3;4697;4939;87,1;-381,4;242;0
vpja32;3;4954;5200;75,4;-398,2;246;0
vpja32;3;5238;5374;169,1;-411,3;136;0
vpja32;3;5397;5662;181,1;-437,9;265;0
vpja32;3;5682;5836;179,3;-398,2;154;0
vpja32;3;5865;6064;81,8000000000001;-366,4;199;0
vpja32;3;6086;6241;49,6;-356,3;155;0
vpja32;3;6276;6538;-136,6;-220;262;0
vpja32;3;6568;6802;-97,9;-219,4;234;0
vpja32;3;6838;6991;9,79999999999995;-205,8;153;0
vpja32;3;7055;7306;538,6;-214,2;251;0
vpja32;3;7333;7498;469,5;-132,4;165;0
vpja32;3;7519;7592;440,6;-120,6;73;0
vpja32;3;7626;7844;606,7;-115,7;218;0
vpja32;3;7876;8060;449,7;-108,2;184;0
vpja32;3;8105;8274;623,7;79,7;169;0
vpja32;3;8328;8446;254,7;111,7;118;0
vpja32;3;8476;8642;109;72,3000000000001;166;255255000
vpja32;3;8673;8889;157,1;98,9000000000001;216;0
vpja32;3;8920;9053;31,4;35;133;255255000
vpja32;3;9097;9215;-259,1;66,8000000000001;118;255
vpja32;3;9253;9430;-319,3;-138,4;177;255000
vpja32;3;9443;9566;-337,1;-138;123;255000
vpja32;3;9597;9832;-198,3;-228,3;235;0
vpja32;3;9860;10000;-250,8;-125,8;140;0
vpja32;4;148;298;-47,4000000000001;-7,89999999999998;150;2,55e+08
vpja32;4;372;470;219,8;169,2;98;0
vpja32;4;500;694;259,5;213,1;194;0
vpja32;4;702;826;272,1;215,5;124;0
vpja32;4;849;1128;205,1;203,3;279;255
vpja32;4;1179;1338;-109,3;269,2;159;2,55e+08
vpja32;4;1555;1578;-173,2;318,6;23;255255000
vpja32;4;1653;1786;-125,5;-149,7;133;255000
vpja32;4;1812;2217;-73,8000000000001;-168;405;255000
vpja32;4;2242;2346;-112,9;-137,8;104;255000
vpja32;4;2400;2549;-553,2;-108,8;149;0
vpja32;4;2625;2744;245,3;179,2;119;0
vpja32;4;2774;3174;281,2;212,5;400;0
vpja32;4;3247;3417;-69,2;-146;170;255000
vpja32;4;3438;3634;-57,8000000000001;-167;196;255000
vpja32;4;3643;3807;-69,5;-170;164;255000
vpja32;4;3831;4203;-75;-116,8;372;255000
vpja32;4;4245;4604;-156,6;-26,1;359;2,55e+08
vpja32;4;4644;4963;-239,3;-157,2;319;255000
vpja32;4;4994;5140;-84,5;-186,9;146;255000
vpja32;4;5158;5407;-57,6;-182,7;249;255000
vpja32;4;5434;5588;-64;-101,5;154;2,55e+08
vpja32;4;5598;5796;-72,3000000000001;-111,3;198;255000
vpja32;4;5836;6033;189,6;-17,4;197;0
vpja32;4;6079;6199;305,8;199,1;120;0
vpja32;4;6223;6371;275,1;214,7;148;0
vpja32;4;6388;6560;292;230,5;172;0
vpja32;4;6621;6910;-155;318,4;289;255255000
vpja32;4;6953;7064;-420,2;411,3;111;0
vpja32;4;7117;7156;-420,5;413,8;39;0
vpja32;4;7220;7401;-531,7;353,8;181;0
vpja32;4;7421;7600;-565,3;349,1;179;0
vpja32;4;7654;7843;-521,9;85,3;189;0
vpja32;4;7902;8105;-562,7;-241,3;203;0
vpja32;4;8146;8208;-561,2;-390,3;62;0
vpja32;4;8274;8416;-130,8;-262,2;142;255000
vpja32;4;8464;8627;-28,6;-199,2;163;255000
vpja32;4;8653;9412;-68,8000000000001;-187,8;759;255000
vpja32;4;9436;9711;-42,3000000000001;-184,9;275;255000
vpja32;4;9777;9922;290,5;141,4;145;0
vpja32;4;9959;10000;255,4;204,4;41;0
vpja32;5;129;219;-16,1;62,5;90;0
vpja32;5;286;438;30,5;-249,3;152;255000
vpja32;5;495;675;314,2;153,7;180;255
vpja32;5;740;1053;-290,4;114,1;313;255255000
vpja32;5;1069;1467;-310,7;109,6;398;255255000
vpja32;5;1527;1690;326,8;144;163;0
vpja32;5;1996;2124;308;267,8;128;0
vpja32;5;2151;2475;328,4;257,4;324;0
vpja32;5;2490;2847;310,9;269,2;357;0
vpja32;5;2935;3314;73,9;-297;379;255000
vpja32;5;3333;3608;45,5999999999999;-290,9;275;255000
vpja32;5;3630;3784;66,1999999999999;-303,6;154;255000
vpja32;5;3824;4050;-33,8000000000001;-396,3;226;255000
vpja32;5;4069;4197;-66,2;-402,1;128;0
vpja32;5;4240;4530;170,6;-229,3;290;0
vpja32;5;4589;4703;258,6;-434,3;114;0
vpja32;5;4759;4969;-46,7;-423,3;210;0
vpja32;5;4994;5082;-87,7;-392,3;88;0
vpja32;5;5281;5350;-31,4000000000001;-369,1;69;255000
vpja32;5;5397;5738;59,6999999999999;-281,3;341;255000
vpja32;5;5763;5921;12,4;-264,8;158;255000
vpja32;5;5939;6518;-15;-259,3;579;255000
vpja32;5;6546;6946;66,5999999999999;-292,1;400;255000
vpja32;5;6967;7154;34,5999999999999;-277,6;187;255000
vpja32;5;7179;7278;59,1999999999999;-294,1;99;255000
vpja32;5;7336;7560;-231,3;74,3000000000001;224;0
vpja32;5;7591;7840;-286,8;106;249;255255000
vpja32;5;7865;8006;-251,9;111,2;141;255255000
vpja32;5;8071;8124;342,8;142,8;53;0
vpja32;5;8391;8660;316,4;256,3;269;0
vpja32;5;8725;8908;-68,2;12,2;183;2,55e+08
vpja32;5;8946;9199;44,5;-25,9;253;2,55e+08
vpja32;5;9253;9380;51,6999999999999;-198,7;127;2,55e+08
vpja32;5;9407;9689;64,1999999999999;-279,3;282;255000
vpja32;5;9706;9974;90,5999999999999;-288,6;268;255000
vpja32;6;209;515;161,595847750865;-95,655017301038;306;255000
vpja32;6;564;715;-90,0041522491351;198,044982698962;151;255
vpja32;6;740;939;-142,104152249135;227,544982698962;199;255
vpja32;6;1404;1623;267,795847750865;348,244982698962;219;255255000
vpja32;6;1657;1822;325,495847750865;403,844982698962;165;255255000
vpja32;6;1839;1963;310,195847750865;428,444982698962;124;255255000
vpja32;6;2036;2157;222,895847750865;40,3449826989621;121;2,55e+08
vpja32;6;2185;2324;177,295847750865;-68,2550173010379;139;2,55e+08
vpja32;6;2346;2618;150,595847750865;-119,755017301038;272;255000
vpja32;6;2678;2890;-122,204152249135;-277,955017301038;212;0
vpja32;6;2943;3146;-364,804152249135;-185,055017301038;203;0
vpja32;6;3182;3435;-348,604152249135;-99,455017301038;253;0
vpja32;6;3472;3710;-464,904152249135;-186,155017301038;238;0
vpja32;6;3763;4017;-156,704152249135;-172,955017301038;254;0
vpja32;6;4069;4212;176,495847750865;-71,3550173010379;143;2,55e+08
vpja32;6;4235;4453;140,295847750865;-95,455017301038;218;2,55e+08
vpja32;6;4486;4668;327,095847750865;-42,1550173010379;182;0
vpja32;6;4708;4919;400,995847750865;114,244982698962;211;0
vpja32;6;4937;5227;421,095847750865;130,544982698962;290;0
vpja32;6;5253;5342;350,495847750865;115,144982698962;89;0
vpja32;6;5390;5600;148,795847750865;-92,2550173010379;210;2,55e+08
vpja32;6;5613;5867;154,695847750865;-128,855017301038;254;255000
vpja32;6;5924;6097;-135,404152249135;-342,755017301038;173;0
vpja32;6;6137;6388;-307,704152249135;-355,155017301038;251;0
vpja32;6;6418;6585;-438,104152249135;-301,255017301038;167;0
vpja32;6;6633;6876;-560,404152249135;-66,6550173010379;243;0
vpja32;6;6940;7121;151,695847750865;-93,2550173010379;181;2,55e+08
vpja32;6;7152;7699;171,995847750865;-119,255017301038;547;255000
vpja32;6;7751;7920;-32,7041522491351;134,044982698962;169;0
vpja32;6;7957;8164;-102,904152249135;209,044982698962;207;255
vpja32;6;8189;8432;-148,604152249135;262,944982698962;243;255
vpja32;6;8498;8749;299,295847750865;411,444982698962;251;255255000
vpja32;6;8772;8986;253,995847750865;419,444982698962;214;255255000
vpja32;6;9336;9496;158,695847750865;-89,7550173010379;160;2,55e+08
vpja32;6;9513;9711;144,195847750865;-108,155017301038;198;2,55e+08
vpja32;6;9755;9944;-107,504152249135;-166,155017301038;189;0
vpja32;7;142;352;-13,6999999999999;33,1;210;255255000
vpja32;7;377;531;-54;-20;154;0
vpja32;7;585;779;336,7;48,7;194;0
vpja32;7;806;974;430;-16,0999999999999;168;0
vpja32;7;1021;1217;175,6;-292,4;196;255000
vpja32;7;1234;1586;162,6;-311,6;352;255000
vpja32;7;1599;1815;152,6;-310,4;216;255000
vpja32;7;1839;2024;134,3;-266,2;185;255000
vpja32;7;2090;2243;388,8;29,8000000000001;153;0
vpja32;7;2269;2523;445,9;-22,3;254;0
vpja32;7;2532;2659;458,8;-21,9;127;0
vpja32;7;2698;2949;334,7;36,7;251;0
vpja32;7;3018;3203;144,7;-279,8;185;255000
vpja32;7;3227;3474;164,6;-301,3;247;255000
vpja32;7;3543;3721;-234,2;-3,89999999999998;178;0
vpja32;7;3761;4062;-100;30,1;301;255255000
vpja32;7;4092;4411;-29,5;-23,0999999999999;319;255255000
vpja32;7;4433;4554;3,30000000000007;-44;121;0
vpja32;7;4603;4835;-334,1;2,90000000000009;232;0
vpja32;7;4891;5038;-520,9;-54,9;147;0
vpja32;7;5078;5186;-576,1;-183,7;108;0
vpja32;7;5256;5427;126,7;-279,2;171;255000
vpja32;7;5459;5670;163,7;-291,8;211;255000
vpja32;7;5710;5944;374,7;-67,3;234;0
vpja32;7;5982;6114;495;-58,5999999999999;132;0
vpja32;7;6175;6328;149,1;-261,1;153;255000
vpja32;7;6384;6704;-69,4;-7,79999999999995;320;255255000
vpja32;7;6739;6965;-10,1999999999999;-29,5;226;255255000
vpja32;7;6999;7130;25,9;-70,6999999999999;131;2,55e+08
vpja32;7;7177;7406;173,7;-297,5;229;255000
vpja32;7;7420;7647;157,3;-307,3;227;255000
vpja32;7;7904;7984;184,2;-255,9;80;0
vpja32;7;8054;8216;412,7;13,6;162;255
vpja32;7;8238;8394;438,5;-17,3;156;0
vpja32;7;8433;8602;329,7;40,5;169;0
vpja32;7;8631;8843;365,5;54,8000000000001;212;255
vpja32;7;8868;9032;427,2;35;164;255
vpja32;7;9098;9316;182,1;-283,5;218;0
vpja32;7;9344;9577;169,4;-306,4;233;255000
vpja32;7;9606;9784;135,8;-225,9;178;2,55e+08
vpja32;7;9805;10000;144,7;-247,5;195;255000
vpja32;8;200;268;-5,69611307420485;42,2628975265018;68;2,55e+08
vpja32;8;324;635;42,8038869257952;-249,137102473498;311;255000
vpja32;8;704;926;405,303886925795;165,762897526502;222;255
vpja32;8;951;1151;333,903886925795;164,962897526502;200;255
vpja32;8;1174;1259;315,703886925795;195,562897526502;85;255
vpja32;8;1325;1516;-226,796113074205;180,062897526502;191;255255000
vpja32;8;1546;1767;-348,496113074205;156,762897526502;221;255255000
vpja32;8;1837;2026;19,0038869257952;-128,437102473498;189;2,55e+08
vpja32;8;2073;2183;232,503886925795;-95,9371024734983;110;0
vpja32;8;2214;2369;272,003886925795;-83,8371024734982;155;0
vpja32;8;2430;2747;58,3038869257952;-283,937102473498;317;255000
vpja32;8;2767;2926;41,8038869257952;-280,937102473498;159;255000
vpja32;8;2992;3137;-244,296113074205;-218,637102473498;145;0
vpja32;8;3180;3439;-273,396113074205;-82,5371024734983;259;0
vpja32;8;3463;3644;-245,996113074205;-90,7371024734982;181;0
vpja32;8;3717;3846;349,603886925795;-108,137102473498;129;0
vpja32;8;3891;4098;513,603886925795;-91,1371024734982;207;0
vpja32;8;4156;4337;65,5038869257951;-315,137102473498;181;255000
vpja32;8;4370;4748;-23,7961130742049;-404,537102473498;378;0
vpja32;8;4797;4936;57,0038869257952;-247,537102473498;139;255000
vpja32;8;4957;5127;52,4038869257952;-271,037102473498;170;255000
vpja32;8;5141;5319;33,4038869257952;-281,237102473498;178;255000
vpja32;8;5358;5622;-71,0961130742048;-396,937102473498;264;0
vpja32;8;5646;5946;-128,096113074205;-414,537102473498;300;0
vpja32;8;6006;6225;-337,696113074205;-229,937102473498;219;0
vpja32;8;6273;6416;-482,596113074205;-84,5371024734983;143;0
vpja32;8;6466;6653;-262,396113074205;-120,337102473498;187;0
vpja32;8;6918;7097;-479,596113074205;-222,437102473498;179;0
vpja32;8;7122;7272;-507,996113074205;-255,537102473498;150;0
vpja32;8;7342;7970;50,7038869257951;-277,937102473498;628;255000
vpja32;8;7984;8367;50,6038869257952;-286,337102473498;383;255000
vpja32;8;8437;8688;369,703886925795;162,362897526502;251;255
vpja32;8;8743;8873;30,8038869257952;229,662897526502;130;0
vpja32;8;8927;9101;-205,596113074205;221,862897526502;174;255255000
vpja32;8;9175;9480;-5,29611307420487;-150,737102473498;305;2,55e+08
vpja32;8;9516;9832;74,1038869257952;-192,637102473498;316;2,55e+08
vpja32;8;9858;9986;32,7038869257951;-190,937102473498;128;2,55e+08
vpja32;9;214;317;-112,207692307692;-187,5;103;2,55e+08
vpja32;9;341;478;-180,707692307692;-203,7;137;255000
vpja32;9;494;814;-217,207692307692;-207,2;320;0
vpja32;9;871;1132;-195,107692307692;139,5;261;2,55e+08
vpja32;9;1177;1529;-441,907692307692;268,2;352;255
vpja32;9;1551;1579;-446,007692307692;274,6;28;255
vpja32;9;2184;2463;-86,9076923076923;371,9;279;255255000
vpja32;9;2480;2736;-114,507692307692;384,7;256;255255000
vpja32;9;2807;2903;333,592307692308;296,7;96;0
vpja32;9;2934;3097;363,992307692308;208,4;163;0
vpja32;9;3167;3331;173,492307692308;-131,6;164;0
vpja32;9;3356;3552;91,1923076923078;-205,7;196;0
vpja32;9;3587;3744;133,692307692308;-275,7;157;0
vpja32;9;3786;3927;310,492307692308;-334,8;141;0
vpja32;9;3983;4179;-33,6076923076922;-279,7;196;0
vpja32;9;4246;4448;-542,807692307692;-236,4;202;0
vpja32;9;4490;4684;-598,307692307692;-68,9999999999999;194;0
vpja32;9;4750;4777;-187,807692307692;-151;27;2,55e+08
vpja32;9;4830;5009;-61,4076923076923;-238,2;179;0
vpja32;9;5042;5328;-12,1076923076922;-257,1;286;0
vpja32;9;5350;5590;-3,40769230769229;-272,9;240;0
vpja32;9;5610;5962;-16,1076923076922;-234,1;352;0
vpja32;9;5985;6229;-36,4076923076923;-201,7;244;0
vpja32;9;6253;6427;-6,0076923076922;-242,1;174;0
vpja32;9;6453;6646;-7,70769230769224;-288,6;193;0
vpja32;9;6662;7023;-32,3076923076923;-272,9;361;0
vpja32;9;7048;7145;-69,3076923076923;-242,5;97;0
vpja32;9;7258;7426;-31,6076923076922;-219,2;168;0
vpja32;9;7473;7637;-236,807692307692;-191,9;164;0
vpja32;9;7660;7852;-213,807692307692;-208,8;192;0
vpja32;9;7865;8185;-212,207692307692;-220;320;255000
vpja32;9;8251;8511;-516,107692307692;300,8;260;0
vpja32;9;8594;8706;400,192307692308;394,9;112;0
vpja32;9;8750;9005;523,892307692308;526,6;255;NA
vpja32;9;9056;9292;112,692307692308;453,9;236;0
vpja32;9;9321;9483;-41,0076923076922;428,9;162;0
vpja32;9;9519;9720;-155,607692307692;386,5;201;255255000
vpja32;10;139;197;-15,4;35,1999999999999;58;2,55e+08
vpja32;10;236;360;-86,5;-149,9;124;255000
vpja32;10;383;552;-96,0999999999999;-211,5;169;255000
vpja32;10;1276;1521;104,6;51,9;245;0
vpja32;10;1566;1742;319,5;35,4;176;0
vpja32;10;1767;1949;297;-13,3000000000001;182;0
vpja32;10;1986;2187;104,8;80,3;201;255
vpja32;10;2253;2481;-110,3;-174,9;228;255000
vpja32;10;2505;2727;-87,1999999999999;-210,7;222;255000
vpja32;10;2736;2821;-96;-210,7;85;255000
vpja32;10;2888;2988;360,5;-131,5;100;0
vpja32;10;3037;3291;605,7;-227,2;254;0
vpja32;10;3315;3453;584,2;-254;138;0
vpja32;10;3531;3765;-108;-443,9;234;0
vpja32;10;3826;3963;-502,6;-394,8;137;0
vpja32;10;4042;4205;-535,2;159,7;163;0
vpja32;10;4291;4365;102,5;306,1;74;0
vpja32;10;4428;4559;528,6;411,7;131;0
vpja32;10;4594;4824;624,5;431;230;0
vpja32;10;4841;5038;597,1;443,8;197;0
vpja32;10;5098;5383;396,3;278,9;285;0
vpja32;10;5427;5458;121,1;197,3;31;0
vpja32;10;5720;5911;-122,5;-97,2;191;2,55e+08
vpja32;10;5930;6134;-101;-185,7;204;255000
vpja32;10;6142;6315;-104,4;-208,1;173;255000
vpja32;10;6377;6548;-279,2;103,9;171;0
vpja32;10;6569;6744;-300,6;90,6;175;0
vpja32;10;7144;7334;-91,1999999999999;-54,1;190;2,55e+08
vpja32;10;7374;7596;93;51,4;222;0
vpja32;10;7650;7920;-111,2;-125,7;270;2,55e+08
vpja32;10;7943;8671;-94,8;-204,1;728;255000
vpja32;10;8697;8977;4,20000000000005;-225,9;280;0
vpja32;10;9004;9164;-71,3;-230,4;160;255000
vpja32;10;9180;9325;-85,6999999999999;-223,1;145;255000
vpja32;10;9568;9765;-89,5;-203,6;197;255000
vpja32;10;9774;10000;-90,8;-208,1;226;255000
vpja32;11;292;389;-21,2474509803922;-233,01568627451;97;2,55e+08
vpja32;11;426;744;-4,74745098039216;-303,41568627451;318;2,55e+08
vpja32;11;803;985;-366,047450980392;-274,81568627451;182;0
vpja32;11;1012;1168;-422,247450980392;-284,51568627451;156;0
vpja32;11;1239;1415;136,652549019608;-272,71568627451;176;0
vpja32;11;1475;1581;373,252549019608;-132,51568627451;106;0
vpja32;11;1642;1894;393,552549019608;282,18431372549;252;0
vpja32;11;1901;2058;386,952549019608;327,38431372549;157;0
vpja32;11;2084;2245;316,552549019608;308,98431372549;161;255
vpja32;11;2331;2581;-278,247450980392;169,58431372549;250;255255000
vpja32;11;2653;2764;-67,3474509803922;-189,31568627451;111;2,55e+08
vpja32;11;2796;2942;-4,04745098039211;-305,01568627451;146;2,55e+08
vpja32;11;2952;3207;8,95254901960789;-298,41568627451;255;255000
vpja32;11;3267;3507;-349,947450980392;-312,41568627451;240;0
vpja32;11;3542;3782;-209,047450980392;-342,51568627451;240;0
vpja32;11;3822;3864;-34,9474509803922;-288,61568627451;42;2,55e+08
vpja32;11;4092;4149;36,8525490196079;-270,71568627451;57;0
vpja32;11;4208;4446;473,752549019608;-156,71568627451;238;0
vpja32;11;4475;4613;479,952549019608;-93,7156862745098;138;0
vpja32;11;4648;4943;390,052549019608;-73,6156862745098;295;0
vpja32;11;4966;5271;411,052549019608;-59,7156862745098;305;0
vpja32;11;5320;5565;143,552549019608;-101,11568627451;245;0
vpja32;11;5611;6053;92,7525490196078;-216,61568627451;442;0
vpja32;11;6086;6316;-7,74745098039216;-311,71568627451;230;255000
vpja32;11;6380;6552;-432,747450980392;-360,51568627451;172;0
vpja32;11;6580;6791;-503,147450980392;-387,91568627451;211;0
vpja32;11;6829;6975;-443,447450980392;-478,91568627451;146;0
vpja32;11;7044;7188;43,9525490196079;-324,61568627451;144;0
vpja32;11;7213;7368;9,45254901960789;-327,71568627451;155;255000
vpja32;11;7423;7606;-28,5474509803921;19,7843137254902;183;2,55e+08
vpja32;11;7635;7872;-47,5474509803921;-76,2156862745098;237;2,55e+08
vpja32;11;7907;8068;-9,84745098039218;-132,21568627451;161;2,55e+08
vpja32;11;8104;8319;-18,5474509803921;-289,21568627451;215;2,55e+08
vpja32;11;8349;8597;-47,7474509803922;-260,11568627451;248;2,55e+08
vpja32;11;8630;8829;-0,0474509803921137;-337,71568627451;199;255000
vpja32;11;8838;9013;-9,14745098039214;-336,41568627451;175;255000
vpja32;11;9057;9254;174,052549019608;-335,11568627451;197;0
vpja32;11;9330;9561;274,752549019608;301,48431372549;231;255
vpja32;11;9618;9846;-72,2474509803922;305,98431372549;228;0
vpja32;11;9871;10000;-95,6474509803921;279,88431372549;129;0
vpja32;12;113;248;-4,09999999999991;18,2;135;2,55e+08
vpja32;12;308;402;-24,6999999999999;-213,3;94;255000
vpja32;12;428;549;-65,5;-320,1;121;255000
vpja32;12;616;755;-439;295,7;139;0
vpja32;12;779;964;-478;287,4;185;0
vpja32;12;1041;1265;368,1;322,8;224;255255000
vpja32;12;1298;1647;426,2;400,3;349;0
vpja32;12;1671;1982;355,6;425,6;311;0
vpja32;12;2017;2264;456;475,6;247;0
vpja32;12;2308;2338;507,2;493,6;30;NA
vpja32;12;2379;2601;520,1;495,5;222;NA
vpja32;12;2628;3018;363;448,9;390;0
vpja32;12;3084;3280;-470,7;340,2;196;0
vpja32;12;3293;3535;-490,6;329,1;242;255
vpja32;12;3556;3722;-519,2;344,2;166;0
vpja32;12;3837;3953;346,9;200;116;0
vpja32;12;3989;4230;408,3;155,9;241;0
vpja32;12;4255;4439;318,2;17,4000000000001;184;0
vpja32;12;4509;4680;-39,1999999999999;-290;171;255000
vpja32;12;4703;4857;-57,9;-327,7;154;255000
vpja32;12;4916;5042;-0,699999999999932;-13,9;126;2,55e+08
vpja32;12;5099;5421;-300,3;-234,8;322;0
vpja32;12;5497;5638;-456,4;311,2;141;0
vpja32;12;5665;5949;-468,1;254,9;284;0
vpja32;12;6228;6263;384,5;551,1;35;NA
vpja32;12;6339;6406;560,3;425,8;67;0
vpja32;12;6418;6486;591,3;383,9;68;0
vpja32;12;6510;6594;526,1;329,7;84;0
vpja32;12;6654;6913;34,1;119,7;259;2,55e+08
vpja32;12;6947;7292;-19;145,6;345;2,55e+08
vpja32;12;7314;7541;-0,5;153,3;227;2,55e+08
vpja32;12;7597;7866;-129,9;-5,29999999999995;269;2,55e+08
vpja32;12;7905;8123;-19,6999999999999;-27,0999999999999;218;2,55e+08
vpja32;12;8162;8356;108,7;77,7;194;2,55e+08
vpja32;12;8373;8550;91,8;105,2;177;2,55e+08
vpja32;12;8603;8844;-180,9;66,1;241;2,55e+08
vpja32;12;8875;9019;-147,9;88,6;144;2,55e+08
vpja32;12;9064;9237;56,4000000000001;136;173;2,55e+08
vpja32;12;9271;9428;94,7;145,7;157;2,55e+08
vpja32;12;9489;9714;392,3;409;225;0
vpja32;12;9737;9820;448,1;475,3;83;0
vpja32;12;9855;9972;455;487,7;117;NA
vpja32;13;116;183;-3,70000000000005;20,6;67;2,55e+08
vpja32;13;215;487;50,6999999999999;-22,6;272;255000
vpja32;13;522;1957;44;204,3;1435;255
vpja32;13;1981;2234;-12,1;202,7;253;255
vpja32;13;2258;2369;-85,7;212,6;111;0
vpja32;13;2447;2608;244,5;189;161;0
vpja32;13;2634;2789;223,8;94;155;0
vpja32;13;2864;3044;332,5;-211,1;180;0
vpja32;13;3093;3230;42,4;-292,4;137;0
vpja32;13;3312;3490;-559,9;-53,2;178;0
vpja32;13;3533;3634;-542;104,4;101;0
vpja32;13;3708;3792;97,4;74,1;84;2,55e+08
vpja32;13;4055;4268;28,9;276,2;213;0
vpja32;13;4319;4341;25,6;223,3;22;0
vpja32;13;4394;4475;347,3;282,8;81;0
vpja32;13;4504;4617;299,7;229,2;113;0
vpja32;13;4635;4694;274,5;206,4;59;0
vpja32;13;4754;4974;20;-4,5;220;0
vpja32;13;4983;5334;48,1999999999999;-60,9;351;255000
vpja32;13;5374;5569;-17,7;-200,7;195;0
vpja32;13;5595;5765;45,9;-244,9;170;0
vpja32;13;5817;6060;331,1;-201,3;243;0
vpja32;13;6121;6290;66,3;-387,5;169;0
vpja32;13;6332;6525;-127,4;-461;193;0
vpja32;13;6546;6714;-121,4;-491,5;168;NA
vpja32;13;6771;6879;-393,1;-248,2;108;0
vpja32;13;6940;7158;-515,1;64,8;218;0
vpja32;13;7179;7585;-532,3;41,9;406;0
vpja32;13;7641;8478;-535,3;-270,9;837;0
vpja32;13;8503;9020;-567,7;-241,6;517;0
vpja32;13;9176;9324;67,6999999999999;8;148;2,55e+08
vpja32;13;9350;9818;64,1;-105,4;468;255000
vpja32;13;9865;10000;78;-14,1;135;0
vpja32;14;140;182;-17,7;72,9000000000001;42;2,55e+08
vpja32;14;243;375;-6,79999999999995;-246,6;132;255000
vpja32;14;401;705;-11,3;-305,7;304;255000
vpja32;14;719;1001;13;-305,8;282;255000
vpja32;14;1023;1192;-16,5;-324,2;169;255000
vpja32;14;1264;1397;-382,2;231,8;133;255255000
vpja32;14;1431;1620;-369,9;169,6;189;0
vpja32;14;2123;2310;399,6;238,6;187;255
vpja32;14;2332;2574;415,8;253,1;242;255
vpja32;14;2599;2776;508,8;329,7;177;255
vpja32;14;2784;2930;549,8;356,9;146;0
vpja32;14;2959;3123;396;322,4;164;0
vpja32;14;3142;3221;355,8;297;79;255
vpja32;14;3284;3304;140,3;198,6;20;0
vpja32;14;3547;3685;10,7;-1,69999999999993;138;2,55e+08
vpja32;14;3770;3985;219;-348,9;215;0
vpja32;14;4028;4159;-18,6;-349,1;131;255000
vpja32;14;4190;4400;4,60000000000002;-311,5;210;255000
vpja32;14;4421;4602;21,6;-282,3;181;255000
vpja32;14;4611;4819;20,5;-273,2;208;255000
vpja32;14;4845;5035;-15,1;-329;190;255000
vpja32;14;5071;5276;-86,3;-442,5;205;0
vpja32;14;5315;5463;25,2;-269,6;148;255000
vpja32;14;5533;5754;408,8;187,1;221;255
vpja32;14;5787;5940;445,4;246,1;153;255
vpja32;14;5963;6081;404;247,5;118;255
vpja32;14;6130;6348;56,7;129,7;218;2,55e+08
vpja32;14;6373;6728;-27,2;66,1;355;2,55e+08
vpja32;14;6750;7135;-31,4;91,6;385;2,55e+08
vpja32;14;7193;7495;423,6;254,7;302;255
vpja32;14;7510;7715;431,1;287,9;205;255
vpja32;14;7732;7968;444,8;350,9;236;0
vpja32;14;7975;8149;442,3;373;174;0
vpja32;14;8184;8435;581,4;413,3;251;0
vpja32;14;8459;8483;522,9;398,5;24;0
vpja32;14;8595;8724;506,4;384,8;129;0
vpja32;14;8763;8909;367,6;371,6;146;0
vpja32;14;9055;9086;-389,6;301,3;31;255255000
vpja32;14;9367;9416;-518,7;95,5;49;0
vpja32;14;9476;9593;-516,3;-237,4;117;0
vpja32;14;9660;9919;-6;-293,3;259;255000
vpja32;14;9941;10000;14,7;-298,2;59;255000
vpja32;15;266;288;0,100000000000023;-64,2;22;2,55e+08
vpja32;15;302;436;8,89999999999998;-179,6;134;255000
vpja32;15;776;989;313,1;172,2;213;255255000
vpja32;15;998;1152;316,3;167,3;154;255255000
vpja32;15;1231;1378;42;-212,4;147;255000
vpja32;15;1407;1898;6,5;-248,9;491;255000
vpja32;15;1953;2132;383;-247,8;179;255255255
vpja32;15;2187;2342;580,4;-155,7;155;255255255
vpja32;15;2402;2540;144,6;-277,1;138;255255255
vpja32;15;2578;2714;44,6;-252,9;136;255000
vpja32;15;2736;2975;13,3;-250,6;239;255000
vpja32;15;2996;3323;-12,8000000000001;-266,1;327;255000
vpja32;15;3354;3664;27,8;-260,7;310;255000
vpja32;15;3678;4077;18,9;-263;399;255000
vpja32;15;4131;4359;-41,4;53,5;228;2,55e+08
vpja32;15;4394;4625;-250,7;134,1;231;255
vpja32;15;5499;5546;-9,10000000000002;-135,9;47;2,55e+08
vpja32;15;5595;5792;-350,7;-235,3;197;255255255
vpja32;15;5847;6156;-403,1;-416,1;309;255255255
vpja32;15;6191;6308;-320,1;-277,5;117;255255255
vpja32;15;6389;6705;368,4;-287;316;255255255
vpja32;15;6732;6982;266,1;-310;250;255255255
vpja32;15;7033;7267;583,9;-133;234;255255255
vpja32;15;7337;7521;35,6999999999999;-264,3;184;255000
vpja32;15;7544;7722;10,1;-260,6;178;255000
vpja32;15;7744;8028;-21,2;-269,3;284;255000
vpja32;15;8066;8279;39,4;-109,7;213;2,55e+08
vpja32;15;8299;8605;36,6999999999999;-130,6;306;2,55e+08
vpja32;15;8626;8815;53,1;-127,1;189;2,55e+08
vpja32;15;8837;9022;57,1999999999999;-92,6;185;2,55e+08
vpja32;15;9064;9314;-71,1;-46,3000000000001;250;2,55e+08
vpja32;15;9346;9517;-47,5;24,8;171;2,55e+08
vpja32;15;9545;9726;-124,7;64,4;181;2,55e+08
vpja32;15;9769;10000;67,1999999999999;-42,5;231;2,55e+08
vpja32;16;129;299;-20,2;29,2;170;2,55e+08
vpja32;16;369;610;-18,4;-326;241;255000
vpja32;16;633;804;-61,9;-338;171;255000
vpja32;16;826;993;-88,1;-333,9;167;255000
vpja32;16;1060;1335;-459,5;206,5;275;0
vpja32;16;1358;1456;-427,1;192,3;98;0
vpja32;16;1509;1673;-62;201,7;164;2,55e+08
vpja32;16;1713;1772;83,3;253,9;59;255255000
vpja32;16;1793;1963;94,0999999999999;286;170;255255000
vpja32;16;2012;2111;11,4;315,5;99;255255000
vpja32;16;2364;2440;48,9;397,8;76;255255000
vpja32;16;2465;2625;99,5999999999999;350,8;160;255255000
vpja32;16;2706;2726;117,6;237,5;20;2,55e+08
vpja32;16;3054;3087;-499,8;253,9;33;255
vpja32;16;3115;3269;-499,6;258,1;154;255
vpja32;16;3637;3864;99,5;250,4;227;255255000
vpja32;16;3946;4150;9;-367,7;204;255000
vpja32;16;4343;4501;-58,6;-368,9;158;255000
vpja32;16;4515;4747;-64,7;-365,2;232;255000
vpja32;16;4805;4989;-7,10000000000002;-119,2;184;2,55e+08
vpja32;16;5015;5201;41,7;-164,1;186;2,55e+08
vpja32;16;5241;5493;-8,70000000000005;-340,2;252;255000
vpja32;16;5543;5612;239,1;-202,6;69;0
vpja32;16;5679;5864;466,4;54,4;185;0
vpja32;16;5932;6148;16,4;-396,4;216;255000
vpja32;16;6173;6375;-22,9;-403,9;202;255000
vpja32;16;6408;6550;-38;-366,1;142;255000
vpja32;16;6572;6683;-62,5;-349,9;111;255000
vpja32;16;6734;7018;-298,5;-235,7;284;0
vpja32;16;7082;7302;-284,1;140,3;220;0
vpja32;16;7329;7529;-308,3;68,9;200;0
vpja32;16;7563;7747;-197,7;44,2;184;0
vpja32;16;7791;7992;33,4;192,1;201;255255000
vpja32;16;8077;8163;79,2;-245,3;86;255000
vpja32;16;8206;8380;10;-359,2;174;255000
vpja32;16;8405;8799;-47;-361,7;394;255000
vpja32;16;8836;9235;31,6;-356,6;399;255000
vpja32;16;9279;9449;-205,3;-338,2;170;0
vpja32;16;9513;9653;151,3;-233,6;140;0
vpja32;16;9690;9890;171,4;-103,6;200;2,55e+08
vpja32;16;9927;10000;266;-21,8;73;2,55e+08
vpja32;17;125;231;-9,30000000000007;36,1;106;2,55e+08
vpja32;17;291;421;86,2;-189,3;130;255000
vpja32;17;444;608;99;-235,2;164;255000
vpja32;17;665;888;412,1;147,5;223;255
vpja32;17;916;1091;398,4;81,3;175;255
vpja32;17;1106;1376;418,4;87,3;270;255
vpja32;17;1389;1614;396,3;89,7;225;255
vpja32;17;1623;1763;387,2;99,6;140;255
vpja32;17;1819;2016;78,2;32,4;197;2,55e+08
vpja32;17;2045;2129;-22,3000000000001;22,2;84;2,55e+08
vpja32;17;2191;2516;-444,8;201,9;325;255255000
vpja32;17;2536;2595;-484,4;206,4;59;255255000
vpja32;17;2632;2751;-482,6;205,7;119;255255000
vpja32;17;3289;3349;-481,5;161,9;60;255255000
vpja32;17;3399;3606;-367,5;-96,4;207;0
vpja32;17;3628;3857;-397;-133;229;0
vpja32;17;3881;4067;-428,4;-118;186;0
vpja32;17;4126;4369;-447,9;-344,3;243;0
vpja32;17;4443;4835;128,4;-253;392;255000
vpja32;17;4893;5142;451,4;102,3;249;255
vpja32;17;5152;5324;437,8;100,7;172;255
vpja32;17;5334;5524;421,7;108,1;190;255
vpja32;17;5544;5935;391,2;102,5;391;255
vpja32;17;5954;6210;406,9;127,5;256;255
vpja32;17;6254;6530;436,5;263,2;276;255
vpja32;17;6560;6768;314,6;228,8;208;255
vpja32;17;6783;6990;333,2;236,4;207;255
vpja32;17;7018;7259;403,4;305,9;241;0
vpja32;17;7288;7474;524,7;317,8;186;0
vpja32;17;7567;7881;557;-221,1;314;0
vpja32;17;7906;8082;520,7;-217,2;176;0
vpja32;17;8138;8272;142,8;-257,4;134;255000
vpja32;17;8301;8450;103,2;-239,7;149;255000
vpja32;17;8470;8740;85,8;-248,4;270;255000
vpja32;17;8758;8916;106,2;-245,8;158;255000
vpja32;17;8990;9169;-416,5;-171,3;179;0
vpja32;17;9185;9270;-408,4;-144;85;0
vpja32;17;9311;9523;-469,5;-68,5;212;0
vpja32;17;9557;9754;-366,3;-105,3;197;0
vpja32;17;9776;10000;-389,2;-97;224;0
vpja32;18;168;292;-46,7;85,9;124;255
vpja32;18;357;474;-162,2;-247,1;117;255000
vpja32;18;497;649;-173,1;-285,4;152;255000
vpja32;18;700;891;-3,70000000000005;-27,1;191;0
vpja32;18;914;1196;-56,2;-50,8;282;0
vpja32;18;1221;1477;-6,70000000000005;-79,9;256;0
vpja32;18;1491;1661;-15,5;-74,1;170;0
vpja32;18;1723;1941;-422,9;-1,19999999999993;218;255255000
vpja32;18;1981;2246;-457,4;-149,9;265;0
vpja32;18;2276;2444;-412,3;-159,8;168;0
vpja32;18;2468;2851;-455,1;-201,2;383;0
vpja32;18;2886;2909;-354,2;-168,7;23;0
vpja32;18;2975;3124;9;-34,8;149;0
vpja32;18;3202;3465;627,7;-198,7;263;0
vpja32;18;3507;3701;298,9;-159,1;194;0
vpja32;18;3758;3937;-130,6;-263,5;179;0
vpja32;18;3960;4207;-151,7;-284,3;247;255000
vpja32;18;4267;4528;-391;-5,89999999999998;261;0
vpja32;18;4563;4705;-226,7;52,3000000000001;142;0
vpja32;18;4754;4825;36,1;-20,3;71;0
vpja32;18;5136;5365;307,3;87,1;229;0
vpja32;18;5429;5694;-41;-27,3;265;0
vpja32;18;5726;6063;0;-11;337;0
vpja32;18;6097;6377;61,6999999999999;20,9;280;0
vpja32;18;6398;6594;38,1999999999999;-9,79999999999995;196;0
vpja32;18;6619;6875;63,1999999999999;-10,3;256;0
vpja32;18;6908;6970;105,7;16,4;62;0
vpja32;18;7035;7162;-148,5;-259,4;127;255000
vpja32;18;7188;7396;-146,2;-289,3;208;255000
vpja32;18;7448;7631;-454,4;-149,9;183;0
vpja32;18;7652;7816;-497,4;-178,3;164;0
vpja32;18;7868;8055;-436,5;47,6;187;0
vpja32;18;8077;8297;-462,6;21,8000000000001;220;255255000
vpja32;18;8319;8494;-496,1;26,2;175;255255000
vpja32;18;8552;8914;-156,9;-308,7;362;0
vpja32;18;8935;9128;-136,8;-306,9;193;0
vpja32;18;9173;9384;-152,4;-190;211;2,55e+08
vpja32;18;9453;9770;398,9;-227,2;317;0
vpja32;18;9804;9973;465,5;-261,4;169;0
vpja32;19;168;276;-58,1;140,5;108;0
vpja32;19;302;496;-65,1;-73,5;194;2,55e+08
vpja32;19;555;579;-440;127;24;255
vpja32;19;846;1035;-534,6;147,2;189;255
vpja32;19;1514;1845;-374;120,1;331;255
vpja32;19;1888;2219;-548,3;161,8;331;255
vpja32;19;2238;2584;-517,1;154,7;346;255
vpja32;19;2611;2947;-416,9;121;336;255
vpja32;19;2986;3118;-266,7;102,9;132;0
vpja32;19;3171;3368;144,5;130,3;197;255255000
vpja32;19;3387;3576;128,9;143,8;189;255255000
vpja32;19;3611;3803;203,1;159,1;192;0
vpja32;19;3817;3987;223,7;167,6;170;0
vpja32;19;4020;4254;330,5;140,3;234;0
vpja32;19;4276;4442;290,3;85,6;166;0
vpja32;19;4491;4704;-63,2;-95;213;255000
vpja32;19;4771;4893;-243;-347,4;122;0
vpja32;19;4934;5097;-69,5;-372,3;163;0
vpja32;19;5153;5458;-59,4;-116,2;305;255000
vpja32;19;5520;5660;-33,8;-360,4;140;0
vpja32;19;5686;6027;-87,5;-382,2;341;0
vpja32;19;6048;6289;-95,3;-350,8;241;0
vpja32;19;6308;6515;-97,6;-378,9;207;0
vpja32;19;6537;6661;-83,8;-382,7;124;0
vpja32;19;6718;6942;-438,7;-375,8;224;0
vpja32;19;7005;7306;-470,5;-131,5;301;0
vpja32;19;7343;7552;-474,8;-65,3000000000001;209;0
vpja32;19;7617;7710;68,5999999999999;-77,2;93;0
vpja32;19;7758;7981;-111,9;-337,8;223;0
vpja32;19;8004;8136;-77,2;-333,5;132;0
vpja32;19;8315;8538;553,1;14,3;223;0
vpja32;19;8574;8700;498,5;41,1999999999999;126;0
vpja32;19;8731;8926;312;29,5;195;0
vpja32;19;8956;9103;345,1;35,9;147;0
vpja32;19;9147;9260;497,5;254,9;113;0
vpja32;19;9305;9548;311,9;76;243;0
vpja32;19;9566;9715;288,3;60,6999999999999;149;0
vpja32;19;9744;9899;183,8;50,6999999999999;155;0
vpja32;19;9928;10000;145,2;72,1999999999999;72;0
vpja32;20;119;224;-6,57718631178705;14,061216730038;105;2,55e+08
vpja32;20;284;338;-223,977186311787;166,361216730038;54;0
vpja32;20;451;626;-565,577186311787;326,061216730038;175;0
vpja32;20;749;951;432,222813688213;440,561216730038;202;255255000
vpja32;20;1041;1145;53,522813688213;-349,938783269962;104;255000
vpja32;20;1186;1395;25,8228136882129;-430,538783269962;209;255000
vpja32;20;1449;1499;-298,977186311787;-361,538783269962;50;0
vpja32;20;1657;1741;-344,877186311787;-341,038783269962;84;0
vpja32;20;1777;1912;-499,377186311787;-362,738783269962;135;0
vpja32;20;1985;2151;63,6228136882129;-439,738783269962;166;255000
vpja32;20;2180;2368;42,422813688213;-443,938783269962;188;255000
vpja32;20;2433;2626;350,722813688213;-299,838783269962;193;0
vpja32;20;2663;2809;444,322813688213;-317,838783269962;146;0
vpja32;20;2880;2997;5,32281368821293;-369,638783269962;117;255000
vpja32;20;3076;3275;-178,777186311787;87,261216730038;199;0
vpja32;20;3326;3508;14,3228136882129;-155,438783269962;182;2,55e+08
vpja32;20;3545;3790;126,822813688213;-188,338783269962;245;2,55e+08
vpja32;20;3840;4016;40,6228136882129;-400,838783269962;176;255000
vpja32;20;4083;4364;426,422813688213;-64,638783269962;281;0
vpja32;20;4428;4610;76,3228136882129;-263,438783269962;182;2,55e+08
vpja32;20;4659;4875;28,1228136882129;-434,938783269962;216;255000
vpja32;20;4954;5117;-252,277186311787;162,861216730038;163;0
vpja32;20;5156;5296;-169,577186311787;115,161216730038;140;0
vpja32;20;5351;5655;-515,777186311787;294,961216730038;304;0
vpja32;20;5687;5850;-486,277186311787;329,161216730038;163;255
vpja32;20;6727;6965;451,122813688213;490,961216730038;238;NA
vpja32;20;6982;7135;439,522813688213;440,361216730038;153;255255000
vpja32;20;7481;7659;37,2228136882129;-401,638783269962;178;255000
vpja32;20;7692;7986;24,422813688213;-431,638783269962;294;255000
vpja32;20;8169;8325;8,82281368821293;-415,838783269962;156;255000
vpja32;20;8371;8656;-283,877186311787;-363,138783269962;285;0
vpja32;20;8713;8904;26,7228136882129;-429,738783269962;191;255000
vpja32;20;8948;9455;-263,477186311787;-311,338783269962;507;0
vpja32;20;9490;9667;-318,277186311787;-261,638783269962;177;0
vpja32;20;9700;9854;-365,677186311787;-192,538783269962;154;0
vpja32;20;9921;10000;12,922813688213;-393,938783269962;79;255000
vpja32;21;27;216;66,6823025924853;-123,765631697816;189;2,55e+08
vpja32;21;268;406;155,482302592485;-250,765631697816;138;255000
vpja32;21;430;599;111,382302592485;-256,165631697816;169;255000
vpja32;21;655;818;-383,817697407515;66,0343683021841;163;255
vpja32;21;892;1089;239,882302592485;185,634368302184;197;255255000
vpja32;21;1119;1281;241,682302592485;121,834368302184;162;255255000
vpja32;21;1353;1506;43,2823025924853;-184,365631697816;153;2,55e+08
vpja32;21;1552;1753;-118,417697407515;-316,665631697816;201;0
vpja32;21;1798;2153;-404,217697407515;-298,165631697816;355;0
vpja32;21;2199;2404;-368,017697407515;-108,765631697816;205;0
vpja32;21;2450;2790;-390,917697407515;67,9343683021841;340;255
vpja32;21;2841;2989;-258,517697407515;203,334368302184;148;0
vpja32;21;3060;3287;-62,4176974075148;-149,165631697816;227;0
vpja32;21;3311;3566;-108,017697407515;-175,465631697816;255;0
vpja32;21;3593;3695;-174,417697407515;-143,165631697816;102;0
vpja32;21;3747;3921;-403,617697407515;7,13436830218416;174;0
vpja32;21;3967;4087;-498,017697407515;172,434368302184;120;255
vpja32;21;4136;4361;-540,517697407515;278,834368302184;225;0
vpja32;21;4413;4703;-444,817697407515;62,2343683021842;290;255
vpja32;21;4738;4849;-380,217697407515;36,7343683021842;111;255
vpja32;21;4911;4994;-10,4176974075148;38,3343683021842;83;0
vpja32;21;5059;5292;496,182302592485;44,2343683021842;233;0
vpja32;21;5320;5495;459,282302592485;-98,3656316978158;175;0
vpja32;21;5555;5662;209,682302592485;-310,965631697816;107;255000
vpja32;21;5697;5829;145,582302592485;-261,265631697816;132;255000
vpja32;21;5855;5938;96,7823025924853;-267,165631697816;83;255000
vpja32;21;5995;6212;-65,3176974075147;-432,765631697816;217;0
vpja32;21;6248;6435;-154,417697407515;-407,665631697816;187;0
vpja32;21;6474;6663;-207,717697407515;-342,865631697816;189;0
vpja32;21;6729;6980;-416,917697407515;-34,2656316978158;251;0
vpja32;21;7010;7119;-390,717697407515;57,5343683021841;109;255
vpja32;21;7399;7474;-413,617697407515;108,834368302184;75;255
vpja32;21;7535;7820;-56,4176974075148;-171,665631697816;285;0
vpja32;21;7835;8018;-58,9176974075148;-154,365631697816;183;0
vpja32;21;8045;8250;-160,817697407515;-158,265631697816;205;0
vpja32;21;8302;8861;24,0823025924852;-337,365631697816;559;0
vpja32;21;8909;9189;136,182302592485;-448,165631697816;280;0
vpja32;21;9244;9388;-81,3176974075147;-419,365631697816;144;0
vpja32;21;9437;9697;-460,517697407515;-199,365631697816;260;0
vpja32;21;9757;9887;-113,517697407515;-396,865631697816;130;0
vpja32;21;9935;10000;125,982302592485;-294,865631697816;65;255000
vpja32;22;334;477;16,6;-313,4;143;255000
vpja32;22;531;804;-330,6;9,29999999999995;273;0
vpja32;22;871;1123;275,6;3,5;252;0
vpja32;22;1199;1384;41,2;-333,6;185;255000
vpja32;22;1408;1728;13,1;-339;320;255000
vpja32;22;1791;1979;469,2;-88,4;188;0
vpja32;22;2020;2273;302,1;-25,2;253;0
vpja32;22;2307;2384;216,7;-39,1;77;0
vpja32;22;2438;2600;-295,6;23,9;162;0
vpja32;22;2626;2720;-353,7;11,4;94;0
vpja32;22;2759;3159;-567,9;-63,3000000000001;400;0
vpja32;22;3225;3406;-182,4;-210,1;181;0
vpja32;22;3444;3618;49,8000000000001;-332,9;174;255000
vpja32;22;3637;3804;42,2;-351,1;167;255000
vpja32;22;3820;3929;25,7;-347,4;109;255000
vpja32;22;3999;4175;591,6;-254,4;176;0
vpja32;22;4248;4444;492,5;247,6;196;0
vpja32;22;4511;4787;115,7;361,6;276;0
vpja32;22;4824;4957;14,9000000000001;279,3;133;0
vpja32;22;5034;5260;-24,1999999999999;-54;226;2,55e+08
vpja32;22;5326;5508;17,5;-357,4;182;255000
vpja32;22;5525;5917;7,40000000000009;-349,1;392;255000
vpja32;22;5986;6150;-261,6;7,79999999999995;164;0
vpja32;22;6176;6297;-333,4;16,8;121;0
vpja32;22;6374;6613;305,9;20,1999999999999;239;0
vpja32;22;6635;6787;267,1;4,5;152;0
vpja32;22;6839;7027;544;19,4;188;0
vpja32;22;7092;7211;73,4000000000001;-137,7;119;2,55e+08
vpja32;22;7271;7461;17,9000000000001;-336,2;190;255000
vpja32;22;7481;7739;6,40000000000009;-355,3;258;255000
vpja32;22;7754;8023;-2,19999999999993;-362,5;269;255000
vpja32;22;8048;8265;28,3000000000001;-354,6;217;255000
vpja32;22;8489;8690;8,80000000000007;-335,7;201;255000
vpja32;22;8719;8860;37,1;-351,1;141;255000
vpja32;22;8932;9140;515;-295,4;208;0
vpja32;22;9204;9488;42,6;-351,7;284;0
vpja32;22;9555;9767;177,9;-71,1;212;0
vpja32;22;9803;9934;76,8;-97,8000000000001;131;2,55e+08
vpja32;23;169;201;-49,4017857142858;26,0192857142857;32;0
vpja32;23;252;363;-257,601785714286;-160,080714285714;111;2,55e+08
vpja32;23;397;703;-234,901785714286;-205,280714285714;306;255000
vpja32;23;718;1311;-245,201785714286;-206,980714285714;593;255000
vpja32;23;1339;1482;-283,301785714286;-155,980714285714;143;2,55e+08
vpja32;23;1544;1712;-227,001785714286;150,119285714286;168;255255000
vpja32;23;1775;2108;283,898214285714;30,9192857142857;333;255
vpja32;23;2138;2354;322,598214285714;21,9192857142857;216;255
vpja32;23;2424;2525;-122,601785714286;79,6192857142858;101;0
vpja32;23;2564;2772;-226,501785714286;119,919285714286;208;255255000
vpja32;23;2840;3026;9,4982142857142;-201,480714285714;186;0
vpja32;23;3081;3338;357,398214285714;-124,880714285714;257;0
vpja32;23;3408;3560;-65,3017857142858;6,51928571428573;152;0
vpja32;23;3586;3694;-131,801785714286;-39,6807142857142;108;0
vpja32;23;3753;3918;-474,801785714286;-90,5807142857143;165;0
vpja32;23;3978;4091;-129,201785714286;-73,2807142857142;113;0
vpja32;23;4162;4311;523,898214285714;175,919285714286;149;0
vpja32;23;4359;4630;621,398214285714;275,119285714286;271;0
vpja32;23;4656;4891;607,098214285714;386,619285714286;235;0
vpja32;23;4960;5167;276,998214285714;107,319285714286;207;255
vpja32;23;5228;5467;426,598214285714;-64,9807142857143;239;0
vpja32;23;5503;5683;528,098214285714;-107,680714285714;180;0
vpja32;23;5707;5880;574,398214285714;-224,380714285714;173;0
vpja32;23;5943;6083;81,5982142857143;-226,580714285714;140;0
vpja32;23;6128;6365;-217,101785714286;-215,080714285714;237;255000
vpja32;23;6387;6517;-238,101785714286;-210,880714285714;130;255000
vpja32;23;6556;6767;-468,201785714286;-32,4807142857143;211;0
vpja32;23;6825;6939;-187,201785714286;103,719285714286;114;255255000
vpja32;23;7002;7257;273,298214285714;42,0192857142857;255;255
vpja32;23;7283;7542;176,798214285714;13,3192857142858;259;0
vpja32;23;7576;7720;240,098214285714;29,0192857142857;144;255
vpja32;23;7782;8048;-187,301785714286;111,819285714286;266;255255000
vpja32;23;8359;8390;351,598214285714;394,419285714286;31;0
vpja32;23;8408;8825;264,098214285714;200,219285714286;417;0
vpja32;23;8851;9052;208,098214285714;91,6192857142858;201;255
vpja32;23;9093;9230;306,398214285714;-1,1807142857142;137;255
vpja32;23;9249;9496;349,098214285714;-85,9807142857143;247;0
vpja32;23;9520;9691;299,098214285714;-128,780714285714;171;0
vpja32;23;9757;9926;-246,201785714286;-212,380714285714;169;255000
vpja32;24;75;250;-6,41769740751477;77,2343683021842;175;0
vpja32;24;312;437;7,18230259248526;-254,865631697816;125;2,55e+08
vpja32;24;469;603;-14,2176974075147;-294,565631697816;134;255000
vpja32;24;660;936;-178,817697407515;8,03436830218413;276;0
vpja32;24;972;1142;-63,8176974075147;7,03436830218413;170;255
vpja32;24;1182;1371;-205,117697407515;-49,5656316978159;189;255255000
vpja32;24;1394;1615;-231,017697407515;-78,8656316978158;221;255255000
vpja32;24;1662;1965;-245,917697407515;147,434368302184;303;0
vpja32;24;2006;2127;-115,417697407515;187,334368302184;121;0
vpja32;24;2202;2445;-540,217697407515;12,8343683021842;243;0
vpja32;24;2514;2598;-79,2176974075147;22,1343683021842;84;255
vpja32;24;3041;3210;14,4823025924852;-283,565631697816;169;255000
vpja32;24;3286;3535;514,582302592485;-59,4656316978159;249;0
vpja32;24;3568;3759;443,182302592485;-69,9656316978159;191;0
vpja32;24;3806;4054;446,682302592485;-208,165631697816;248;0
vpja32;24;4107;4302;8,48230259248521;-310,565631697816;195;255000
vpja32;24;4321;4560;3,68230259248526;-299,265631697816;239;255000
vpja32;24;4617;4907;-209,617697407515;-87,5656316978159;290;255255000
vpja32;24;4928;5124;-231,417697407515;-92,3656316978158;196;255255000
vpja32;24;5415;5563;-216,717697407515;-89,7656316978158;148;255255000
vpja32;24;5586;5827;-234,117697407515;-104,965631697816;241;255255000
vpja32;24;5857;5952;-263,117697407515;-140,665631697816;95;0
vpja32;24;6016;6216;-1,41769740751477;-288,965631697816;200;255000
vpja32;24;6260;6429;-167,617697407515;-260,865631697816;169;0
vpja32;24;6462;6606;-132,217697407515;-285,265631697816;144;0
vpja32;24;6650;6878;-294,817697407515;-193,265631697816;228;0
vpja32;24;6939;7151;-544,517697407515;-15,8656316978158;212;0
vpja32;24;7379;7561;-540,217697407515;-262,665631697816;182;0
vpja32;24;7638;7830;38,3823025924852;-311,265631697816;192;0
vpja32;24;7854;7975;12,1823025924853;-315,065631697816;121;255000
vpja32;24;8045;8224;412,482302592485;-114,965631697816;179;0
vpja32;24;8258;8368;452,882302592485;-82,5656316978159;110;0
vpja32;24;8435;8608;-88,5176974075148;-33,5656316978159;173;2,55e+08
vpja32;24;8645;8789;-30,8176974075147;-57,9656316978159;144;2,55e+08
vpja32;24;8841;9025;106,482302592485;100,034368302184;184;0
vpja32;24;9057;9216;75,7823025924853;94,1343683021842;159;2,55e+08
vpja32;24;9271;9396;33,7823025924853;-118,965631697816;125;2,55e+08
vpja32;24;9455;9583;11,5823025924852;-328,565631697816;128;255000
vpja32;24;9602;10000;9,78230259248528;-303,165631697816;398;255000
vpja32;25;137;222;-19,6999999999999;68,1;85;2,55e+08
vpja32;25;264;405;-79,5;-143,3;141;2,55e+08
vpja32;25;428;667;-110,9;-174,6;239;255000
vpja32;25;733;833;-213,8;62,1;100;2,55e+08
vpja32;25;872;1037;-279;121,8;165;0
vpja32;25;1088;1322;19,7;121,5;234;255255000
vpja32;25;1344;1493;46,8000000000001;112,7;149;255255000
vpja32;25;2349;2504;-93,0999999999999;-161,9;155;255000
vpja32;25;2526;2794;-103,2;-176,1;268;255000
vpja32;25;2849;3120;89,6000000000001;-356,2;271;0
vpja32;25;3200;3478;-394,2;-83,8;278;0
vpja32;25;3502;3645;-377,9;-48,4;143;0
vpja32;25;3681;3761;-427,2;-3,10000000000002;80;0
vpja32;25;3817;3988;-441,3;231,5;171;0
vpja32;25;4052;4261;-98,6999999999999;299,2;209;0
vpja32;25;4325;4453;124;365,9;128;0
vpja32;25;4504;4768;309,5;395,8;264;0
vpja32;25;4788;4937;288,8;325,2;149;0
vpja32;25;5025;5220;9,5;164,6;195;255255000
vpja32;25;5253;5420;-47,5999999999999;148,4;167;255255000
vpja32;25;5446;5597;-117,2;105,8;151;0
vpja32;25;5645;5899;15,6;118,5;254;255255000
vpja32;25;5914;6524;1;110,1;610;255255000
vpja32;25;6535;6751;-5,09999999999991;120,6;216;255255000
vpja32;25;6785;6964;-126,8;133,7;179;0
vpja32;25;8833;9037;-230,2;180,5;204;0
vpja32;25;9078;9278;-304;190,5;200;0
vpja32;25;9328;9513;-115,7;35,8;185;2,55e+08
vpja32;25;9563;9698;-67,1999999999999;-149,3;135;2,55e+08
vpja32;25;9723;9886;-97,5999999999999;-175;163;255000
vpja32;25;9919;10000;81,1000000000001;-287;81;0
vpja32;26;113;177;-1,29999999999995;18,4;64;2,55e+08
vpja32;26;206;291;-119,5;-79;85;2,55e+08
vpja32;26;309;440;-130,2;-167,9;131;255000
vpja32;26;453;589;-150,9;-198;136;255000
vpja32;26;652;921;375,5;-17,5;269;255
vpja32;26;977;1161;466,7;200,9;184;0
vpja32;26;1189;1425;351,2;287,3;236;0
vpja32;26;1444;1709;340,3;341,6;265;0
vpja32;26;2704;2891;-402,9;372,2;187;255255000
vpja32;26;3449;3631;452,2;426;182;0
vpja32;26;3693;3885;370,9;149,9;192;255
vpja32;26;3911;4089;307,2;35,9;178;255
vpja32;26;4137;4374;424,4;252,2;237;0
vpja32;26;4407;4568;353,9;273,7;161;0
vpja32;26;4584;4720;329,1;286,5;136;0
vpja32;26;4794;4906;-105,5;-126,4;112;2,55e+08
vpja32;26;4937;5120;-156,4;-194,1;183;255000
vpja32;26;5128;5425;-158,4;-210;297;255000
vpja32;26;5442;5845;-132,5;-206,5;403;255000
vpja32;26;5901;6141;40,8;-395,2;240;0
vpja32;26;6165;6303;8;-405,4;138;0
vpja32;26;6345;6589;59,5;-492,2;244;NA
vpja32;26;6613;6862;39,3;-502,2;249;NA
vpja32;26;6869;7164;50,8;-499,3;295;NA
vpja32;26;7178;7485;66,2;-496,6;307;NA
vpja32;26;7628;7776;-360,3;-62,5;148;0
vpja32;26;7812;7970;-397,9;-9,5;158;0
vpja32;26;8004;8077;-352,2;14,8;73;0
vpja32;26;8418;8619;-425;147,1;201;0
vpja32;26;8689;8794;-142,7;-166,6;105;255000
vpja32;26;8826;9112;-159,4;-209,6;286;255000
vpja32;26;9126;9415;-138,1;-208,5;289;255000
vpja32;26;9473;9639;-6,60000000000002;59;166;2,55e+08
vpja32;26;9664;9849;-42;0,199999999999932;185;2,55e+08
vpja32;26;9900;10000;414,9;-9,70000000000005;100;255
