vp;trial;timest;timeend;x;y;duration;roi
vpja76;1;316;427;-9,19999999999993;-350;111;255000
vpja76;1;501;602;-284,6;301;101;0
vpja76;1;655;776;-447,2;328,1;121;0
vpja76;1;852;971;337,3;323,4;119;255255000
vpja76;1;1024;1279;545,9;367,6;255;255255000
vpja76;1;1359;1547;152,8;-231,7;188;2,55e+08
vpja76;1;1583;1758;265,9;-240,5;175;0
vpja76;1;1828;1940;-176;-333;112;0
vpja76;1;1992;2150;22,1;-389,3;158;255000
vpja76;1;2171;2547;-1,39999999999998;-401,7;376;255000
vpja76;1;2609;2806;-346,9;-240,8;197;0
vpja76;1;2845;3122;-478,3;-317,4;277;0
vpja76;1;3175;3397;-313;-229,8;222;0
vpja76;1;3471;3646;343,9;-214,3;175;0
vpja76;1;3677;3814;270,8;-255,3;137;0
vpja76;1;3854;4310;386,6;-317,9;456;0
vpja76;1;4348;4567;289,5;-248,6;219;0
vpja76;1;4591;4694;232,7;-232,2;103;0
vpja76;1;4764;4933;360;296,2;169;255255000
vpja76;1;5014;5174;-372,4;365,4;160;0
vpja76;1;5224;5328;-520,7;428,8;104;255
vpja76;1;5414;5557;406,4;398;143;0
vpja76;1;5594;5869;541;375,2;275;255255000
vpja76;1;5914;6055;329,3;280,1;141;255255000
vpja76;1;6084;6360;238,2;233,1;276;255255000
vpja76;1;6407;6730;504,8;404;323;255255000
vpja76;1;6744;6902;518,3;381,4;158;255255000
vpja76;1;7007;7138;-312,9;334,1;131;0
vpja76;1;7200;7401;-570,7;431,3;201;0
vpja76;1;7498;7671;367,8;-75,9000000000001;173;0
vpja76;1;7712;7926;568,5;-70,9000000000001;214;0
vpja76;1;7968;8230;392,8;-149,4;262;0
vpja76;1;8307;8462;-181,2;-234,9;155;2,55e+08
vpja76;1;8519;8715;-413,5;-295,5;196;0
vpja76;1;8759;9102;-565,5;-341,7;343;0
vpja76;1;9159;9471;-214,2;-329,7;312;0
vpja76;1;9526;9781;15,6;-402,8;255;255000
vpja76;1;9802;10000;-8,29999999999995;-407,8;198;255000
vpja76;2;115;239;-35,9;11,5;124;2,55e+08
vpja76;2;287;508;-49,8;-123,3;221;255000
vpja76;2;526;778;-66,9;-98,6;252;255000
vpja76;2;827;928;-239,7;159,5;101;0
vpja76;2;980;1160;-402,3;128;180;255255000
vpja76;2;1195;1485;-482,6;146,9;290;255255000
vpja76;2;1563;1764;235,3;145,1;201;0
vpja76;2;1785;2075;207,5;123;290;255
vpja76;2;2097;2308;254,3;115,4;211;255
vpja76;2;2347;2715;340;30,9;368;0
vpja76;2;2766;3089;139,1;15,1999999999999;323;0
vpja76;2;3137;3292;354;-3,5;155;0
vpja76;2;3372;3504;-274,6;-153,6;132;0
vpja76;2;3561;3666;-268,6;-347,9;105;0
vpja76;2;3720;3927;0,5;-332,6;207;0
vpja76;2;3947;4041;-16,9;-359,6;94;0
vpja76;2;4106;4338;109,5;60,4;232;0
vpja76;2;4367;4601;190,2;71,1999999999999;234;0
vpja76;2;4630;4936;227;142,2;306;0
vpja76;2;4954;5087;205,7;121,3;133;255
vpja76;2;5164;5390;-393;152,2;226;255255000
vpja76;2;5425;5677;-476,7;150,9;252;255255000
vpja76;2;5884;6655;-417,3;144,8;771;255255000
vpja76;2;6711;6965;-333,9;373,1;254;0
vpja76;2;7026;7315;-10,0999999999999;291,4;289;0
vpja76;2;7347;7622;-86,5;305,9;275;2,55e+08
vpja76;2;7680;7781;308,7;258,2;101;0
vpja76;2;7846;8016;511,2;70,4;170;0
vpja76;2;8050;8214;368,8;60,6999999999999;164;0
vpja76;2;8268;8513;189,1;132,7;245;255
vpja76;2;8534;8735;228,8;121,5;201;255
vpja76;2;8798;8937;-55,4;-74,9000000000001;139;255000
vpja76;2;8957;9431;-69,0999999999999;-99,2;474;255000
vpja76;2;9490;9721;71,2;-344,2;231;0
vpja76;2;9895;10000;613,6;-69,5;105;0
vpja76;3;40;323;1,89999999999998;41;283;2,55e+08
vpja76;3;377;466;4,20000000000005;-201,4;89;255000
vpja76;3;536;646;-350,1;216,5;110;0
vpja76;3;673;842;-342,8;154,7;169;255
vpja76;3;901;1219;236;178;318;255255000
vpja76;3;1283;1415;64,1;-200;132;255000
vpja76;3;1442;1750;8,80000000000007;-209,8;308;255000
vpja76;3;1768;2008;-16;-200,5;240;255000
vpja76;3;2081;2315;-354;201,5;234;255
vpja76;3;2394;2675;298,1;115,8;281;0
vpja76;3;2727;3060;501,7;18,8000000000001;333;0
vpja76;3;3123;3286;167,4;-224,7;163;0
vpja76;3;3350;3572;-155,4;-240,7;222;0
vpja76;3;3619;3937;-9,10000000000002;-211,3;318;255000
vpja76;3;3988;4079;-121,2;-232,9;91;0
vpja76;3;4143;4300;-215,2;129,5;157;0
vpja76;3;4329;4529;-305,4;143,1;200;255
vpja76;3;4585;4770;193,6;143,6;185;255255000
vpja76;3;4797;5279;263,9;176,2;482;255255000
vpja76;3;5348;5572;-39,9;-189,4;224;255000
vpja76;3;5626;5913;-195,6;-269,6;287;0
vpja76;3;5970;6216;33,9;-206,9;246;255000
vpja76;3;6236;6590;5,30000000000007;-205,6;354;255000
vpja76;3;6651;6764;221,3;11,2;113;0
vpja76;3;6818;7144;519,2;10,8000000000001;326;0
vpja76;3;7216;7331;86;77,1;115;2,55e+08
vpja76;3;7380;7641;-124,2;135,7;261;2,55e+08
vpja76;3;7663;7869;-108,9;158,6;206;0
vpja76;3;7933;8097;76,7;-189,9;164;0
vpja76;3;8126;8524;14;-212,7;398;255000
vpja76;3;8762;9118;636,4;-9,69999999999993;356;0
vpja76;3;9173;9285;369,4;259,4;112;0
vpja76;3;9318;9559;303;184,6;241;0
vpja76;3;9582;9697;257,9;173,6;115;255255000
vpja76;3;9762;9872;-234,5;158,1;110;0
vpja76;3;9923;10000;-362,1;143,3;77;255
vpja76;4;275;455;-19,8;-199,5;180;255000
vpja76;4;583;722;-388,5;211,2;139;255
vpja76;4;749;905;-322;179,5;156;255
vpja76;4;927;1330;-275,5;186,8;403;255
vpja76;4;1368;1484;-365,1;117,5;116;255
vpja76;4;1555;1749;338,3;212,1;194;255255000
vpja76;4;1771;1997;348,1;246,8;226;255255000
vpja76;4;2018;2211;303;259,3;193;255255000
vpja76;4;2283;2456;-32,6999999999999;-192,6;173;255000
vpja76;4;2476;2878;-38,6999999999999;-214,6;402;255000
vpja76;4;2939;3093;-260,5;144,5;154;255
vpja76;4;3130;3265;-354,7;173,7;135;255
vpja76;4;3291;3515;-279,1;181,8;224;255
vpja76;4;3582;3725;11,5;-146,1;143;0
vpja76;4;3755;3864;-30,8;-207,4;109;255000
vpja76;4;3934;4273;-497,5;-12,4;339;0
vpja76;4;4305;4468;-367,8;-25,6999999999999;163;0
vpja76;4;4530;4705;28,6;-183,7;175;255000
vpja76;4;4773;4982;353,6;235,5;209;255255000
vpja76;4;5054;5191;540,1;-96,7;137;0
vpja76;4;5267;5434;-35,3;-159,9;167;255000
vpja76;4;5483;5686;-29,9;25,2;203;2,55e+08
vpja76;4;5757;6082;-417,5;-32,8;325;0
vpja76;4;6097;6732;-406,4;-13,1999999999999;635;0
vpja76;4;6796;7130;-86,6999999999999;-204,6;334;255000
vpja76;4;7192;7519;-375;17,1;327;0
vpja76;4;7542;8262;-323,4;17;720;0
vpja76;4;8278;8469;-348,7;28,1;191;0
vpja76;4;8534;8761;-37,8;-212,6;227;255000
vpja76;4;8769;9066;-26,3;-204,7;297;255000
vpja76;4;9134;9343;-302,9;159,6;209;255
vpja76;4;9364;9503;-285,5;192,1;139;255
vpja76;4;9567;9782;207,1;14,5;215;0
vpja76;4;9827;9999;382,9;230,6;172;255255000
vpja76;5;498;626;300,5;122,7;128;255
vpja76;5;689;879;-71;75,8000000000001;190;255255000
vpja76;5;909;1111;-48,6999999999999;16,6;202;255255000
vpja76;5;1147;1277;-133,4;78,2;130;255255000
vpja76;5;1345;1786;163,2;-295,2;441;255000
vpja76;5;1855;2207;-79,8;67,5;352;255255000
vpja76;5;2267;2568;168,7;-240,5;301;2,55e+08
vpja76;5;2596;2926;166,6;-306,8;330;255000
vpja76;5;2994;4054;352,1;86,6;1060;255
vpja76;5;4126;5088;-11,8;92;962;0
vpja76;5;5123;5780;-105,7;80,8000000000001;657;255255000
vpja76;5;5814;6364;-166,8;94,6;550;0
vpja76;5;6398;6564;-93,4;76,9000000000001;166;255255000
vpja76;5;6627;6887;261,5;84,9000000000001;260;0
vpja76;5;6945;7307;29,2;1,90000000000009;362;0
vpja76;5;7345;8116;-81,5999999999999;49,8000000000001;771;255255000
vpja76;5;8161;8356;77,5;34,2;195;0
vpja76;5;8400;8655;295,5;87,6;255;255
vpja76;5;8675;9501;326,9;86,6;826;255
vpja76;5;9573;10000;-32,5;100,4;427;0
vpja76;6;314;481;139,6;244,1;167;255255000
vpja76;6;557;958;-394;369,5;401;255
vpja76;6;1039;1308;-294,7;-277,6;269;255000
vpja76;6;1386;1637;-405;389,8;251;255
vpja76;6;1710;1986;215,4;251;276;255255000
vpja76;6;2004;2393;213,3;229;389;255255000
vpja76;6;2475;2713;-363,6;352,8;238;255
vpja76;6;2783;2957;183,3;248,6;174;255255000
vpja76;6;2980;3579;201,2;216,9;599;255255000
vpja76;6;3617;3848;240,5;303,1;231;255255000
vpja76;6;3876;4426;184,4;222;550;255255000
vpja76;6;4452;4751;228,4;267,5;299;255255000
vpja76;6;4779;5253;187,8;219,7;474;255255000
vpja76;6;5292;5761;263,9;309,4;469;255255000
vpja76;6;5800;6020;146,5;233,1;220;255255000
vpja76;6;6096;6192;-84,5;-181,3;96;0
vpja76;6;6239;6663;-268,4;-290;424;255000
vpja76;6;6748;6858;67,1;106,3;110;0
vpja76;6;6928;7039;-187,5;12,6;111;2,55e+08
vpja76;6;7148;7250;-337,7;-256,3;102;255000
vpja76;6;7275;7699;-289,7;-302,7;424;255000
vpja76;6;7781;8076;410,5;-52,1;295;0
vpja76;6;8119;8326;585,1;-119,2;207;0
vpja76;6;8352;8669;594,4;-170;317;0
vpja76;6;8729;8907;374,7;22,4;178;0
vpja76;6;9005;9220;-486,2;-149,9;215;2,55e+08
vpja76;6;9267;9429;-529,3;-243,7;162;0
vpja76;6;9503;9598;-57,7;-173,6;95;0
vpja76;6;9656;9883;243;10;227;0
vpja76;6;9922;10000;373,4;9,5;78;0
vpja76;7;343;484;-155,9;375,1;141;255255000
vpja76;7;514;642;-152,4;316,6;128;255255000
vpja76;7;669;850;-129,2;257,9;181;255255000
vpja76;7;916;1167;256;19,2;251;255
vpja76;7;1183;1345;257,6;48,5;162;255
vpja76;7;1420;1683;-267,9;-173,9;263;255000
vpja76;7;1736;1926;101,5;-15,5999999999999;190;0
vpja76;7;1991;2323;-217,8;-101,4;332;0
vpja76;7;2380;2640;130,3;62,9000000000001;260;0
vpja76;7;2702;2865;-82,5;306,5;163;255255000
vpja76;7;2930;3225;256,4;20,4000000000001;295;255
vpja76;7;3296;3737;-137,4;323,8;441;255255000
vpja76;7;3807;4091;73,9000000000001;132,8;284;0
vpja76;7;4149;4318;-107,1;308,9;169;255255000
vpja76;7;4383;4942;255;16,2;559;255
vpja76;7;5001;5496;31,2;110,6;495;0
vpja76;7;5635;6012;147,5;102,9;377;0
vpja76;7;6071;6644;-76,8;246;573;255255000
vpja76;7;6702;7138;270,1;62,4000000000001;436;255
vpja76;7;7197;7391;27,1;158,2;194;0
vpja76;7;7441;7886;222,4;63,2;445;255
vpja76;7;7957;9607;-86,8;217,2;1650;255255000
vpja76;7;9654;10000;232,4;46,1;346;255
vpja76;8;291;500;297,5;227,5;209;255
vpja76;8;526;686;350,1;290;160;255
vpja76;8;698;885;367,8;307,7;187;255
vpja76;8;963;1090;-228,2;174,1;127;255255000
vpja76;8;1159;1282;26;-285,6;123;0
vpja76;8;1312;1633;26,8;-346,1;321;0
vpja76;8;1644;2020;16,4;-349,4;376;0
vpja76;8;2080;2236;-123,3;-32;156;0
vpja76;8;2257;2497;-97,3000000000001;-56,4;240;2,55e+08
vpja76;8;2548;2841;149,4;-235,2;293;0
vpja76;8;2879;3117;290,6;-212,6;238;0
vpja76;8;3208;3745;-417;-252,5;537;0
vpja76;8;3799;3952;-409,9;-408,2;153;0
vpja76;8;4029;4299;-307,9;213,5;270;0
vpja76;8;4368;4499;30,9;-263,1;131;0
vpja76;8;4534;4778;-2,60000000000002;-354;244;255000
vpja76;8;4790;5403;19,5999999999999;-344,7;613;0
vpja76;8;5480;5633;139,1;189,7;153;0
vpja76;8;5674;5842;295,7;228,2;168;255
vpja76;8;5904;6116;-61,8000000000001;168;212;2,55e+08
vpja76;8;6177;6397;395;299,1;220;0
vpja76;8;6409;6807;379,6;313,2;398;255
vpja76;8;6881;7039;-191,6;213,9;158;0
vpja76;8;7098;7471;370,2;270;373;255
vpja76;8;7499;7758;393,1;330,4;259;0
vpja76;8;7767;7977;403;317,6;210;0
vpja76;8;8010;8199;327,6;225,9;189;255
vpja76;8;8287;8616;-324,1;171,4;329;255255000
vpja76;8;8669;8970;27,4;-89,9;301;0
vpja76;8;9027;9512;-50,2;167,3;485;2,55e+08
vpja76;8;9567;9810;-212,4;181,7;243;0
vpja76;8;9875;10000;113,6;155,2;125;0
vpja76;9;9;251;-51,1;10;242;2,55e+08
vpja76;9;316;549;-337,3;101,9;233;255
vpja76;9;612;888;276,8;127,8;276;255255000
vpja76;9;901;1137;265;119,1;236;255255000
vpja76;9;1210;1379;51,8;-286,7;169;255000
vpja76;9;1407;1879;-7,30000000000007;-291,5;472;255000
vpja76;9;1948;2589;261,3;96,1999999999999;641;255255000
vpja76;9;2633;2779;83,3;201,6;146;0
vpja76;9;2851;3472;-364;102,4;621;255
vpja76;9;3487;3853;-378,5;93;366;255
vpja76;9;3919;4111;57,1999999999999;108,9;192;0
vpja76;9;4156;4468;285,4;129,9;312;255255000
vpja76;9;4478;4736;278,8;118;258;255255000
vpja76;9;4749;5460;268,7;107,5;711;255255000
vpja76;9;5743;5766;309,6;368,1;23;0
vpja76;9;5776;5982;261,9;219,7;206;0
vpja76;9;6034;6199;118,5;590,6;165;NA
vpja76;9;6218;6392;69,7;617;174;NA
vpja76;9;6491;6647;647,5;129,5;156;NA
vpja76;9;6694;7049;561,7;-69,1;355;0
vpja76;9;7091;7356;606,9;-142,4;265;0
vpja76;9;7396;7742;510,4;-268,8;346;0
vpja76;9;7842;8038;-368,7;-151,2;196;0
vpja76;9;8102;8321;-514,3;128;219;0
vpja76;9;8363;8727;-615,9;60,6;364;0
vpja76;9;8809;8908;-2,20000000000005;-89,6;99;2,55e+08
vpja76;9;8947;9299;-122,1;-116,6;352;2,55e+08
vpja76;9;9362;9659;-324,7;77,5;297;255
vpja76;9;9680;9879;-366,8;72,9;199;255
vpja76;10;220;377;8,60000000000002;10,8000000000001;157;255
vpja76;10;407;815;-37,3;60;408;255
vpja76;10;835;1175;-12,6999999999999;35,9;340;255
vpja76;10;1198;1579;40,3000000000001;42,7;381;255
vpja76;10;1600;1813;4,70000000000005;61,7;213;255
vpja76;10;1833;2161;4,70000000000005;41,1;328;255
vpja76;10;2218;2458;-148,4;-218,7;240;0
vpja76;10;2522;2671;31,2;89,9;149;255
vpja76;10;2697;2925;-18,5999999999999;57,9;228;255
vpja76;10;2949;3347;32,8000000000001;42,4;398;255
vpja76;10;3369;3615;-11,1999999999999;53,8000000000001;246;255
vpja76;10;3691;3966;-474,7;44,6;275;255255000
vpja76;10;3997;4154;-454,4;130,4;157;0
vpja76;10;4220;4450;13,7;82,9;230;255
vpja76;10;4518;4630;-406,6;160,5;112;0
vpja76;10;4694;4974;6,40000000000009;102,6;280;255
vpja76;10;5007;5396;54,1;173;389;0
vpja76;10;5454;5603;-112,1;-144,8;149;2,55e+08
vpja76;10;5635;6085;-165;-213,6;450;255000
vpja76;10;6105;6360;-161,5;-248,5;255;255000
vpja76;10;6368;6659;-159,9;-235,2;291;255000
vpja76;10;6726;6923;328,6;-228,9;197;0
vpja76;10;6978;7171;429,4;-43;193;0
vpja76;10;7252;7467;-35,0999999999999;302,5;215;0
vpja76;10;7552;7765;-568,7;120,2;213;0
vpja76;10;7795;7907;-573,5;64,9;112;0
vpja76;10;7981;8156;24,7;-209,4;175;0
vpja76;10;8211;8389;224,3;-110;178;0
vpja76;10;8479;8789;-459,7;77,2;310;255255000
vpja76;10;8840;9055;-502,7;236,9;215;0
vpja76;10;9092;9326;-480,3;112,4;234;255255000
vpja76;10;9377;9577;-451,2;-48,6;200;255255000
vpja76;10;9639;10000;-48,5;83,7;361;255
vpja76;11;234;401;3;36,6999999999998;167;2,55e+08
vpja76;11;452;736;-23,8000000000001;292,8;284;255
vpja76;11;795;1488;363,2;200,8;693;255255000
vpja76;11;1506;1688;414,3;212,9;182;0
vpja76;11;1726;1830;273;200,4;104;0
vpja76;11;1895;2028;-105,5;309,5;133;0
vpja76;11;2052;2184;-49,3000000000001;290,5;132;255
vpja76;11;2255;2680;-21,6;-247,7;425;255000
vpja76;11;2729;3033;-44,7;-75,9000000000002;304;2,55e+08
vpja76;11;3077;3245;-42,8000000000001;42,1999999999998;168;2,55e+08
vpja76;11;3303;3684;-30;313,7;381;255
vpja76;11;3727;3854;-17,2;156,9;127;2,55e+08
vpja76;11;3891;4137;98,9999999999999;182,5;246;0
vpja76;11;4175;4369;-13,6;186;194;2,55e+08
vpja76;11;4441;4934;-12,4;-222,6;493;255000
vpja76;11;4954;5162;-33,6;-254,1;208;255000
vpja76;11;5271;5432;583;451;161;0
vpja76;11;5446;5533;453,8;406,5;87;0
vpja76;11;5556;5840;363,7;326,9;284;0
vpja76;11;5905;6165;-92,8000000000001;368,5;260;0
vpja76;11;6212;6670;69,5;188,5;458;2,55e+08
vpja76;11;6699;7018;-1,30000000000007;201,9;319;2,55e+08
vpja76;11;7044;7478;104,5;187;434;0
vpja76;11;7502;7679;26,1;198,7;177;2,55e+08
vpja76;11;7702;7802;-40;156,8;100;2,55e+08
vpja76;11;7863;8042;-39,1;-136,9;179;2,55e+08
vpja76;11;8085;8231;-179;-86,4000000000002;146;2,55e+08
vpja76;11;8296;8440;-421,7;-32,7000000000002;144;0
vpja76;11;8499;8617;-135,1;241,4;118;0
vpja76;11;9297;9369;261,8;505,3;72;NA
vpja76;11;9379;9595;250,6;374,2;216;0
vpja76;11;9649;9955;-17,3000000000001;247,9;306;0
vpja76;12;276;568;-195,809540636042;116,815901060071;292;255255000
vpja76;12;597;723;-272,409540636042;93,3159010600707;126;255255000
vpja76;12;775;1022;-373,909540636042;-137,084098939929;247;0
vpja76;12;1052;1387;-434,309540636042;-150,584098939929;335;255000
vpja76;12;1458;1664;21,3904593639575;-31,5840989399293;206;255
vpja76;12;1828;1948;-62,7095406360424;82,5159010600706;120;0
vpja76;12;2008;2165;-315,409540636042;108,015901060071;157;255255000
vpja76;12;2224;2565;-407,209540636042;-173,684098939929;341;255000
vpja76;12;2579;2902;-414,209540636042;-155,784098939929;323;255000
vpja76;12;2963;3121;-125,709540636042;-150,784098939929;158;0
vpja76;12;3176;3423;-37,6095406360425;-312,984098939929;247;0
vpja76;12;3451;3768;10,4904593639575;-259,984098939929;317;0
vpja76;12;3834;3949;-287,409540636042;-190,284098939929;115;0
vpja76;12;4002;4203;-448,809540636042;-179,384098939929;201;255000
vpja76;12;4357;4739;-427,509540636043;-142,184098939929;382;255000
vpja76;12;4810;5087;-51,0095406360425;129,215901060071;277;0
vpja76;12;5148;5325;279,290459363958;92,8159010600707;177;0
vpja76;12;5405;5704;-319,409540636042;28,3159010600707;299;0
vpja76;12;5752;5961;-237,709540636042;104,915901060071;209;255255000
vpja76;12;6019;6253;10,7904593639576;11,7159010600707;234;255
vpja76;12;6323;6472;-341,309540636042;-32,1840989399293;149;0
vpja76;12;6521;6980;-410,109540636043;-155,584098939929;459;255000
vpja76;12;7036;7260;-171,409540636042;-117,584098939929;224;0
vpja76;12;7314;7500;-61,2095406360424;-266,384098939929;186;0
vpja76;12;7527;7851;27,3904593639575;-266,184098939929;324;0
vpja76;12;7894;8344;144,390459363957;-429,184098939929;450;0
vpja76;12;8404;8735;588,390459363957;-374,584098939929;331;0
vpja76;12;8822;9092;52,1904593639575;27,9159010600707;270;0
vpja76;12;9424;9592;-25,3095406360425;-133,984098939929;168;0
vpja76;12;9658;9884;-355,709540636042;-191,684098939929;226;0
vpja76;12;9930;10000;-435,609540636042;-145,684098939929;70;255000
vpja76;13;333;550;8,58989547038323;99,18606271777;217;255255000
vpja76;13;610;875;-68,8101045296168;-162,31393728223;265;255000
vpja76;13;933;1078;-95,3101045296168;143,68606271777;145;0
vpja76;13;1111;1271;19,6898954703832;144,68606271777;160;255255000
vpja76;13;1329;1463;-235,110104529617;172,58606271777;134;0
vpja76;13;1489;1961;-296,010104529617;184,68606271777;472;0
vpja76;13;1984;2289;-247,110104529617;164,18606271777;305;255
vpja76;13;2311;2502;-284,010104529617;179,88606271777;191;0
vpja76;13;2521;2704;-314,610104529617;187,18606271777;183;0
vpja76;13;2771;2966;-105,510104529617;-186,11393728223;195;255000
vpja76;13;2983;3132;-117,510104529617;-161,01393728223;149;255000
vpja76;13;3309;3632;182,289895470383;-268,11393728223;323;0
vpja76;13;3707;3840;-2,81010452961675;194,08606271777;133;255255000
vpja76;13;3902;4131;-94,6101045296167;-105,51393728223;229;2,55e+08
vpja76;13;4190;4381;97,8898954703832;-263,81393728223;191;0
vpja76;13;4438;4704;-58,4101045296168;-146,01393728223;266;2,55e+08
vpja76;13;4753;5078;-65,8101045296168;2,48606271776998;325;2,55e+08
vpja76;13;5143;5481;-272,710104529617;193,68606271777;338;0
vpja76;13;5540;5944;-20,4101045296168;113,48606271777;404;255255000
vpja76;13;6005;6179;-63,5101045296167;-172,61393728223;174;0
vpja76;13;6204;6652;-105,610104529617;-167,21393728223;448;255000
vpja76;13;6716;7096;-293,110104529617;-21,31393728223;380;0
vpja76;13;7152;7479;-331,610104529617;168,08606271777;327;0
vpja76;13;7529;8058;-135,310104529617;374,68606271777;529;0
vpja76;13;8119;8289;32,8898954703833;129,58606271777;170;255255000
vpja76;13;8346;8537;230,989895470383;71,58606271777;191;0
vpja76;13;8600;8861;-38,0101045296167;-56,41393728223;261;2,55e+08
vpja76;13;8920;9140;-23,4101045296168;-213,51393728223;220;0
vpja76;13;9173;9434;107,189895470383;-269,51393728223;261;0
vpja76;13;9623;9959;-78,6101045296167;-71,7139372822301;336;2,55e+08
vpja76;14;274;357;19,8;-242,2;83;255000
vpja76;14;428;536;-228,5;218,8;108;0
vpja76;14;572;729;-235,4;126,3;157;255
vpja76;14;796;1190;27;-288,8;394;255000
vpja76;14;1206;1646;5,29999999999995;-276,2;440;255000
vpja76;14;1713;1861;293,9;115,4;148;255255000
vpja76;14;1898;2034;411,1;141,3;136;255255000
vpja76;14;2107;2250;73,1;-268,9;143;0
vpja76;14;2276;3092;20,9;-285,2;816;255000
vpja76;14;3124;3540;36,6;-341,6;416;255000
vpja76;14;3570;3966;27;-275,4;396;255000
vpja76;14;4033;4192;299,5;148,4;159;255255000
vpja76;14;4231;4533;421,6;158,8;302;255255000
vpja76;14;4591;4722;172,2;210,1;131;0
vpja76;14;4774;4908;-36,7;200,6;134;0
vpja76;14;4964;5221;-250,2;127;257;255
vpja76;14;5245;5546;-199,4;120,9;301;255
vpja76;14;5607;5842;146,3;13,0999999999999;235;2,55e+08
vpja76;14;5877;6120;274,4;-61,2;243;0
vpja76;14;6184;6535;31,9;-281,3;351;255000
vpja76;14;6607;6781;-144,2;77,6999999999999;174;0
vpja76;14;7056;8590;-126,5;93,8;1534;0
vpja76;14;8644;8903;56,6999999999999;117,3;259;0
vpja76;14;8956;9187;-110,6;119,9;231;0
vpja76;14;9233;9784;-208,7;143,7;551;255
vpja76;14;9842;10000;41,1;199,4;158;0
vpja76;15;82;269;9,59621212121215;7,67575757575753;187;0
vpja76;15;296;379;64,7962121212121;-4,0242424242424;83;2,55e+08
vpja76;15;427;656;2,09621212121215;121,475757575758;229;255
vpja76;15;671;822;-7,00378787878788;106,775757575758;151;255
vpja76;15;872;1180;325,696212121212;165,375757575758;308;255255000
vpja76;15;1194;1420;340,296212121212;192,775757575758;226;0
vpja76;15;1478;1594;150,096212121212;23,2757575757576;116;0
vpja76;15;1623;1814;94,1962121212122;-46,4242424242425;191;255000
vpja76;15;1866;2117;-34,0037878787879;105,675757575758;251;255
vpja76;15;2144;2432;31,4962121212121;126,275757575758;288;255
vpja76;15;2489;2961;117,596212121212;-56,5242424242424;472;0
vpja76;15;3010;3303;249,696212121212;-186,724242424242;293;0
vpja76;15;3328;3697;329,896212121212;-162,024242424242;369;0
vpja76;15;3760;3862;18,3962121212121;-172,724242424242;102;0
vpja76;15;3913;4113;88,7962121212121;-50,3242424242425;200;255000
vpja76;15;4127;4734;87,9962121212121;-62,0242424242424;607;255000
vpja76;15;4914;5052;126,196212121212;-56,5242424242424;138;0
vpja76;15;5073;5375;101,496212121212;-59,1242424242424;302;255000
vpja76;15;5452;5670;-401,403787878788;125,675757575758;218;0
vpja76;15;5710;6033;-538,603787878788;149,175757575758;323;0
vpja76;15;6107;6220;76,1962121212122;2,67575757575753;113;2,55e+08
vpja76;15;6247;6822;88,6962121212122;-46,8242424242425;575;255000
vpja76;15;6889;7012;-263,803787878788;-71,9242424242425;123;0
vpja76;15;7072;7237;5,69621212121217;71,1757575757575;165;2,55e+08
vpja76;15;7259;7406;53,1962121212122;91,7757575757576;147;2,55e+08
vpja76;15;7447;7600;180,196212121212;138,675757575758;153;0
vpja76;15;7650;8068;343,696212121212;175,975757575758;418;255255000
vpja76;15;8133;8259;304,096212121212;549,275757575758;126;NA
vpja76;15;8325;8412;243,596212121212;270,475757575758;87;0
vpja76;15;8449;8767;366,796212121212;153,775757575758;318;0
vpja76;15;8782;9350;350,696212121212;162,675757575758;568;0
vpja76;15;9421;9538;-71,6037878787879;107,275757575758;117;255
vpja76;15;9562;10000;-15,6037878787879;143,575757575758;438;255
vpja76;16;172;462;9,87774650552296;4,09717635130301;290;0
vpja76;16;507;676;-66,3222534944771;69,7971763513029;169;0
vpja76;16;719;984;127,577746505523;120,997176351303;265;0
vpja76;16;1049;1229;-225,822253494477;119,997176351303;180;255255000
vpja76;16;1250;1484;-254,522253494477;104,397176351303;234;255255000
vpja76;16;1544;2056;-77,7222534944771;-191,202823648697;512;255000
vpja76;16;2115;2627;246,077746505523;-36,2028236486971;512;0
vpja76;16;2963;2992;185,077746505523;497,197176351303;29;NA
vpja76;16;3010;3495;162,377746505523;293,197176351303;485;0
vpja76;16;3550;4013;-77,5222534944771;155,197176351303;463;0
vpja76;16;4737;4802;88,4777465055229;271,097176351303;65;0
vpja76;16;4810;5030;65,377746505523;190,197176351303;220;0
vpja76;16;5088;5334;-136,222253494477;103,497176351303;246;0
vpja76;16;5408;5684;-44,9222534944771;-216,902823648697;276;255000
vpja76;16;5702;6150;-42,4222534944771;-177,902823648697;448;255000
vpja76;16;6208;6435;232,677746505523;-138,602823648697;227;0
vpja76;16;6474;6720;366,577746505523;-74,102823648697;246;0
vpja76;16;6780;6903;116,977746505523;-33,602823648697;123;0
vpja76;16;7079;7163;65,377746505523;-123,302823648697;84;0
vpja76;16;7200;7438;-43,3222534944771;-203,002823648697;238;255000
vpja76;16;7458;7768;-51,7222534944771;-183,602823648697;310;255000
vpja76;16;7825;8057;338,477746505523;-164,502823648697;232;0
vpja76;16;8120;8996;-33,9222534944771;-188,202823648697;876;255000
vpja76;16;9045;9597;220,877746505523;-195,602823648697;552;0
vpja76;16;9621;9825;284,977746505523;-207,402823648697;204;0
vpja76;17;241;483;-152,9;-103,7;242;2,55e+08
vpja76;17;547;758;-375,3;368;211;255255000
vpja76;17;831;1069;305,7;44,8;238;255
vpja76;17;1137;1269;-95,8000000000001;-145,3;132;0
vpja76;17;1296;1474;-160,4;-193,1;178;255000
vpja76;17;1544;1768;-356,5;308,3;224;255255000
vpja76;17;1790;2263;-392,6;305,9;473;255255000
vpja76;17;2292;2763;-404,1;384,3;471;255255000
vpja76;17;2771;2898;-390,7;377,6;127;255255000
vpja76;17;3126;3293;-379,5;383,1;167;255255000
vpja76;17;3325;3601;-385,9;401,5;276;0
vpja76;17;3637;3994;-388,2;283,8;357;255255000
vpja76;17;4040;4279;-416,9;362,7;239;255255000
vpja76;17;4301;4514;-419,4;412,1;213;0
vpja76;17;4585;4938;-196,7;2,29999999999995;353;2,55e+08
vpja76;17;4981;5373;-25,9;-39,4;392;0
vpja76;17;5439;5591;-319,1;126,2;152;0
vpja76;17;5627;5772;-403,2;81,5;145;0
vpja76;17;5839;5965;-239,8;-241,4;126;0
vpja76;17;6021;6133;6;-308,3;112;0
vpja76;17;6180;6297;-103,2;-202,4;117;0
vpja76;17;6322;6601;-146,9;-197,4;279;255000
vpja76;17;6681;6807;70,5;437,5;126;0
vpja76;17;6842;7121;45,9;337,1;279;0
vpja76;17;7167;7279;15,4;135,8;112;0
vpja76;17;7346;7792;400,5;7,89999999999998;446;255
vpja76;17;7972;8143;510,4;494,1;171;NA
vpja76;17;8175;8520;371,6;274,1;345;0
vpja76;17;8540;9023;336,9;279,4;483;0
vpja76;17;9052;9353;337,2;352,9;301;0
vpja76;17;9392;9574;310,3;230,5;182;0
vpja76;17;9638;9885;350,7;21;247;255
vpja76;17;9906;10000;370,2;-20,9;94;255
vpja76;18;463;628;83,577746505523;-137,602823648697;165;255000
vpja76;18;692;888;-72,122253494477;223,297176351303;196;255255000
vpja76;18;951;1141;331,577746505523;356,397176351303;190;255
vpja76;18;1172;1495;406,577746505523;405,597176351303;323;255
vpja76;18;1558;1764;125,177746505523;-41,402823648697;206;2,55e+08
vpja76;18;1809;2060;123,977746505523;-134,702823648697;251;255000
vpja76;18;2083;2537;79,9777465055229;-122,102823648697;454;255000
vpja76;18;2595;2756;-114,822253494477;-64,3028236486971;161;0
vpja76;18;2949;3040;-47,0222534944771;14,997176351303;91;2,55e+08
vpja76;18;3079;3352;87,577746505523;-118,102823648697;273;255000
vpja76;18;3424;3669;351,277746505523;364,797176351303;245;255
vpja76;18;3706;3955;475,177746505523;393,397176351303;249;255
vpja76;18;4036;4225;-83,7222534944771;334,997176351303;189;255255000
vpja76;18;4295;4494;158,577746505523;-80,902823648697;199;0
vpja76;18;4557;4680;-61,2222534944771;186,197176351303;123;255255000
vpja76;18;4720;4867;-213,522253494477;230,197176351303;147;255255000
vpja76;18;4880;5044;-216,222253494477;251,897176351303;164;255255000
vpja76;18;5114;5349;377,077746505523;341,497176351303;235;255
vpja76;18;5375;5721;405,077746505523;403,397176351303;346;255
vpja76;18;5751;6236;422,977746505523;353,197176351303;485;255
vpja76;18;6258;6433;460,177746505523;378,297176351303;175;255
vpja76;18;6459;6635;476,277746505523;437,397176351303;176;255
vpja76;18;6656;6804;532,077746505523;418,497176351303;148;0
vpja76;18;7075;7197;467,177746505523;618,497176351303;122;NA
vpja76;18;7229;7446;435,177746505523;354,297176351303;217;255
vpja76;18;7458;8014;423,277746505523;345,897176351303;556;255
vpja76;18;8034;8419;380,077746505523;356,197176351303;385;255
vpja76;18;8447;8636;391,177746505523;436,197176351303;189;255
vpja76;18;8674;8933;532,977746505523;444,697176351303;259;0
vpja76;18;8957;9137;480,177746505523;407,497176351303;180;255
vpja76;18;9173;9374;400,777746505523;319,697176351303;201;255
vpja76;18;9391;9730;421,477746505523;348,897176351303;339;255
vpja76;18;9739;10000;405,577746505523;348,897176351303;261;255
vpja76;19;250;296;63,2762589928059;-98,5550359712229;46;255000
vpja76;19;361;650;-64,6237410071942;288,144964028777;289;255
vpja76;19;670;915;-71,1237410071942;254,544964028777;245;255
vpja76;19;984;1137;-464,023741007194;205,544964028777;153;0
vpja76;19;1163;1414;-538,923741007194;177,044964028777;251;255255000
vpja76;19;1427;1565;-544,123741007194;163,344964028777;138;255255000
vpja76;19;1640;1849;49,4762589928058;-119,655035971223;209;255000
vpja76;19;2128;2168;41,4762589928058;-44,7550359712229;40;2,55e+08
vpja76;19;2245;2377;-441,623741007194;159,144964028777;132;0
vpja76;19;2440;2614;-54,5237410071942;268,244964028777;174;255
vpja76;19;2677;2800;150,676258992806;-127,055035971223;123;2,55e+08
vpja76;19;3698;4274;-68,3237410071941;327,344964028777;576;255
vpja76;19;4339;4532;59,8762589928058;-152,155035971223;193;255000
vpja76;19;4547;4753;48,8762589928058;-133,155035971223;206;255000
vpja76;19;4822;4951;-18,2237410071941;330,144964028777;129;0
vpja76;19;4977;5255;-59,9237410071942;250,044964028777;278;255
vpja76;19;5326;5491;135,076258992806;-121,655035971223;165;2,55e+08
vpja76;19;5518;5899;74,1762589928059;-169,455035971223;381;255000
vpja76;19;5927;6217;64,6762589928059;-120,955035971223;290;255000
vpja76;19;6484;6813;83,0762589928058;-64,8550359712229;329;2,55e+08
vpja76;19;6882;7909;-135,423741007194;218,144964028777;1027;0
vpja76;19;8152;8311;93,9762589928059;-91,9550359712229;159;2,55e+08
vpja76;19;8384;8821;-208,023741007194;175,144964028777;437;0
vpja76;19;8877;9117;-91,6237410071942;351,844964028777;240;255
vpja76;19;9175;9402;-73,9237410071942;193,044964028777;227;0
vpja76;19;9431;9570;-96,0237410071942;255,544964028777;139;255
vpja76;19;9640;9941;-477,123741007194;197,744964028777;301;0
vpja76;19;9961;10000;-509,623741007194;176,744964028777;39;255255000
vpja76;20;92;355;28,877746505523;-52,402823648697;263;2,55e+08
vpja76;20;421;545;-370,922253494477;346,297176351303;124;0
vpja76;20;594;760;-501,422253494477;304,597176351303;166;255
vpja76;20;827;991;41,377746505523;313,797176351303;164;255255000
vpja76;20;1067;1808;10,4777465055229;-303,402823648697;741;255000
vpja76;20;1891;2062;65,377746505523;406,797176351303;171;255255000
vpja76;20;2134;2341;-430,322253494477;310,297176351303;207;255
vpja76;20;2395;2510;-199,822253494477;358,097176351303;115;0
vpja76;20;2565;2849;39,6777465055229;395,897176351303;284;255255000
vpja76;20;2899;3051;-105,322253494477;370,297176351303;152;0
vpja76;20;3127;3277;324,577746505523;198,797176351303;150;0
vpja76;20;3322;3453;507,977746505523;177,397176351303;131;0
vpja76;20;3538;3865;-187,622253494477;-228,002823648697;327;0
vpja76;20;3917;4121;-323,122253494477;-201,302823648697;204;0
vpja76;20;4164;4427;-180,222253494477;-271,702823648697;263;0
vpja76;20;4494;4852;-499,822253494477;-284,002823648697;358;0
vpja76;20;5102;5303;-270,322253494477;-27,002823648697;201;0
vpja76;20;5368;5515;-271,222253494477;316,097176351303;147;0
vpja76;20;5542;5655;-365,722253494477;429,397176351303;113;0
vpja76;20;6402;6652;-524,722253494477;420,597176351303;250;0
vpja76;20;6671;7093;-490,022253494477;296,497176351303;422;255
vpja76;20;7111;7363;-521,322253494477;292,897176351303;252;255
vpja76;20;7438;7558;-4,72225349447706;322,097176351303;120;255255000
vpja76;20;7583;7729;64,5777465055229;358,997176351303;146;255255000
vpja76;20;8081;8116;-553,822253494477;411,797176351303;35;255
vpja76;20;8129;8336;-536,322253494477;287,597176351303;207;255
vpja76;20;8388;8484;-366,622253494477;297,797176351303;96;0
vpja76;20;8517;8628;-490,622253494477;306,897176351303;111;255
vpja76;20;8644;8699;-545,122253494477;312,797176351303;55;255
vpja76;20;9402;9727;-386,822253494477;314,097176351303;325;0
vpja76;20;9774;10000;-460,722253494477;311,797176351303;226;255
vpja76;21;288;393;34,6;-291,4;105;255000
vpja76;21;456;605;-242,7;117,5;149;255255000
vpja76;21;630;755;-306,9;143,6;125;0
vpja76;21;815;1117;281,4;192,5;302;255
vpja76;21;1137;1380;319,3;217,7;243;0
vpja76;21;1458;2026;-278,5;130;568;255255000
vpja76;21;2059;2489;-347,2;139,7;430;255255000
vpja76;21;2508;3429;-307,4;123,1;921;255255000
vpja76;21;3446;3678;-271,2;120,3;232;255255000
vpja76;21;3697;3905;-312,7;122,1;208;255255000
vpja76;21;3913;4220;-332,8;122,7;307;255255000
vpja76;21;4483;4681;-330,1;123,6;198;255255000
vpja76;21;4758;5012;287,6;197,2;254;255
vpja76;21;5082;5300;68,9;-256,2;218;255000
vpja76;21;5346;5478;41,8000000000001;-140,1;132;2,55e+08
vpja76;21;5533;5696;46,2;-318,4;163;255000
vpja76;21;5707;6152;37,6;-304,1;445;255000
vpja76;21;6169;6359;16,8000000000001;-270,6;190;255000
vpja76;21;6377;6781;36,1;-302,3;404;255000
vpja76;21;6888;7134;-221,1;233;246;0
vpja76;21;7200;7580;317;217,6;380;255
vpja76;21;7652;7745;-128,6;137,2;93;0
vpja76;21;7797;8097;-354,6;119,4;300;255255000
vpja76;21;8114;8189;-397,7;115,4;75;0
vpja76;21;8249;8311;-276,8;-65,6;62;0
vpja76;21;8318;8338;-286,7;-21,2;20;0
vpja76;21;8978;9309;-363;112,1;331;255255000
vpja76;21;9358;9448;-177,7;96,4;90;0
vpja76;21;9533;9582;240,2;215,5;49;0
vpja76;21;9592;9797;387,9;227,3;205;0
vpja76;21;9925;10000;173,6;-201,3;75;0
vpja76;22;561;722;-83,3;-106,5;161;0
vpja76;22;765;1044;11,7;-283,1;279;255000
vpja76;22;1103;1347;-131,1;-48,4;244;0
vpja76;22;1375;1634;-70,4;-23,5;259;255255000
vpja76;22;1682;2028;-193,4;-61,7;346;255
vpja76;22;2064;2300;-80,4;-33,7;236;255255000
vpja76;22;2322;2447;-36,9;-54,8;125;0
vpja76;22;2641;2775;-182;-71,4;134;0
vpja76;22;2800;3059;-224,9;-91,7;259;255
vpja76;22;3122;3495;-22,9;-302,2;373;255000
vpja76;22;3555;3706;-128,7;-29,5;151;0
vpja76;22;3775;4063;387;-16,1;288;0
vpja76;22;4133;4349;-177,9;-33,7;216;0
vpja76;22;4374;4672;-224,4;-21,7;298;255
vpja76;22;4734;5071;41;-281,9;337;2,55e+08
vpja76;22;5124;5430;-100,1;-288,2;306;0
vpja76;22;5489;5791;-186,7;-55,4;302;0
vpja76;22;5810;6297;-209,1;-91,5;487;255
vpja76;22;6337;6585;-128,2;-156,8;248;0
vpja76;22;6828;7569;-204,3;-90,1;741;255
vpja76;22;7608;8029;-61,9;-56,8;421;0
vpja76;22;8070;8228;-47,1;-161,3;158;0
vpja76;22;8269;8548;26,1;-273,1;279;2,55e+08
vpja76;22;8599;9002;-111,6;-247,5;403;0
vpja76;22;9039;9552;27,6;-321;513;255000
vpja76;22;9620;9835;-120,7;-24,2;215;0
vpja76;22;9874;10000;-224,4;-48,2;126;255
vpja76;23;34;316;18,8575971731449;7,41519434628981;282;2,55e+08
vpja76;23;380;488;-320,642402826855;245,11519434629;108;0
vpja76;23;541;762;-471,042402826855;369,51519434629;221;255
vpja76;23;825;995;233,157597173145;337,51519434629;170;0
vpja76;23;1020;1238;292,757597173145;323,11519434629;218;0
vpja76;23;1312;1456;-407,442402826855;371,31519434629;144;0
vpja76;23;1487;1686;-488,842402826855;388,31519434629;199;255
vpja76;23;1765;1944;282,457597173145;334,81519434629;179;0
vpja76;23;1970;2253;291,157597173145;294,61519434629;283;255255000
vpja76;23;2275;2659;334,657597173145;345,61519434629;384;255255000
vpja76;23;2732;2833;95,0575971731449;24,9151943462898;101;2,55e+08
vpja76;23;2899;3264;-87,8424028268552;-261,88480565371;365;255000
vpja76;23;3285;3943;-102,442402826855;-300,68480565371;658;255000
vpja76;23;4594;4670;-94,3424028268552;-1,48480565371017;76;2,55e+08
vpja76;23;4733;4924;-92,3424028268552;-276,38480565371;191;255000
vpja76;23;4960;5210;-42,0424028268552;-112,08480565371;250;2,55e+08
vpja76;23;5314;5385;268,957597173145;421,81519434629;71;0
vpja76;23;5393;6018;311,657597173145;321,01519434629;625;255255000
vpja76;23;6052;6523;265,657597173145;278,01519434629;471;255255000
vpja76;23;6559;6734;353,957597173145;352,71519434629;175;0
vpja76;23;6757;6868;310,157597173145;330,91519434629;111;255255000
vpja76;23;6929;7058;485,457597173145;61,1151943462899;129;0
vpja76;23;7087;7512;356,057597173145;45,8151943462898;425;0
vpja76;23;7550;7713;240,257597173145;-42,8848056537101;163;0
vpja76;23;7778;7966;-21,5424028268552;-276,18480565371;188;255000
vpja76;23;7994;8709;-77,0424028268552;-301,68480565371;715;255000
vpja76;23;8767;8872;132,457597173145;-177,18480565371;105;2,55e+08
vpja76;23;8990;9038;305,457597173145;305,01519434629;48;255255000
vpja76;23;9070;9093;213,957597173145;228,71519434629;23;0
vpja76;23;9112;9322;198,657597173145;15,5151943462898;210;2,55e+08
vpja76;23;9386;10000;-34,9424028268552;-277,88480565371;614;255000
vpja76;24;259;386;20,9;-230,2;127;255000
vpja76;24;454;655;-407,5;245,1;201;255
vpja76;24;694;888;-452,7;175,6;194;255
vpja76;24;962;1170;271,9;248,4;208;255255000
vpja76;24;1194;1514;346,5;229,1;320;255255000
vpja76;24;1534;1774;329,4;203,7;240;255255000
vpja76;24;1815;2093;332,4;290,4;278;255255000
vpja76;24;2138;2572;329,2;210,2;434;255255000
vpja76;24;2601;2912;338,6;285,3;311;255255000
vpja76;24;2944;3308;324,8;210,7;364;255255000
vpja76;24;3365;3629;4,89999999999998;-8;264;2,55e+08
vpja76;24;3687;3895;6,89999999999998;-219,1;208;255000
vpja76;24;3915;4708;11;-248,9;793;255000
vpja76;24;4762;4993;13,3;-34,3000000000001;231;2,55e+08
vpja76;24;5024;5240;-16;66,8;216;2,55e+08
vpja76;24;5294;5389;-217,2;131,8;95;0
vpja76;24;5441;5695;55,8;-79,3000000000001;254;2,55e+08
vpja76;24;5746;6125;23,9;-252,8;379;255000
vpja76;24;6142;6276;-0,100000000000023;-252,4;134;255000
vpja76;24;6319;6698;196,8;-355,5;379;0
vpja76;24;6725;6976;227,5;-276,4;251;0
vpja76;24;7030;7235;37,2;-258,6;205;255000
vpja76;24;7252;7477;10,6;-244,6;225;255000
vpja76;24;7627;8093;26,8;-235,7;466;255000
vpja76;24;8165;8327;424,2;128,6;162;0
vpja76;24;8419;8677;-429,7;128,4;258;255
vpja76;24;8702;8897;-430,8;186,2;195;255
vpja76;24;8937;9128;-531,6;81;191;0
vpja76;24;9159;9280;-525,9;38,6999999999999;121;0
vpja76;24;9335;9749;-458,2;236;414;255
vpja76;24;9781;10000;-374,7;246,1;219;255
vpja76;25;340;520;-399,4;96,6999999999999;180;255
vpja76;25;580;807;153,2;219,2;227;255255000
vpja76;25;882;1048;-390,8;165,9;166;255
vpja76;25;1078;1226;-437,1;93,5999999999999;148;255
vpja76;25;1296;1447;127,1;-62,3000000000001;151;2,55e+08
vpja76;25;1502;1619;148,3;-253,7;117;255000
vpja76;25;1698;1861;-407,1;52,6999999999999;163;255
vpja76;25;1890;2261;-466,5;96,6999999999999;371;255
vpja76;25;2283;2589;-496,3;140,5;306;255
vpja76;25;2627;2954;-404,5;82,6999999999999;327;255
vpja76;25;2974;3355;-411;40,0999999999999;381;255
vpja76;25;3401;3621;-477,3;114,3;220;255
vpja76;25;3828;4204;-481,4;99,0999999999999;376;255
vpja76;25;4240;4864;-394,7;61,0999999999999;624;255
vpja76;25;4904;5300;-481,7;70,3;396;255
vpja76;25;5349;5527;-382,7;112,8;178;255
vpja76;25;5597;5786;151,2;-40,2;189;2,55e+08
vpja76;25;5846;6016;200;-297,1;170;255000
vpja76;25;6044;6203;131,5;-276,8;159;255000
vpja76;25;6288;6454;-365,5;23,4;166;255
vpja76;25;6501;6938;-439,7;98,3;437;255
vpja76;25;7018;7233;179,1;32,6999999999999;215;0
vpja76;25;7267;7492;145,3;-44,6;225;2,55e+08
vpja76;25;7529;7640;194,7;13,6999999999999;111;2,55e+08
vpja76;25;7697;7846;409,1;-203,9;149;0
vpja76;25;7886;8083;300,6;-325,3;197;0
vpja76;25;8152;8309;-77,8;-374,9;157;0
vpja76;25;8332;8521;-109,5;-400,7;189;0
vpja76;25;8543;8794;-59,1;-410,6;251;0
vpja76;25;8828;9004;-143,1;-414,1;176;0
vpja76;25;9032;9353;-63,1;-412,5;321;0
vpja76;25;9374;9579;-27,4;-409,2;205;0
vpja76;25;9616;9756;-110;-411,4;140;0
vpja76;25;9826;10000;-390,9;-201,9;174;0
vpja76;26;54;138;-108,522253494477;191,597176351303;84;2,55e+08
vpja76;26;167;373;-87,8222534944771;10,897176351303;206;2,55e+08
vpja76;26;428;678;-204,322253494477;372,297176351303;250;0
vpja76;26;729;944;-437,322253494477;290,997176351303;215;255
vpja76;26;1004;1249;-65,5222534944771;332,097176351303;245;255255000
vpja76;26;1271;1812;-97,622253494477;344,197176351303;541;255255000
vpja76;26;1886;2025;-444,722253494477;319,897176351303;139;255
vpja76;26;2086;2212;-183,722253494477;-173,102823648697;126;255000
vpja76;26;2239;2508;-186,122253494477;-228,602823648697;269;255000
vpja76;26;2581;2779;-420,622253494477;258,297176351303;198;255
vpja76;26;2803;3246;-457,422253494477;285,997176351303;443;255
vpja76;26;3320;3452;-155,622253494477;-119,302823648697;132;2,55e+08
vpja76;26;3501;3729;-146,522253494477;-240,702823648697;228;255000
vpja76;26;3804;4236;-407,122253494477;289,097176351303;432;255
vpja76;26;4260;4551;-454,922253494477;290,797176351303;291;255
vpja76;26;4795;4948;-469,322253494477;388,997176351303;153;0
vpja76;26;5008;5341;-133,522253494477;313,597176351303;333;255255000
vpja76;26;5403;5598;-436,522253494477;290,597176351303;195;255
vpja76;26;5659;5857;-78,2222534944771;290,097176351303;198;255255000
vpja76;26;5928;6210;-116,822253494477;-201,402823648697;282;0
vpja76;26;6246;6646;-198,922253494477;-222,102823648697;400;255000
vpja76;26;6725;6944;-88,122253494477;342,197176351303;219;255255000
vpja76;26;7016;7197;-167,122253494477;-237,602823648697;181;255000
vpja76;26;7223;7858;-192,922253494477;-225,502823648697;635;255000
vpja76;26;8034;8079;-233,922253494477;433,797176351303;45;0
vpja76;26;8099;9979;-171,122253494477;200,297176351303;1880;2,55e+08
