vp;trial;timest;timeend;x;y;duration;roi
vpja13;1;318;530;-29,9;-279,9;212;255000
vpja13;1;544;754;-54,2;-257,1;210;255000
vpja13;1;851;1026;-266,3;220;175;255
vpja13;1;1095;1343;316,9;238,7;248;255255000
vpja13;1;1375;1530;287,9;165,5;155;255255000
vpja13;1;1579;1700;307,1;-71,1999999999999;121;0
vpja13;1;1739;1875;131,6;-63,8;136;2,55e+08
vpja13;1;1940;2108;-348,5;8;168;0
vpja13;1;2137;2464;-327,5;-70,4;327;0
vpja13;1;2497;2729;-426,5;10;232;0
vpja13;1;2773;2918;-210,7;-63;145;0
vpja13;1;2973;3156;-32,2;-282,9;183;255000
vpja13;1;3231;3448;333,6;177,5;217;255255000
vpja13;1;3476;3681;372;236,5;205;255255000
vpja13;1;3703;3857;417,3;216,8;154;255255000
vpja13;1;3886;4032;316,6;256,6;146;255255000
vpja13;1;4041;4208;301;266,2;167;0
vpja13;1;4217;4496;313;272,8;279;0
vpja13;1;4532;4696;350,8;202,4;164;255255000
vpja13;1;4719;4949;404,1;195,4;230;255255000
vpja13;1;5023;5361;-248,2;221;338;255
vpja13;1;5426;5577;318,6;232,6;151;255255000
vpja13;1;5605;5832;410,3;223,9;227;255255000
vpja13;1;5884;6110;522,6;-34,5;226;0
vpja13;1;6130;6421;528,3;-81,1;291;0
vpja13;1;6454;6800;573,9;1,40000000000009;346;0
vpja13;1;6890;7070;-222,7;-11,5;180;0
vpja13;1;7107;7368;-396,1;-23,0999999999999;261;0
vpja13;1;7427;7760;-400,3;267,1;333;255
vpja13;1;7797;7927;-272,5;253,3;130;255
vpja13;1;7988;8126;-66,9;-227,7;138;255000
vpja13;1;8153;8500;-44,3000000000001;-307;347;255000
vpja13;1;8510;8754;-41;-297,7;244;255000
vpja13;1;8770;9493;-47,1;-268;723;255000
vpja13;1;9511;9860;-39,8000000000001;-316,4;349;255000
vpja13;1;9909;10000;-33;-62,8;91;2,55e+08
vpja13;2;317;596;-355,5;-96,9;279;2,55e+08
vpja13;2;644;820;-316,7;172,7;176;255
vpja13;2;838;1102;-325,7;139,6;264;255
vpja13;2;1157;1416;-368,6;-109,2;259;2,55e+08
vpja13;2;1467;1614;-335,3;109,6;147;255
vpja13;2;1670;1831;-247,3;-207,2;161;0
vpja13;2;1864;2130;-356,9;-123,6;266;255000
vpja13;2;2146;2336;-368,3;-113,9;190;255000
vpja13;2;2359;2770;-343,9;-142,9;411;255000
vpja13;2;2785;2956;-344,2;-111;171;255000
vpja13;2;3008;3398;-364,1;137,1;390;255
vpja13;2;3473;3644;-558,1;458,2;171;0
vpja13;2;3718;3831;-357,2;-38,3000000000001;113;2,55e+08
vpja13;2;3860;4464;-365,7;-144,9;604;255000
vpja13;2;4515;4615;-80;-64,6;100;0
vpja13;2;4668;4870;-344,3;-140,2;202;255000
vpja13;2;4917;5073;-265,1;98,5;156;255
vpja13;2;5126;5499;-170,7;-244,2;373;0
vpja13;2;5535;5679;-68,5;-331,3;144;0
vpja13;2;5724;5974;69,1;-404,8;250;0
vpja13;2;6044;6236;522,7;-255;192;0
vpja13;2;6269;6488;527,7;-151,5;219;0
vpja13;2;6512;6735;469,9;-154,1;223;0
vpja13;2;6791;6923;384;84,6999999999999;132;0
vpja13;2;6975;7194;30,6;39,6999999999999;219;255255000
vpja13;2;7217;7445;7,5;4;228;255255000
vpja13;2;7519;7715;434,7;272,3;196;0
vpja13;2;7749;7923;520,6;410,4;174;0
vpja13;2;7967;8141;367,1;236,1;174;0
vpja13;2;8241;8384;-545,2;116,2;143;0
vpja13;2;8448;8703;-605,8;488,8;255;NA
vpja13;2;8725;9028;-618,6;442,2;303;0
vpja13;2;9091;9374;-588,9;100,3;283;0
vpja13;2;9459;9710;-151;-281,1;251;0
vpja13;2;9735;9884;-217,9;-267,6;149;0
vpja13;2;9907;10000;-254,7;-300;93;0
vpja13;3;318;561;-14;-245,5;243;255000
vpja13;3;577;913;-18,7;-256,8;336;255000
vpja13;3;926;1563;-19,4000000000001;-273,4;637;255000
vpja13;3;1591;2049;-0,100000000000023;-274,2;458;255000
vpja13;3;2264;2521;-19,1;-255;257;255000
vpja13;3;2545;2738;-4,40000000000009;-266,9;193;255000
vpja13;3;2812;3194;-344,2;148,3;382;0
vpja13;3;3217;3951;-357;111,8;734;255
vpja13;3;4002;4168;-311,4;320,8;166;0
vpja13;3;4222;4390;-576,9;70,7;168;0
vpja13;3;4414;4664;-640,2;85,6;250;NA
vpja13;3;4689;5274;-575,7;74,7;585;0
vpja13;3;5384;5554;487,4;-26,5;170;0
vpja13;3;5580;5718;557,8;-28,4;138;0
vpja13;3;5759;5911;577,5;-115,9;152;0
vpja13;3;5934;6241;606,6;-61,5;307;0
vpja13;3;6291;6588;533,6;-268,6;297;0
vpja13;3;6638;6781;245,4;-274,5;143;0
vpja13;3;6821;6958;42,4;-304,3;137;255000
vpja13;3;6986;7226;-19,8000000000001;-292,7;240;255000
vpja13;3;7257;7398;86;-288,6;141;0
vpja13;3;7463;7749;296,5;97,3;286;0
vpja13;3;7762;8086;283,2;123,2;324;255255000
vpja13;3;8153;8491;-326,8;116,7;338;255
vpja13;3;8560;8783;-54,8000000000001;409;223;0
vpja13;3;8815;8939;88,5999999999999;473,5;124;0
vpja13;3;9000;9194;315,1;101,9;194;0
vpja13;3;9249;9461;80,8999999999999;-91,5;212;2,55e+08
vpja13;3;9492;9749;-51,8000000000001;27,1;257;2,55e+08
vpja13;3;9767;9836;-74,4000000000001;34,2;69;2,55e+08
vpja13;3;9881;10000;-19,7;-120,3;119;2,55e+08
vpja13;4;72;205;11,6999999999999;-9,60000000000002;133;0
vpja13;4;242;594;61,9;-30,3000000000001;352;255000
vpja13;4;605;730;52,9;-36,4000000000001;125;255000
vpja13;4;774;1066;37,1999999999999;203,4;292;255
vpja13;4;1086;1338;71,4;203,6;252;255
vpja13;4;1352;1488;47,1999999999999;198,4;136;255
vpja13;4;1533;1746;55,1999999999999;-30,1;213;255000
vpja13;4;1781;1910;-63,8000000000001;18,8;129;0
vpja13;4;1940;2080;38,8;-37,6;140;255000
vpja13;4;2326;2419;76,6;14;93;2,55e+08
vpja13;4;2463;2583;35,6999999999999;178,3;120;255
vpja13;4;2627;2844;58;-28,6;217;255000
vpja13;4;2864;3096;57,8;-57,4;232;255000
vpja13;4;3147;3318;72,1;179,7;171;255
vpja13;4;3361;3697;316;102,5;336;255255000
vpja13;4;3716;3880;300,4;99;164;255255000
vpja13;4;3935;4065;20,3;-101,3;130;255000
vpja13;4;4110;4263;-62;-214,9;153;0
vpja13;4;4308;4466;-306,1;-239,2;158;0
vpja13;4;4545;4696;-518,7;120,6;151;0
vpja13;4;4722;4850;-568,5;164,7;128;0
vpja13;4;4927;5082;-0,100000000000023;-170,4;155;0
vpja13;4;5140;5294;404,5;-159,8;154;0
vpja13;4;5320;5874;341,1;-161,8;554;0
vpja13;4;5903;6197;417,6;-189,9;294;0
vpja13;4;6225;6456;333,5;-179,1;231;0
vpja13;4;6558;6804;-524,1;161,2;246;0
vpja13;4;6818;7268;-555,9;160,8;450;0
vpja13;4;7329;7521;34;45,9;192;2,55e+08
vpja13;4;7590;7832;67,6999999999999;436,6;242;0
vpja13;4;7883;8011;313,7;432,1;128;0
vpja13;4;8064;8253;438,2;47,5999999999999;189;0
vpja13;4;8303;8542;415,1;-201,5;239;0
vpja13;4;8586;8715;507,4;-278,6;129;0
vpja13;4;8751;8947;326,9;-282,8;196;0
vpja13;4;9003;9093;43,6;-367,2;90;0
vpja13;4;9179;9305;-478,3;73,5;126;0
vpja13;4;9335;9789;-558,4;142,4;454;0
vpja13;4;9809;10000;-549,4;154,8;191;0
vpja13;5;24;257;16,7301527715491;-9,58566355662651;233;2,55e+08
vpja13;5;312;516;-62,169847228451;-186,185663556627;204;255000
vpja13;5;527;1178;-88,3698472284509;-167,385663556627;651;255000
vpja13;5;1203;1451;-74,2698472284509;-165,285663556627;248;255000
vpja13;5;1508;1611;-6,26984722845089;149,414336443373;103;0
vpja13;5;1653;1902;-243,669847228451;125,814336443373;249;0
vpja13;5;1918;2202;-266,169847228451;127,814336443373;284;0
vpja13;5;2223;3065;-255,569847228451;124,714336443373;842;0
vpja13;5;3118;3381;95,130152771549;120,214336443373;263;0
vpja13;5;3403;3576;134,030152771549;131,414336443373;173;0
vpja13;5;3587;3762;152,230152771549;137,114336443374;175;0
vpja13;5;3826;3949;-223,669847228451;141,114336443374;123;0
vpja13;5;3968;4243;-263,869847228451;139,814336443373;275;0
vpja13;5;4295;4553;85,7301527715491;123,214336443373;258;0
vpja13;5;4580;4778;144,830152771549;129,514336443374;198;0
vpja13;5;4804;5216;74,830152771549;128,414336443373;412;0
vpja13;5;5241;5470;116,930152771549;118,614336443374;229;0
vpja13;5;5520;5686;158,630152771549;19,5143364433735;166;0
vpja13;5;5733;5945;363,430152771549;-65,4856635566265;212;0
vpja13;5;5958;6119;343,530152771549;-48,9856635566265;161;0
vpja13;5;6173;6519;596,030152771549;-209,185663556627;346;0
vpja13;5;6571;6740;316,330152771549;-62,2856635566266;169;0
vpja13;5;6764;7096;353,230152771549;-57,2856635566266;332;0
vpja13;5;7154;7517;601,630152771549;-219,385663556627;363;0
vpja13;5;7656;7948;17,0301527715491;378,814336443373;292;0
vpja13;5;8017;8232;-353,969847228451;408,014336443374;215;0
vpja13;5;8277;8500;-410,669847228451;168,914336443373;223;0
vpja13;5;8563;8831;-119,869847228451;-149,685663556627;268;255000
vpja13;5;8864;9028;-92,2698472284509;-174,485663556626;164;255000
vpja13;5;9083;9415;155,830152771549;-317,085663556627;332;0
vpja13;5;9470;9732;-117,769847228451;-174,185663556627;262;255000
vpja13;5;9915;10000;30,5301527715491;-183,185663556627;85;0
vpja13;6;208;383;162,3;-125,8;175;255000
vpja13;6;407;910;163,1;-121,8;503;255000
vpja13;6;991;1168;-151,9;309,1;177;255
vpja13;6;1238;1507;368,1;406,3;269;255255000
vpja13;6;1551;1752;387;267,7;201;255255000
vpja13;6;1779;1915;457,4;320,3;136;255255000
vpja13;6;1980;2143;-104,3;287,8;163;255
vpja13;6;2170;2436;-170,9;286,3;266;255
vpja13;6;2461;2805;-131,3;309,1;344;255
vpja13;6;2832;3070;-210,4;305,8;238;255
vpja13;6;3098;3454;-144,8;316,7;356;255
vpja13;6;3464;3635;-156,6;326,4;171;255
vpja13;6;3658;4090;-210,6;302,8;432;255
vpja13;6;4163;4413;425,6;184,3;250;255255000
vpja13;6;4432;4523;436,1;159,8;91;0
vpja13;6;4589;4718;153,4;-208,2;129;255000
vpja13;6;4758;4944;-95,3000000000001;-235,9;186;0
vpja13;6;4992;5192;-325,1;-163,2;200;0
vpja13;6;5229;5345;-429,5;-109,4;116;0
vpja13;6;5407;5534;140,4;-145,7;127;255000
vpja13;6;5554;5787;167,2;-123,3;233;255000
vpja13;6;5808;6040;175,9;-158,6;232;255000
vpja13;6;6072;6217;175,7;-48,8000000000001;145;2,55e+08
vpja13;6;6252;6452;161,2;96,3;200;2,55e+08
vpja13;6;6477;6881;128,9;172,3;404;2,55e+08
vpja13;6;6925;7084;163,6;6,5;159;2,55e+08
vpja13;6;7129;7396;171,6;-114,2;267;255000
vpja13;6;7420;7584;127,8;-125,6;164;2,55e+08
vpja13;6;7606;7770;169,8;-144;164;255000
vpja13;6;7805;8055;174,7;-215,9;250;255000
vpja13;6;8072;8376;184,6;-187,9;304;255000
vpja13;6;8415;8618;-4,80000000000007;-92,4;203;0
vpja13;6;8660;8799;-186,5;-72,6;139;0
vpja13;6;8864;8992;-460,5;211,7;128;0
vpja13;6;9049;9167;-78,9;288,3;118;255
vpja13;6;9220;9437;162;10,0999999999999;217;2,55e+08
vpja13;6;9483;9682;149,6;-122,6;199;255000
vpja13;6;9703;10000;169,4;-121,5;297;255000
vpja13;7;248;378;-6,90571428571411;-210,477142857143;130;255000
vpja13;7;403;676;-27,6057142857142;-253,077142857143;273;255000
vpja13;7;690;1316;-12,7057142857142;-254,577142857143;626;255000
vpja13;7;1399;1537;-348,305714285714;233,422857142857;138;0
vpja13;7;1563;1912;-313,705714285714;188,522857142857;349;0
vpja13;7;1991;2135;309,794285714286;215,522857142857;144;255255000
vpja13;7;2161;2491;348,594285714286;225,822857142857;330;0
vpja13;7;2505;2910;355,894285714286;244,622857142857;405;0
vpja13;7;2986;3140;-289,205714285714;231,022857142857;154;0
vpja13;7;3164;3425;-328,005714285714;190,822857142857;261;0
vpja13;7;3443;3666;-351,605714285714;200,622857142857;223;0
vpja13;7;3754;4021;342,994285714286;217,922857142857;267;255255000
vpja13;7;4093;4317;249,694285714286;-366,177142857143;224;0
vpja13;7;4342;4607;234,194285714286;-442,477142857143;265;0
vpja13;7;4636;4787;247,094285714286;-441,277142857143;151;0
vpja13;7;4840;5117;-120,705714285714;-407,877142857143;277;0
vpja13;7;5185;5630;-600,205714285714;-448,677142857143;445;0
vpja13;7;5666;5916;-547,605714285714;-429,377142857143;250;0
vpja13;7;5984;6211;-490,305714285714;4,22285714285726;227;0
vpja13;7;6222;6613;-508,805714285714;32,8228571428573;391;0
vpja13;7;6656;6900;-388,705714285714;-138,077142857143;244;0
vpja13;7;6964;7177;-333,505714285714;-443,077142857143;213;0
vpja13;7;7215;7704;-132,505714285714;-401,677142857143;489;0
vpja13;7;7731;7879;-74,7057142857142;-383,477142857143;148;0
vpja13;7;7903;8050;-80,9057142857141;-444,677142857143;147;0
vpja13;7;8136;8324;-280,905714285714;133,222857142857;188;0
vpja13;7;8344;8498;-303,905714285714;168,622857142857;154;255
vpja13;7;8544;8645;-242,505714285714;402,322857142857;101;0
vpja13;7;8677;8823;-381,905714285714;393,722857142857;146;0
vpja13;7;8885;9154;-17,0057142857141;447,722857142857;269;0
vpja13;7;9212;9323;87,8942857142858;229,222857142857;111;0
vpja13;7;9363;9527;124,094285714286;151,522857142857;164;0
vpja13;7;9601;9793;-404,705714285714;349,222857142857;192;0
vpja13;7;9812;9979;-427,105714285714;329,322857142857;167;0
vpja13;8;106;225;10,930152771549;7,21433644337344;119;0
vpja13;8;270;410;-287,269847228451;-137,185663556627;140;255000
vpja13;8;444;898;-259,569847228451;-125,485663556626;454;255000
vpja13;8;961;1077;-79,169847228451;264,114336443374;116;255255000
vpja13;8;1130;1329;254,330152771549;76,1143364433735;199;255
vpja13;8;1352;1489;286,530152771549;66,1143364433735;137;255
vpja13;8;1550;1792;-154,269847228451;351,314336443373;242;255255000
vpja13;8;1816;2087;-102,869847228451;348,014336443374;271;255255000
vpja13;8;2109;2223;-135,869847228451;366,114336443374;114;255255000
vpja13;8;2286;2496;-266,169847228451;-145,885663556627;210;255000
vpja13;8;2526;2642;-242,669847228451;-128,985663556626;116;255000
vpja13;8;2685;2894;1,33015277154902;-150,985663556626;209;0
vpja13;8;2954;3097;-221,569847228451;60,0143364433735;143;2,55e+08
vpja13;8;3148;3313;-294,569847228451;-121,385663556627;165;255000
vpja13;8;3381;3995;-139,869847228451;356,714336443373;614;255255000
vpja13;8;4073;4190;262,130152771549;328,614336443374;117;0
vpja13;8;4251;4587;307,930152771549;-76,3856635566265;336;0
vpja13;8;4659;4838;115,830152771549;-312,285663556627;179;0
vpja13;8;4864;5060;50,1301527715491;-373,385663556627;196;0
vpja13;8;5144;5293;-589,269847228451;-177,385663556627;149;0
vpja13;8;5340;5564;-629,269847228451;3,21433644337344;224;0
vpja13;8;5628;5781;-490,369847228451;-203,785663556627;153;0
vpja13;8;5805;6034;-461,769847228451;-218,485663556626;229;0
vpja13;8;6142;6467;568,130152771549;-19,3856635566265;325;0
vpja13;8;6531;6685;500,630152771549;320,314336443373;154;0
vpja13;8;6734;6904;282,530152771549;81,0143364433735;170;255
vpja13;8;6959;7235;-127,669847228451;330,714336443373;276;255255000
vpja13;8;7299;7630;-283,469847228451;-59,4856635566265;331;2,55e+08
vpja13;8;7675;7882;-260,269847228451;-124,785663556627;207;255000
vpja13;8;7930;8145;-322,269847228451;100,814336443373;215;2,55e+08
vpja13;8;8183;8290;-365,869847228451;42,1143364433735;107;2,55e+08
vpja13;8;8333;8543;-306,569847228451;-148,985663556626;210;255000
vpja13;8;8568;8681;-270,869847228451;-168,485663556626;113;255000
vpja13;8;8713;8913;-380,169847228451;-213,785663556627;200;255000
vpja13;8;8943;9130;-487,969847228451;-188,385663556627;187;0
vpja13;8;9155;9307;-461,369847228451;-225,685663556627;152;0
vpja13;8;9357;9678;-558,669847228451;-22,8856635566265;321;0
vpja13;8;9716;9869;-589,969847228451;-55,3856635566265;153;0
vpja13;8;9907;10000;-639,469847228451;-65,1856635566265;93;0
vpja13;9;43;194;10,6000000000001;2,5;151;2,55e+08
vpja13;9;237;373;109,7;-220,7;136;255000
vpja13;9;410;759;98,0000000000001;-280;349;255000
vpja13;9;782;1021;135,5;-282,5;239;255000
vpja13;9;1041;1169;110,9;-242,9;128;255000
vpja13;9;1207;1385;59,3000000000002;-386,1;178;255000
vpja13;9;1395;2222;62,8000000000002;-372,3;827;255000
vpja13;9;2312;2498;471;155,6;186;0
vpja13;9;2551;2806;319;391,8;255;255
vpja13;9;2826;3342;309,3;360,2;516;255
vpja13;9;3374;3609;334,8;362,1;235;255
vpja13;9;3690;3863;-375,4;236,1;173;0
vpja13;9;3903;4083;-441,9;251,7;180;255255000
vpja13;9;4123;4406;-268,1;188,5;283;0
vpja13;9;4425;4625;-297,9;193,6;200;0
vpja13;9;4651;4857;-258,3;170,9;206;0
vpja13;9;4885;5055;-179,6;168,7;170;0
vpja13;9;5118;5329;-278,9;-248,6;211;0
vpja13;9;5359;5531;-144,1;-242,9;172;0
vpja13;9;5558;5853;-143,3;-301,1;295;0
vpja13;9;5899;6038;-361,8;-214,7;139;0
vpja13;9;6075;6293;-575,4;-198,6;218;0
vpja13;9;6319;6567;-604,8;-241,6;248;0
vpja13;9;6680;7389;525,3;162,3;709;0
vpja13;9;7422;7918;533,8;249,4;496;0
vpja13;9;7952;8173;528,5;177,3;221;0
vpja13;9;8198;8414;514,4;118,1;216;0
vpja13;9;8499;8678;-75,0999999999998;370,5;179;0
vpja13;9;8723;8865;-264,3;375,2;142;0
vpja13;9;8902;9105;-416,1;416,7;203;255255000
vpja13;9;9177;9488;-459,8;-158,6;311;0
vpja13;9;9535;9821;-286,3;-236,5;286;0
vpja13;9;9867;10000;-588,1;-230,3;133;0
vpja13;10;242;517;-294;-150,9;275;255000
vpja13;10;591;979;-512,8;388,2;388;255255000
vpja13;10;1040;1165;41,4;334;125;0
vpja13;10;1200;1422;115,9;331,7;222;255
vpja13;10;1442;1802;116,3;301,7;360;255
vpja13;10;1833;2068;162,3;401;235;0
vpja13;10;2093;2352;187,7;413,4;259;0
vpja13;10;2400;2666;143,3;272,6;266;255
vpja13;10;2679;2938;122,6;280,5;259;255
vpja13;10;3019;3084;-374,4;341,4;65;0
vpja13;10;3130;3344;-496,1;380,5;214;255255000
vpja13;10;3367;3481;-536,3;354,8;114;255255000
vpja13;10;3542;3755;-556,3;-206,4;213;0
vpja13;10;3798;4069;-632,3;-65,8000000000001;271;0
vpja13;10;4122;4417;-576,2;-293;295;0
vpja13;10;4437;4727;-600,6;-275,3;290;0
vpja13;10;4755;4971;-568;-221,4;216;0
vpja13;10;5027;5247;-234,2;-324,2;220;255000
vpja13;10;5282;5427;-204;-313,9;145;0
vpja13;10;5468;5792;-331,8;-452,2;324;0
vpja13;10;5906;6079;467,6;97,1;173;0
vpja13;10;6107;6353;397,8;50,5;246;0
vpja13;10;6391;6518;303,3;9,5;127;0
vpja13;10;6573;6810;595,6;-74,3;237;0
vpja13;10;6829;7000;591,2;-105,7;171;0
vpja13;10;7097;7248;-247,3;-302,9;151;255000
vpja13;10;7288;7434;-383,8;-431,4;146;0
vpja13;10;7488;7828;-592,1;-199,2;340;0
vpja13;10;7865;7990;-550,4;-152,9;125;0
vpja13;10;8032;8158;-610,7;-92,9;126;0
vpja13;10;8209;8456;-309,2;-204,1;247;255000
vpja13;10;8480;8701;-293,8;-180,1;221;255000
vpja13;10;8759;8892;-311,7;76,6999999999999;133;2,55e+08
vpja13;10;8953;9193;-545,4;425,9;240;255255000
vpja13;10;9218;9526;-495,4;388,4;308;255255000
vpja13;10;9596;9986;113,3;306,5;390;255
vpja13;11;79;212;14,9;2,29999999999995;133;0
vpja13;11;254;363;-182;-83,8;109;2,55e+08
vpja13;11;392;631;-256,3;-167,6;239;0
vpja13;11;692;889;-240,6;220,1;197;2,55e+08
vpja13;11;938;1060;-456,5;378,4;122;255
vpja13;11;1133;1365;-75,7;-115;232;0
vpja13;11;1390;1498;-114,7;-174,8;108;0
vpja13;11;1540;1864;-231,7;-195,9;324;255000
vpja13;11;1892;2020;-138,5;-173,1;128;0
vpja13;11;2107;2304;-411,6;370,3;197;255
vpja13;11;2329;2773;-460,4;352;444;255
vpja13;11;2820;2973;-168;405,6;153;0
vpja13;11;2997;3185;-141,6;404,2;188;0
vpja13;11;3236;3568;-251,6;276,1;332;2,55e+08
vpja13;11;3626;3808;-259,5;-149,7;182;2,55e+08
vpja13;11;3834;4019;-240,3;-200,4;185;255000
vpja13;11;4038;4226;-244,8;-237,2;188;255000
vpja13;11;4259;4478;-63,1;-167,7;219;0
vpja13;11;4515;5038;13,9;-203,6;523;0
vpja13;11;5052;5213;8,09999999999991;-183,1;161;0
vpja13;11;5236;5709;17,6999999999999;-211,2;473;0
vpja13;11;5734;5954;6,5;-158,4;220;0
vpja13;11;5979;6286;19,4;-205,8;307;0
vpja13;11;6298;6711;13,5999999999999;-223,1;413;0
vpja13;11;6767;6986;-98;-138;219;0
vpja13;11;7022;7269;-47,2;-145,2;247;0
vpja13;11;7316;7589;-47;93,3;273;0
vpja13;11;7646;7845;233,9;-135,6;199;0
vpja13;11;7891;8118;306,3;-281,9;227;0
vpja13;11;8142;8403;306,7;-220,5;261;0
vpja13;11;8473;8601;446;77,2;128;0
vpja13;11;8630;8846;473,4;136,9;216;0
vpja13;11;8876;9199;568,6;183,6;323;0
vpja13;11;9309;9405;-387,3;-134,9;96;0
vpja13;11;9461;9702;-646;0,600000000000023;241;NA
vpja13;11;9765;10000;-599,8;382;235;0
vpja13;12;238;427;-26,9064814814815;-207,460185185185;189;255000
vpja13;12;449;857;-30,1064814814815;-229,660185185185;408;255000
vpja13;12;881;1081;-47,7064814814814;-188,860185185185;200;255000
vpja13;12;1111;1260;-29,2064814814814;-213,060185185185;149;255000
vpja13;12;1339;1598;-397,906481481481;262,039814814815;259;255
vpja13;12;1624;1855;-383,906481481481;314,739814814815;231;255
vpja13;12;1943;2137;-11,1064814814815;-194,060185185185;194;255000
vpja13;12;2157;2445;-32,8064814814815;-222,960185185185;288;255000
vpja13;12;2546;2748;434,393518518518;241,139814814815;202;255255000
vpja13;12;2774;2992;455,593518518519;228,639814814815;218;255255000
vpja13;12;3017;3352;435,393518518518;299,039814814815;335;255255000
vpja13;12;3376;3574;452,593518518519;284,339814814815;198;255255000
vpja13;12;3586;3780;435,193518518518;277,839814814815;194;255255000
vpja13;12;3808;3928;440,093518518519;210,739814814815;120;255255000
vpja13;12;3995;4133;16,5935185185185;-192,160185185185;138;255000
vpja13;12;4161;4280;-31,5064814814815;-232,860185185185;119;255000
vpja13;12;4363;4616;-397,406481481481;280,239814814815;253;255
vpja13;12;4662;4828;-486,406481481481;116,739814814815;166;0
vpja13;12;4867;5079;-395,206481481481;280,639814814815;212;255
vpja13;12;5103;5560;-417,106481481482;252,039814814815;457;255
vpja13;12;5594;5939;-384,706481481481;273,239814814815;345;255
vpja13;12;5986;6210;-451,006481481482;93,3398148148149;224;0
vpja13;12;6246;6386;-394,506481481482;107,839814814815;140;0
vpja13;12;6448;6725;-583,006481481482;-196,660185185185;277;0
vpja13;12;6779;7013;-478,806481481481;131,839814814815;234;0
vpja13;12;7110;7217;228,893518518518;-232,460185185185;107;0
vpja13;12;7263;7520;207,193518518518;-381,860185185185;257;0
vpja13;12;7558;7742;322,993518518519;-292,860185185185;184;0
vpja13;12;7767;7904;341,193518518518;-309,860185185185;137;0
vpja13;12;7964;8517;506,393518518518;29,9398148148149;553;0
vpja13;12;8803;8920;-430,906481481481;139,439814814815;117;0
vpja13;12;8971;9218;-253,606481481482;344,439814814815;247;0
vpja13;12;9262;9398;-84,1064814814815;401,939814814815;136;0
vpja13;12;9466;9659;-40,7064814814814;-192,160185185185;193;255000
vpja13;12;9680;9809;-41,5064814814815;-234,960185185185;129;255000
vpja13;12;9857;10000;-5,0064814814815;-11,0601851851851;143;2,55e+08
vpja13;13;327;618;16,910743801653;-324,485123966942;291;255000
vpja13;13;635;1088;10,910743801653;-338,885123966942;453;255000
vpja13;13;1178;1367;-298,789256198347;86,6148760330578;189;255
vpja13;13;1505;1660;375,310743801653;263,914876033058;155;255255000
vpja13;13;1689;2017;409,410743801653;340,214876033058;328;0
vpja13;13;2054;2193;355,510743801653;246,114876033058;139;255255000
vpja13;13;2247;2383;93,7107438016531;75,6148760330578;136;2,55e+08
vpja13;13;2416;2629;35,910743801653;158,814876033058;213;2,55e+08
vpja13;13;2714;2826;335,610743801653;313,714876033058;112;255255000
vpja13;13;2854;3030;411,410743801653;342,114876033058;176;0
vpja13;13;3091;3287;545,310743801653;-138,885123966942;196;0
vpja13;13;3350;3487;53,7107438016529;-260,685123966942;137;255000
vpja13;13;3547;3713;-327,689256198347;-219,785123966942;166;0
vpja13;13;3742;4007;-448,189256198347;-255,385123966942;265;0
vpja13;13;4037;4201;-371,789256198347;-217,885123966942;164;0
vpja13;13;4236;4352;-284,089256198347;-159,385123966942;116;0
vpja13;13;4429;4580;132,810743801653;-296,085123966942;151;0
vpja13;13;4618;4911;190,810743801653;-337,985123966942;293;0
vpja13;13;4986;5169;-389,289256198347;-258,785123966942;183;0
vpja13;13;5194;5412;-453,489256198347;-278,085123966942;218;0
vpja13;13;5432;5672;-491,889256198347;-275,785123966942;240;0
vpja13;13;5712;5894;-430,289256198347;-428,685123966942;182;0
vpja13;13;5929;6079;-340,089256198347;-404,285123966942;150;0
vpja13;13;6113;6289;-179,689256198347;-381,885123966942;176;0
vpja13;13;6325;6464;42,1107438016529;-350,685123966942;139;255000
vpja13;13;6484;6681;17,510743801653;-348,985123966942;197;255000
vpja13;13;6733;6930;42,410743801653;-93,6851239669422;197;2,55e+08
vpja13;13;6994;7300;49,2107438016529;153,214876033058;306;2,55e+08
vpja13;13;7315;7496;60,410743801653;179,514876033058;181;2,55e+08
vpja13;13;7554;7681;77,510743801653;-295,685123966942;127;255000
vpja13;13;7713;8040;15,1107438016529;-343,185123966942;327;255000
vpja13;13;8082;8245;199,710743801653;-265,185123966942;163;0
vpja13;13;8283;8525;247,410743801653;-205,185123966942;242;0
vpja13;13;8581;8923;208,010743801653;-427,585123966942;342;0
vpja13;13;8993;9322;549,910743801653;-175,585123966942;329;0
vpja13;13;9370;9528;235,410743801653;-213,885123966942;158;0
vpja13;13;9581;9707;-87,7892561983471;-199,585123966942;126;0
vpja13;13;9766;9890;-380,889256198347;-252,085123966942;124;0
vpja13;13;9919;10000;-470,589256198347;-308,185123966942;81;0
vpja13;14;284;515;-117,002405498282;-210,666666666667;231;255000
vpja13;14;583;721;-209,402405498282;325,633333333333;138;0
vpja13;14;745;917;-154,802405498282;317,533333333334;172;0
vpja13;14;928;1086;-137,402405498282;320,233333333333;158;0
vpja13;14;1138;1342;245,497594501718;198,833333333333;204;255255000
vpja13;14;1363;1732;267,097594501718;190,133333333333;369;255255000
vpja13;14;1787;1945;-153,102405498282;290,633333333333;158;0
vpja13;14;1964;2101;-132,502405498282;299,233333333333;137;0
vpja13;14;2168;2499;-130,602405498282;-196,666666666667;331;255000
vpja13;14;2524;2733;-79,9024054982817;-229,166666666667;209;255000
vpja13;14;2754;2883;-106,702405498282;-222,666666666667;129;255000
vpja13;14;2932;3142;-115,802405498282;-22,9666666666665;210;2,55e+08
vpja13;14;3167;3342;-105,002405498282;-78,1666666666665;175;2,55e+08
vpja13;14;3353;3588;-101,902405498282;-49,3666666666666;235;2,55e+08
vpja13;14;3629;3861;-100,702405498282;-219,366666666667;232;255000
vpja13;14;3880;4233;-123,102405498282;-230,266666666667;353;255000
vpja13;14;4259;4475;-101,802405498282;-278,066666666666;216;255000
vpja13;14;4520;4617;-100,902405498282;-163,166666666667;97;255000
vpja13;14;4655;4886;-115,402405498282;-226,666666666667;231;255000
vpja13;14;4904;5161;-98,9024054982817;-237,866666666667;257;255000
vpja13;14;5175;5514;-120,402405498282;-247,366666666667;339;255000
vpja13;14;5551;5778;-85,4024054982817;-222,966666666667;227;255000
vpja13;14;5812;6130;-32,4024054982817;-228,966666666667;318;255000
vpja13;14;6151;6182;-22,7024054982817;-213,766666666667;31;0
vpja13;14;6248;6456;-0,902405498281723;139,933333333334;208;2,55e+08
vpja13;14;6483;6626;-33,6024054982817;178,833333333333;143;2,55e+08
vpja13;14;6650;6917;-72,6024054982817;155,133333333333;267;2,55e+08
vpja13;14;6948;7663;-14,4024054982817;152,633333333333;715;2,55e+08
vpja13;14;7722;7894;-310,802405498282;-229,166666666667;172;0
vpja13;14;7929;8132;-467,902405498282;-225,466666666667;203;0
vpja13;14;8182;8577;-565,702405498282;-340,666666666667;395;0
vpja13;14;8606;8802;-544,702405498282;-258,366666666667;196;0
vpja13;14;8834;9205;-590,102405498282;-155,066666666666;371;0
vpja13;14;9239;9516;-568,402405498282;-167,566666666666;277;0
vpja13;14;9572;9735;-551,602405498282;-324,466666666667;163;0
vpja13;14;9762;10000;-476,602405498282;-400,866666666667;238;0
vpja13;15;238;387;148,631543624161;-214,870469798658;149;255000
vpja13;15;415;544;171,131543624161;-150,070469798658;129;2,55e+08
vpja13;15;615;886;216,731543624161;259,129530201342;271;255
vpja13;15;909;1266;257,131543624161;267,029530201342;357;255
vpja13;15;1288;1449;220,531543624161;300,229530201342;161;255
vpja13;15;1549;1777;-422,768456375839;172,629530201342;228;255255000
vpja13;15;1835;1996;-515,368456375839;-110,570469798658;161;0
vpja13;15;2045;2238;-180,768456375839;-137,170469798658;193;0
vpja13;15;2293;2454;-162,868456375839;-333,070469798658;161;0
vpja13;15;2476;2592;-123,668456375839;-339,270469798658;116;0
vpja13;15;2653;2848;-150,168456375839;-80,4704697986577;195;0
vpja13;15;2879;3227;-131,468456375839;-175,770469798658;348;0
vpja13;15;3249;3443;-170,068456375839;-179,870469798658;194;0
vpja13;15;3468;3639;-124,268456375839;-184,470469798658;171;0
vpja13;15;3670;3942;-232,468456375839;-170,670469798658;272;0
vpja13;15;4017;4235;389,831543624161;-335,670469798658;218;0
vpja13;15;4263;4630;336,531543624161;-369,870469798658;367;0
vpja13;15;4649;4812;347,831543624161;-337,770469798658;163;0
vpja13;15;4833;5037;346,631543624161;-382,470469798658;204;0
vpja13;15;5070;5372;528,531543624161;-372,970469798658;302;0
vpja13;15;5431;5632;526,631543624161;-109,570469798658;201;0
vpja13;15;5664;5950;474,531543624161;-51,3704697986577;286;0
vpja13;15;6031;6199;-39,1684563758389;-352,270469798658;168;0
vpja13;15;6237;6525;-126,668456375839;-348,370469798658;288;0
vpja13;15;6553;6793;-177,768456375839;-374,870469798658;240;0
vpja13;15;6827;7089;-143,168456375839;-333,570469798658;262;0
vpja13;15;7178;7355;-381,968456375839;170,329530201342;177;255255000
vpja13;15;7411;7669;-554,368456375839;413,229530201342;258;0
vpja13;15;7761;7943;105,531543624161;332,729530201342;182;255
vpja13;15;7992;8253;244,731543624161;200,829530201342;261;255
vpja13;15;8305;9003;156,431543624161;-133,470469798658;698;255000
vpja13;15;9189;9758;155,531543624161;-200,070469798658;569;255000
vpja13;15;9848;10000;-430,468456375839;-156,470469798658;152;0
vpja13;16;222;332;-131,535087719298;-179,984210526316;110;2,55e+08
vpja13;16;364;714;-163,235087719298;-211,484210526316;350;255000
vpja13;16;753;1130;-393,635087719298;-211,884210526316;377;0
vpja13;16;1218;1516;-477,735087719298;346,515789473684;298;255
vpja13;16;1547;1749;-430,935087719298;428,815789473684;202;0
vpja13;16;1777;2030;-474,035087719298;347,615789473684;253;255
vpja13;16;2058;2295;-442,235087719298;419,215789473684;237;0
vpja13;16;2390;2574;379,764912280702;300,715789473684;184;0
vpja13;16;2611;2749;419,064912280702;252,815789473684;138;0
vpja13;16;2805;2983;393,964912280702;77,315789473684;178;255255000
vpja13;16;3016;3193;417,364912280702;233,515789473684;177;0
vpja13;16;3219;3486;384,064912280702;298,215789473684;267;0
vpja13;16;3509;3667;335,764912280702;285,715789473684;158;0
vpja13;16;3705;3965;290,664912280702;446,415789473684;260;0
vpja13;16;3985;4187;290,764912280702;475,615789473684;202;0
vpja13;16;4255;4468;287,064912280702;352,115789473684;213;0
vpja13;16;4500;4657;296,364912280702;313,215789473684;157;0
vpja13;16;4688;5044;306,864912280702;230,515789473684;356;0
vpja13;16;5076;5284;334,164912280702;284,115789473684;208;0
vpja13;16;5359;5653;60,2649122807018;-376,084210526316;294;0
vpja13;16;5677;5887;-2,0350877192983;-343,484210526316;210;0
vpja13;16;5913;6241;-65,4350877192983;-398,184210526316;328;0
vpja13;16;6280;6452;23,5649122807017;-391,084210526316;172;0
vpja13;16;6477;6609;74,8649122807017;-389,684210526316;132;0
vpja13;16;6700;6918;-471,935087719298;47,5157894736841;218;0
vpja13;16;6951;7102;-511,935087719298;73,7157894736841;151;0
vpja13;16;7136;7335;-473,235087719298;181,915789473684;199;0
vpja13;16;7403;7577;-51,6350877192983;195,015789473684;174;0
vpja13;16;7630;7773;70,1649122807016;-11,0842105263159;143;0
vpja13;16;7815;7993;290,764912280702;14,815789473684;178;255255000
vpja13;16;8029;8171;380,764912280702;42,4157894736841;142;0
vpja13;16;8231;8334;517,264912280702;296,715789473684;103;0
vpja13;16;8398;8493;205,164912280702;-33,2842105263159;95;0
vpja13;16;8542;8724;10,2649122807018;-43,3842105263159;182;0
vpja13;16;8774;8999;269,864912280702;33,4157894736841;225;0
vpja13;16;9061;9398;40,3649122807017;-379,484210526316;337;0
vpja13;16;9423;9491;43,1649122807017;-336,484210526316;68;0
vpja13;16;9553;9782;-385,635087719298;-225,484210526316;229;0
vpja13;16;9803;9930;-413,235087719298;-226,484210526316;127;0
vpja13;16;9970;10000;-157,835087719298;-226,484210526316;30;255000
vpja13;17;279;506;-19,4643835616438;-290,341095890411;227;255000
vpja13;17;571;747;-82,1643835616438;49,358904109589;176;255
vpja13;17;777;892;-72,4643835616438;-28,9410958904109;115;255
vpja13;17;930;1145;-244,164383561644;-51,841095890411;215;0
vpja13;17;1165;1408;-243,064383561644;-81,241095890411;243;255255000
vpja13;17;1451;1603;-218,064383561644;51,9589041095891;152;0
vpja13;17;1625;1752;-179,864383561644;39,158904109589;127;0
vpja13;17;1828;1970;52,6356164383562;420,658904109589;142;2,55e+08
vpja13;17;2009;2421;19,8356164383562;479,858904109589;412;2,55e+08
vpja13;17;2478;2607;-248,664383561644;416,458904109589;129;0
vpja13;17;2636;2947;-332,764383561644;439,858904109589;311;0
vpja13;17;3023;3269;-216,664383561644;-108,341095890411;246;0
vpja13;17;3315;3431;-262,664383561644;-275,641095890411;116;0
vpja13;17;3532;3555;-352,264383561644;399,458904109589;23;0
vpja13;17;3575;3653;-352,164383561644;474,258904109589;78;0
vpja13;17;3686;4175;-339,564383561644;427,958904109589;489;0
vpja13;17;4205;4354;-324,364383561644;450,658904109589;149;0
vpja13;17;4384;4448;-335,564383561644;413,958904109589;64;0
vpja13;17;4470;4490;-336,664383561644;413,558904109589;20;0
vpja13;17;4584;4762;-560,564383561644;206,358904109589;178;0
vpja13;17;4819;5173;-594,864383561644;53,9589041095891;354;0
vpja13;17;5193;5322;-626,764383561644;54,258904109589;129;0
vpja13;17;5393;5547;-175,364383561644;-63,841095890411;154;0
vpja13;17;5604;5816;271,835616438356;-47,9410958904109;212;0
vpja13;17;5844;6035;177,235616438356;-48,4410958904109;191;0
vpja13;17;6083;6369;433,935616438356;-30,741095890411;286;0
vpja13;17;6396;6677;488,635616438356;-18,9410958904109;281;0
vpja13;17;6699;6841;530,235616438356;13,758904109589;142;0
vpja13;17;6892;7125;504,235616438356;-172,341095890411;233;0
vpja13;17;7161;7413;460,035616438356;-266,041095890411;252;0
vpja13;17;7424;7885;451,535616438356;-271,941095890411;461;0
vpja13;17;7945;8195;22,3356164383562;-215,041095890411;250;2,55e+08
vpja13;17;8234;8385;-161,064383561644;-250,141095890411;151;0
vpja13;17;8430;8827;-23,4643835616438;-306,241095890411;397;255000
vpja13;17;8849;9071;-33,7643835616439;-307,741095890411;222;255000
vpja13;17;9107;9349;-176,364383561644;-279,541095890411;242;0
vpja13;17;9412;9639;143,435616438356;-64,4410958904109;227;0
vpja13;17;9678;9903;184,535616438356;-44,9410958904109;225;0
vpja13;18;328;463;-77,5;-280,8;135;255000
vpja13;18;555;793;-487,8;343,9;238;255
vpja13;18;812;1321;-496,4;315,2;509;0
vpja13;18;1344;1860;-479,4;289,1;516;0
vpja13;18;1956;2162;331,4;320,7;206;255255000
vpja13;18;2197;2383;404,7;341;186;255255000
vpja13;18;2407;2865;422,9;361;458;255255000
vpja13;18;2891;3131;348,7;324,5;240;255255000
vpja13;18;3167;3807;410,8;340,6;640;255255000
vpja13;18;4380;4602;364,4;234,1;222;0
vpja13;18;4642;4899;414,5;252,2;257;0
vpja13;18;4921;5133;424,4;265,5;212;0
vpja13;18;5262;5464;-498,8;326,9;202;0
vpja13;18;5546;5666;88,5;-208,9;120;2,55e+08
vpja13;18;5727;5856;460,4;45,7;129;0
vpja13;18;5920;6060;-43,2;-277,3;140;255000
vpja13;18;6086;6301;-90,3;-305,2;215;255000
vpja13;18;6323;6627;-75,9;-332;304;255000
vpja13;18;6710;6936;488,5;13,4;226;0
vpja13;18;6976;7189;531,6;72,8000000000001;213;0
vpja13;18;7215;7460;585,4;95,5;245;0
vpja13;18;7484;7673;605,2;39,9;189;0
vpja13;18;7698;7899;620,1;-13;201;0
vpja13;18;7947;8182;334,6;-53,9;235;0
vpja13;18;8252;8430;526,5;-326,7;178;0
vpja13;18;8455;8628;552,9;-330,3;173;0
vpja13;18;8643;8896;523,2;-327,9;253;0
vpja13;18;8916;9291;550,3;-329,8;375;0
vpja13;18;9309;9765;514,9;-332,2;456;0
vpja13;18;9789;10000;552,6;-338,5;211;0
vpja13;19;277;416;-20,3;-190,3;139;255000
vpja13;19;480;810;-363,8;158,5;330;255
vpja13;19;845;1477;-315,9;145,3;632;255
vpja13;19;1509;1583;-337,1;144,5;74;255
vpja13;19;1823;1979;-353,9;135,4;156;255
vpja13;19;2003;2938;-334,4;126,6;935;255
vpja13;19;2963;3111;-321,4;166;148;255
vpja13;19;3179;3475;241,3;181,4;296;255255000
vpja13;19;3496;3982;205,2;191,2;486;255255000
vpja13;19;4294;4659;244,1;154,3;365;255255000
vpja13;19;4678;5011;221,9;182,4;333;255255000
vpja13;19;5092;5209;232;-106,2;117;0
vpja13;19;5274;5399;-290,8;138;125;255
vpja13;19;5426;5716;-358,7;159,2;290;255
vpja13;19;5783;5998;-187,6;-256,9;215;0
vpja13;19;6045;6208;-407,9;-224,3;163;0
vpja13;19;6275;6572;232,9;-201,8;297;0
vpja13;19;6627;6807;-17,8;-212,3;180;255000
vpja13;19;6828;7060;-41,6;-175,2;232;255000
vpja13;19;7141;7379;524,4;4;238;0
vpja13;19;7404;7703;552;8,39999999999998;299;0
vpja13;19;7749;7936;495;-106,3;187;0
vpja13;19;7983;8238;314,7;-243;255;0
vpja13;19;8268;8453;425;-234,5;185;0
vpja13;19;8497;8650;163,1;-234;153;0
vpja13;19;8718;8867;-8,29999999999995;167,3;149;0
vpja13;19;8925;9171;-357,8;190,9;246;255
vpja13;19;9196;9437;-368,2;158,4;241;255
vpja13;19;9474;9641;-154,6;153,3;167;0
vpja13;19;9709;9950;266,2;185,9;241;255255000
vpja13;20;298;621;-77,4928315412187;-230,218996415771;323;255000
vpja13;20;693;906;-492,192831541219;167,181003584229;213;255
vpja13;20;932;1159;-494,092831541219;223,681003584229;227;255
vpja13;20;1183;1334;-459,292831541219;243,481003584229;151;255
vpja13;20;1423;1591;332,707168458781;196,281003584229;168;255255000
vpja13;20;1630;1770;378,707168458781;142,981003584229;140;255255000
vpja13;20;1791;1924;398,007168458781;110,881003584229;133;255255000
vpja13;20;1954;2221;297,207168458781;169,481003584229;267;255255000
vpja13;20;2249;2358;374,807168458781;136,981003584229;109;255255000
vpja13;20;2390;2564;417,707168458781;123,181003584229;174;255255000
vpja13;20;2585;3466;391,907168458781;79,1810035842294;881;255255000
vpja13;20;3518;3649;84,5071684587813;35,9810035842294;131;2,55e+08
vpja13;20;3711;4334;-72,0928315412186;-234,818996415771;623;255000
vpja13;20;4357;4494;-51,9928315412187;-246,618996415771;137;255000
vpja13;20;4514;4718;-75,8928315412187;-230,718996415771;204;255000
vpja13;20;4730;4979;-63,5928315412186;-238,418996415771;249;255000
vpja13;20;5056;5275;-575,192831541219;-3,71899641577056;219;0
vpja13;20;5311;5440;-527,092831541219;6,18100358422942;129;0
vpja13;20;5477;5785;-449,292831541219;-80,6189964157706;308;0
vpja13;20;5807;5970;-428,492831541219;-45,3189964157706;163;0
vpja13;20;5981;6171;-437,492831541219;-35,5189964157706;190;0
vpja13;20;6196;6437;-414,692831541219;-37,4189964157706;241;0
vpja13;20;6460;6502;-470,092831541219;-21,8189964157706;42;0
vpja13;20;6552;6743;-585,592831541219;120,681003584229;191;0
vpja13;20;6768;6892;-636,792831541219;149,381003584229;124;0
vpja13;20;6956;7166;-484,092831541219;-346,018996415771;210;0
vpja13;20;7203;7370;-416,692831541219;-340,118996415771;167;0
vpja13;20;7472;7867;525,607168458781;-144,318996415771;395;0
vpja13;20;7893;8018;458,707168458781;-144,318996415771;125;0
vpja13;20;8043;8402;489,507168458781;-195,818996415771;359;0
vpja13;20;8449;8796;509,407168458781;-348,018996415771;347;0
vpja13;20;8840;9032;481,107168458781;-210,518996415771;192;0
vpja13;20;9043;9483;491,407168458781;-205,518996415771;440;0
vpja13;20;9559;9718;219,207168458781;45,7810035842294;159;0
vpja13;20;9773;10000;74,9071684587814;318,381003584229;227;0
vpja13;21;238;362;-90,4361010830324;-186,37797833935;124;255000
vpja13;21;385;675;-124,236101083033;-198,37797833935;290;0
vpja13;21;737;1103;-483,136101083032;61,8220216606499;366;255
vpja13;21;1157;1346;-75,4361010830324;131,02202166065;189;255255000
vpja13;21;1383;1562;-16,6361010830325;106,52202166065;179;255255000
vpja13;21;1603;1815;-184,136101083032;82,1220216606499;212;2,55e+08
vpja13;21;1837;1915;-226,636101083032;86,6220216606499;78;2,55e+08
vpja13;21;1949;2233;-61,8361010830325;42,0220216606499;284;2,55e+08
vpja13;21;2282;2436;-111,236101083033;-174,07797833935;154;0
vpja13;21;2456;2940;-126,836101083033;-203,57797833935;484;0
vpja13;21;3007;3184;228,963898916967;-403,37797833935;177;0
vpja13;21;3210;3344;286,163898916967;-373,77797833935;134;0
vpja13;21;3373;3508;381,763898916968;-355,37797833935;135;0
vpja13;21;3547;3751;577,563898916968;-341,17797833935;204;0
vpja13;21;3796;4024;568,563898916968;-110,97797833935;228;0
vpja13;21;4047;4217;595,363898916968;-88,7779783393501;170;0
vpja13;21;4254;4490;384,263898916968;-49,0779783393501;236;0
vpja13;21;4522;4765;339,063898916968;61,3220216606499;243;0
vpja13;21;4820;4986;80,3638989169675;210,82202166065;166;0
vpja13;21;5028;5217;-25,8361010830325;123,02202166065;189;255255000
vpja13;21;5239;5597;-47,9361010830324;91,3220216606499;358;255255000
vpja13;21;5635;5886;8,66389891696747;108,32202166065;251;255255000
vpja13;21;5909;6089;-30,9361010830324;90,1220216606499;180;255255000
vpja13;21;6355;6533;-44,5361010830325;85,8220216606499;178;255255000
vpja13;21;6573;6844;81,1638989169675;81,1220216606499;271;255255000
vpja13;21;6879;7106;227,263898916968;60,4220216606499;227;0
vpja13;21;7157;7340;297,763898916968;287,32202166065;183;0
vpja13;21;7397;7519;350,863898916968;-7,27797833935017;122;0
vpja13;21;7564;7846;90,4638989169674;35,1220216606499;282;0
vpja13;21;7886;8179;228,563898916968;182,62202166065;293;0
vpja13;21;8230;8371;219,363898916968;-14,7779783393502;141;0
vpja13;21;8451;8689;-468,836101083032;-2,57797833935012;238;255
vpja13;21;8720;9307;-600,536101083032;85,3220216606499;587;0
vpja13;21;9347;9607;-654,836101083032;126,32202166065;260;NA
vpja13;21;9846;9900;-563,736101083033;57,6220216606499;54;0
vpja13;21;9920;10000;-563,436101083033;124,02202166065;80;0
vpja13;22;301;538;150,269503546099;-173,293617021277;237;255000
vpja13;22;599;762;80,6695035460993;249,906382978723;163;255
vpja13;22;787;1085;44,8695035460993;285,606382978723;298;255
vpja13;22;1101;1252;44,4695035460993;266,206382978723;151;255
vpja13;22;1308;1532;-388,230496453901;145,706382978723;224;255255000
vpja13;22;1552;1760;-408,230496453901;112,006382978723;208;255255000
vpja13;22;1811;1924;-415,330496453901;-82,9936170212767;113;0
vpja13;22;1966;2164;-592,430496453901;-66,3936170212767;198;0
vpja13;22;2182;2318;-617,130496453901;-55,1936170212767;136;0
vpja13;22;2364;2644;-467,430496453901;-275,493617021277;280;0
vpja13;22;2707;2886;-592,630496453901;-68,6936170212767;179;0
vpja13;22;2926;3063;-343,730496453901;68,9063829787233;137;255255000
vpja13;22;3100;3339;-231,230496453901;35,5063829787233;239;0
vpja13;22;3401;3737;-38,0304964539007;-322,593617021277;336;0
vpja13;22;3761;3888;-72,8304964539008;-347,293617021277;127;0
vpja13;22;3962;4192;398,869503546099;-285,493617021277;230;0
vpja13;22;4277;4460;384,969503546099;179,906382978723;183;0
vpja13;22;4508;4747;303,969503546099;478,006382978723;239;0
vpja13;22;4813;4893;519,569503546099;274,406382978723;80;0
vpja13;22;4974;5185;287,169503546099;468,306382978723;211;0
vpja13;22;5250;5410;444,269503546099;277,906382978723;160;0
vpja13;22;5483;5591;383,969503546099;-161,493617021277;108;0
vpja13;22;5639;5882;414,969503546099;-308,093617021277;243;0
vpja13;22;5923;6117;207,369503546099;-301,993617021277;194;255000
vpja13;22;6153;6248;15,9695035460993;-299,893617021277;95;0
vpja13;22;6293;6465;174,469503546099;-177,193617021277;172;255000
vpja13;22;6491;6742;138,069503546099;-187,893617021277;251;255000
vpja13;22;6764;7149;133,969503546099;-152,093617021277;385;255000
vpja13;22;7181;7344;163,869503546099;-264,093617021277;163;255000
vpja13;22;7367;7709;201,169503546099;-297,193617021277;342;255000
vpja13;22;7734;8004;134,469503546099;-325,993617021277;270;255000
vpja13;22;8023;8323;109,769503546099;-331,393617021277;300;255000
vpja13;22;8349;8598;152,269503546099;-331,893617021277;249;255000
vpja13;22;8624;8734;211,369503546099;-306,493617021277;110;255000
vpja13;22;8778;9104;145,669503546099;-193,793617021277;326;255000
vpja13;22;9125;9371;133,769503546099;-159,393617021277;246;255000
vpja13;22;9437;9941;418,669503546099;-314,993617021277;504;0
vpja13;22;9966;10000;417,569503546099;-344,993617021277;34;0
vpja13;23;269;392;139,564827586207;-247,181379310345;123;255000
vpja13;23;425;1004;151,964827586207;-263,581379310345;579;255000
vpja13;23;1056;1158;95,1648275862069;-53,0813793103448;102;0
vpja13;23;1201;1599;-104,235172413793;95,3186206896552;398;255255000
vpja13;23;1668;1870;353,264827586207;142,118620689655;202;0
vpja13;23;1894;2119;389,964827586207;92,9186206896552;225;0
vpja13;23;2142;2483;428,964827586207;56,1186206896552;341;0
vpja13;23;2544;2795;-83,7351724137932;80,9186206896552;251;255255000
vpja13;23;2820;3135;-135,435172413793;111,118620689655;315;255255000
vpja13;23;3163;3408;-58,7351724137932;28,9186206896552;245;255255000
vpja13;23;3443;3565;-137,935172413793;119,118620689655;122;255255000
vpja13;23;3608;3733;-340,535172413793;51,8186206896552;125;0
vpja13;23;3776;3970;-579,935172413793;114,318620689655;194;0
vpja13;23;3997;4233;-518,035172413793;175,018620689655;236;0
vpja13;23;4259;4416;-574,935172413793;202,918620689655;157;0
vpja13;23;4451;4583;-345,435172413793;284,718620689655;132;0
vpja13;23;4683;4807;535,064827586207;122,918620689655;124;0
vpja13;23;4846;5041;580,364827586207;38,3186206896552;195;0
vpja13;23;5066;5245;522,864827586207;79,4186206896552;179;0
vpja13;23;5279;5679;441,864827586207;-7,38137931034476;400;0
vpja13;23;5748;5980;148,864827586207;-220,981379310345;232;2,55e+08
vpja13;23;6034;6678;222,564827586207;21,1186206896552;644;0
vpja13;23;6731;6920;145,864827586207;-225,081379310345;189;2,55e+08
vpja13;23;6947;7400;153,064827586207;-271,381379310345;453;255000
vpja13;23;7480;7733;161,464827586207;268,518620689655;253;0
vpja13;23;7774;7948;260,664827586207;352,418620689655;174;0
vpja13;23;8037;8185;558,364827586207;134,918620689655;148;0
vpja13;23;8208;8490;591,964827586207;84,2186206896552;282;0
vpja13;23;8512;8771;571,864827586207;117,418620689655;259;0
vpja13;23;8800;8979;570,564827586207;22,8186206896552;179;0
vpja13;23;9003;9246;508,964827586207;16,2186206896552;243;0
vpja13;23;9268;9697;482,364827586207;-5,48137931034478;429;0
vpja13;23;9718;9831;514,764827586207;-3,88137931034476;113;0
vpja13;24;323;601;-26,4000000000001;-342,4;278;255000
vpja13;24;626;770;-13,2;-380,1;144;255000
vpja13;24;823;1019;-283,6;-308,2;196;0
vpja13;24;1048;1194;-432;-293,4;146;0
vpja13;24;1235;1476;-584;-316,7;241;0
vpja13;24;1514;1734;-372;-382,2;220;0
vpja13;24;1776;2168;-282,4;-382,3;392;0
vpja13;24;2243;2411;-279,8;142,1;168;0
vpja13;24;2452;2597;-275,5;227;145;255255000
vpja13;24;2671;2864;404,3;339,7;193;255
vpja13;24;2901;3583;455,1;413;682;255
vpja13;24;3612;3832;427,3;376;220;255
vpja13;24;3868;4226;471,6;397,3;358;255
vpja13;24;4264;4384;427;338,3;120;0
vpja13;24;4468;4630;-352;274,2;162;255255000
vpja13;24;4659;4850;-268,6;206,9;191;255255000
vpja13;24;4936;5118;249,9;-251,6;182;0
vpja13;24;5161;5456;350,3;-350,3;295;0
vpja13;24;5487;5699;385,7;-304;212;0
vpja13;24;5724;5909;354,4;-350,7;185;0
vpja13;24;5941;6339;223,5;-350,7;398;0
vpja13;24;6354;6599;244;-335,2;245;0
vpja13;24;6678;6880;-326,7;-327,8;202;0
vpja13;24;6920;7139;-526;-344,3;219;0
vpja13;24;7165;7338;-587,7;-360,1;173;0
vpja13;24;7382;7686;-371,4;-370,8;304;0
vpja13;24;7711;7954;-304,8;-417,2;243;0
vpja13;24;7992;8214;-364,9;-323,6;222;0
vpja13;24;8247;8520;-224,7;-300,3;273;0
vpja13;24;8588;8763;-387,8;59,2;175;0
vpja13;24;8804;8978;-395,3;-65,6;174;0
vpja13;24;9003;9214;-397,7;-122,3;211;0
vpja13;24;9271;9443;-109,5;33,1;172;2,55e+08
vpja13;24;9499;9674;-30,5;-389;175;255000
vpja13;24;9699;10000;-5,5;-371,7;301;255000
vpja13;25;410;485;-97,1072164948454;-61,1621993127148;75;255000
vpja13;25;515;633;-77,8072164948454;-90,6621993127148;118;255000
vpja13;25;690;861;222,292783505154;171,737800687285;171;0
vpja13;25;883;1135;211,392783505155;130,437800687285;252;255
vpja13;25;1206;1499;-437,707216494845;175,037800687285;293;255255000
vpja13;25;1526;1926;-503,207216494845;162,137800687285;400;255255000
vpja13;25;1966;2157;-411,207216494845;155,037800687285;191;255255000
vpja13;25;2184;2340;-337,307216494845;149,537800687285;156;255255000
vpja13;25;2391;2511;-461,407216494845;-208,962199312715;120;0
vpja13;25;2553;2696;-419,407216494845;-370,862199312715;143;0
vpja13;25;2748;3105;-30,3072164948454;-352,762199312715;357;0
vpja13;25;3134;3267;110,292783505154;-321,462199312715;133;0
vpja13;25;3308;3533;290,292783505154;-321,762199312715;225;0
vpja13;25;3598;3793;392,392783505155;85,9378006872852;195;0
vpja13;25;3815;4050;366,592783505155;42,7378006872851;235;0
vpja13;25;4102;4319;424,192783505155;296,137800687285;217;0
vpja13;25;4380;4645;269,192783505155;-73,3621993127148;265;0
vpja13;25;4872;5057;210,192783505155;-301,662199312715;185;0
vpja13;25;5078;5256;247,592783505155;-355,562199312715;178;0
vpja13;25;5304;5475;-27,8072164948454;-348,362199312715;171;0
vpja13;25;5521;5733;-270,807216494845;-346,662199312715;212;0
vpja13;25;5765;5946;-420,007216494845;-339,862199312715;181;0
vpja13;25;5970;6294;-449,107216494845;-319,562199312715;324;0
vpja13;25;6373;6503;10,0927835051546;-196,562199312715;130;0
vpja13;25;6561;6736;349,592783505155;3,23780068728513;175;0
vpja13;25;6774;7056;392,592783505155;28,8378006872852;282;0
vpja13;25;7080;7211;317,292783505154;38,4378006872852;131;0
vpja13;25;7251;7546;394,992783505155;211,237800687285;295;0
vpja13;25;7590;7792;456,892783505155;89,7378006872851;202;0
vpja13;25;7853;8066;542,492783505155;-95,0621993127148;213;0
vpja13;25;8098;8375;622,992783505155;25,5378006872852;277;0
vpja13;25;8400;8600;546,292783505154;-5,06219931271482;200;0
vpja13;25;8662;8971;115,192783505155;88,6378006872852;309;0
vpja13;25;9011;9122;-26,4072164948454;169,837800687285;111;2,55e+08
vpja13;25;9162;9393;145,392783505155;63,7378006872851;231;0
vpja13;25;9446;9574;-112,907216494845;74,7378006872851;128;2,55e+08
vpja13;25;9609;9740;-287,707216494845;95,4378006872852;131;0
vpja13;25;9802;10000;-672,407216494845;-24,4621993127148;198;NA
vpja13;26;298;386;23,2972696245735;135,163139931741;88;255255000
vpja13;26;447;565;-125,002730375426;-146,036860068259;118;255000
vpja13;26;599;985;-137,102730375427;-182,536860068259;386;255000
vpja13;26;995;1163;-133,402730375426;-170,336860068259;168;255000
vpja13;26;1213;1440;-469,802730375427;-151,536860068259;227;0
vpja13;26;1466;1656;-490,502730375426;-93,0368600682594;190;0
vpja13;26;1731;1873;-505,602730375427;285,263139931741;142;0
vpja13;26;1900;1995;-474,302730375427;234,363139931741;95;0
vpja13;26;2026;2224;-311,802730375427;163,163139931741;198;0
vpja13;26;2248;2438;-286,802730375427;168,663139931741;190;0
vpja13;26;2446;2745;-300,302730375427;188,363139931741;299;0
vpja13;26;2794;3036;-216,302730375427;391,963139931741;242;0
vpja13;26;3058;3328;-241,702730375427;387,363139931741;270;0
vpja13;26;3391;3496;-134,502730375426;147,263139931741;105;0
vpja13;26;3541;3733;17,9972696245735;140,463139931741;192;255255000
vpja13;26;3796;4044;145,397269624573;-325,736860068259;248;0
vpja13;26;4072;4311;66,4972696245735;-282,836860068259;239;0
vpja13;26;4403;4534;364,097269624574;159,263139931741;131;0
vpja13;26;4590;4774;309,097269624574;-37,4368600682594;184;0
vpja13;26;4814;5084;239,297269624574;104,263139931741;270;0
vpja13;26;5170;5332;-348,602730375427;-2,93686006825942;162;0
vpja13;26;5374;5581;-448,902730375427;-48,1368600682594;207;0
vpja13;26;5637;5849;-491,702730375427;216,163139931741;212;0
vpja13;26;5911;6115;-479,802730375427;-85,6368600682594;204;0
vpja13;26;6179;6319;-482,902730375427;325,363139931741;140;0
vpja13;26;6348;6545;-501,202730375427;260,663139931741;197;0
vpja13;26;6567;6986;-487,402730375427;243,663139931741;419;0
vpja13;26;7041;7546;-202,202730375427;341,663139931741;505;0
vpja13;26;7599;7723;-101,002730375426;347,563139931741;124;0
vpja13;26;7753;8268;-83,9027303754265;228,163139931741;515;0
vpja13;26;8294;8425;-146,902730375426;245,463139931741;131;0
vpja13;26;8462;8497;-214,302730375427;269,363139931741;35;0
vpja13;26;8544;8572;-216,902730375426;270,463139931741;28;0
vpja13;26;8674;8749;-218,802730375427;266,863139931741;75;0
vpja13;26;8832;8978;-217,802730375427;330,963139931741;146;0
vpja13;26;9005;9068;-303,502730375426;299,063139931741;63;0
vpja13;26;9092;9214;-298,802730375427;357,363139931741;122;0
vpja13;26;9253;9368;-232,902730375426;344,363139931741;115;0
vpja13;26;9449;9706;-422,402730375426;-161,136860068259;257;0
vpja13;26;9741;9912;-343,202730375427;-42,6368600682594;171;0
vpja13;26;9953;10000;-436,802730375427;-11,8368600682594;47;0
