vp;trial;timest;timeend;x;y;duration;roi
vpja36;1;296;386;-296,1;-56,1999999999999;90;255000
vpja36;1;3180;3381;-363,6;-16,6;201;255000
vpja36;1;3435;3865;-313,6;348,2;430;255
vpja36;1;3903;4111;-179,2;310,2;208;0
vpja36;1;4150;4565;-269,9;311,8;415;255
vpja36;1;4588;4838;-323,5;305,8;250;255
vpja36;1;4919;5532;217,9;159,4;613;255255000
vpja36;1;5591;5886;380,1;1,89999999999998;295;0
vpja36;1;5936;6302;461,4;-53,6;366;0
vpja36;1;6352;6614;555,1;-138,5;262;0
vpja36;1;6640;7071;503,7;-86,7;431;0
vpja36;1;7097;7508;509,8;-148,9;411;0
vpja36;1;7561;7673;355,6;-117,3;112;0
vpja36;1;7721;7887;180,6;15,3000000000001;166;0
vpja36;1;7910;8164;211,4;1,70000000000005;254;0
vpja36;1;8186;8571;229,8;4,80000000000007;385;0
vpja36;1;8624;8727;26;-17,6;103;0
vpja36;1;8772;8795;-112,5;-40,9;23;0
vpja36;1;8850;8920;-115,3;-45,1999999999999;70;0
vpja36;1;9134;9267;-68,4;-64,3;133;0
vpja36;1;9301;9497;-5,20000000000005;-88,8;196;0
vpja36;1;9527;10000;19,3;-164,4;473;0
vpja36;2;228;608;149,3;-136,9;380;255000
vpja36;2;654;765;125,1;148,9;111;2,55e+08
vpja36;2;810;980;86,1999999999999;297,1;170;255
vpja36;2;1058;1189;-346,1;203;131;255255000
vpja36;2;1216;1449;-374,7;128,4;233;255255000
vpja36;2;1466;1866;-371;101,6;400;255255000
vpja36;2;1885;2119;-343,4;74,1;234;255255000
vpja36;2;2142;2521;-355,5;100,2;379;255255000
vpja36;2;2538;2888;-360,3;83,4000000000001;350;255255000
vpja36;2;2911;3288;-355,4;117,7;377;255255000
vpja36;2;3311;3405;-331,9;127,3;94;255255000
vpja36;2;3462;3670;-385,1;-144,6;208;0
vpja36;2;3723;4054;-534,7;-89,6;331;0
vpja36;2;4120;4290;-277,7;-239;170;0
vpja36;2;4329;4569;-415;-280;240;0
vpja36;2;4628;4836;-549,1;-96,1;208;0
vpja36;2;4926;5190;70,1;-273,7;264;255000
vpja36;2;5219;5385;36,6;-340,4;166;0
vpja36;2;5459;5632;425,7;-332,7;173;0
vpja36;2;5664;5924;450,1;-307;260;0
vpja36;2;5987;6140;180,9;-180,1;153;255000
vpja36;2;6166;6473;146,6;-133,4;307;255000
vpja36;2;6537;6738;437,9;256,4;201;0
vpja36;2;6794;7110;267,4;433,6;316;0
vpja36;2;7139;7571;312,4;454;432;0
vpja36;2;7708;7802;207,6;-137,9;94;2,55e+08
vpja36;2;7827;8264;153;-157,2;437;255000
vpja36;2;8317;8762;301,4;-57,3;445;2,55e+08
vpja36;2;8787;8979;350,6;3,20000000000005;192;2,55e+08
vpja36;2;9030;9247;195,6;-120,7;217;2,55e+08
vpja36;2;9270;9657;150,7;-145,3;387;255000
vpja36;2;9728;9953;479,5;-9;225;0
vpja36;3;219;330;-44,9;-259,4;111;0
vpja36;3;373;462;41,7;-355,8;89;255000
vpja36;3;483;1296;20,8000000000001;-338,8;813;255000
vpja36;3;1366;1512;28,8000000000001;41,7;146;2,55e+08
vpja36;3;1565;1803;30;-137,2;238;2,55e+08
vpja36;3;1836;1914;32,1;-86,4;78;2,55e+08
vpja36;3;1983;2335;-231,8;108,4;352;0
vpja36;3;2379;2511;-327,7;13,8000000000001;132;255
vpja36;3;2567;2856;-396,2;-334,4;289;0
vpja36;3;2886;3066;-425,8;-409;180;0
vpja36;3;3132;3281;20,2;-130,4;149;2,55e+08
vpja36;3;3350;3532;278,5;226,2;182;255255000
vpja36;3;3567;3712;365,5;267,1;145;255255000
vpja36;3;3736;4081;380,7;266,6;345;255255000
vpja36;3;4152;4368;504;-251,8;216;0
vpja36;3;4392;4728;509,9;-200,9;336;0
vpja36;3;4752;5130;537,5;-174;378;0
vpja36;3;5191;5575;199,5;-401,7;384;0
vpja36;3;5608;5852;153,1;-327,8;244;0
vpja36;3;5887;6136;69,1999999999999;-293,3;249;255000
vpja36;3;6186;6490;111,6;-432,6;304;0
vpja36;3;6524;6896;155,9;-424,9;372;0
vpja36;3;6920;7420;102,9;-428,8;500;0
vpja36;3;7451;7597;88,5000000000001;-316,9;146;255000
vpja36;3;7657;7826;-239,5;-316,6;169;0
vpja36;3;7879;8125;-417,5;-294,9;246;0
vpja36;3;8170;8437;-432,1;-399,2;267;0
vpja36;3;8483;8819;-440,9;-274,4;336;0
vpja36;3;8838;9093;-427,7;-282,8;255;0
vpja36;3;9119;9289;-411,7;-331,8;170;0
vpja36;3;9343;9551;-227,5;-243;208;0
vpja36;3;9581;9820;-199,8;-235,8;239;0
vpja36;3;9845;10000;-176,5;-206,9;155;0
vpja36;4;228;261;31,4;169,7;33;2,55e+08
vpja36;4;309;647;-38,6;-189,8;338;255000
vpja36;4;663;1065;-60,5;-186,2;402;255000
vpja36;4;1119;1526;-42,6;358,5;407;0
vpja36;4;1546;1686;-28,6;368,8;140;0
vpja36;4;1761;2280;342,7;196,1;519;255255000
vpja36;4;2307;2429;372,9;207,7;122;255255000
vpja36;4;2487;2688;-17,7;345,9;201;0
vpja36;4;2713;3870;-39,2;363;1157;0
vpja36;4;3940;4354;358,6;198,2;414;255255000
vpja36;4;4373;4561;325,3;173,4;188;255255000
vpja36;4;4581;4710;365,8;164,5;129;0
vpja36;4;4771;4947;190,7;-97,8;176;0
vpja36;4;5009;5187;-139,3;-182,2;178;255000
vpja36;4;5246;5450;-444,8;-171,4;204;0
vpja36;4;5513;5897;-496,6;17,7;384;0
vpja36;4;5955;6146;-285,9;257,3;191;0
vpja36;4;6191;6465;-352,9;422,3;274;0
vpja36;4;6508;6582;-507,7;430,7;74;0
vpja36;4;6652;6917;-531,4;78,6;265;0
vpja36;4;6989;7207;-522,9;-281,9;218;0
vpja36;4;7240;7438;-518,5;-233,5;198;0
vpja36;4;7483;7579;-526,5;-322,6;96;0
vpja36;4;7630;7801;-344,2;-367,4;171;0
vpja36;4;7891;8216;337,8;-342,6;325;0
vpja36;4;8279;8427;499,7;-236;148;0
vpja36;4;8479;8892;468,2;11,9;413;0
vpja36;4;8936;9220;486;-73,4;284;0
vpja36;4;9275;9510;370,5;223,4;235;0
vpja36;4;9560;9785;376,9;425;225;0
vpja36;4;9831;10000;358,6;285,3;169;0
vpja36;5;185;291;-143,3;-183,9;106;2,55e+08
vpja36;5;317;449;-197,7;-215,7;132;255000
vpja36;5;894;1096;-185,3;117,1;202;2,55e+08
vpja36;5;1143;1284;-190,2;243;141;0
vpja36;5;1341;1839;-457,7;310,5;498;255
vpja36;5;1909;2212;-89,8;384,7;303;255255000
vpja36;5;2236;2378;-105,7;336,1;142;255255000
vpja36;5;2450;2708;390,5;24,3000000000001;258;0
vpja36;5;2737;2967;424,5;15,3000000000001;230;0
vpja36;5;2997;3204;321,2;44,3000000000001;207;0
vpja36;5;3260;3544;257;-296,8;284;0
vpja36;5;3625;3809;319,8;-364,4;184;0
vpja36;5;3842;3996;266,3;-362,3;154;0
vpja36;5;4020;4231;336,6;-373,6;211;0
vpja36;5;4292;4547;-63,3;-270,5;255;0
vpja36;5;4581;5236;-12,9;-267,2;655;0
vpja36;5;5269;5402;-174,2;-226;133;255000
vpja36;5;5434;5786;-202,3;-214,8;352;255000
vpja36;5;5843;6016;-430,2;-338;173;0
vpja36;5;6040;6369;-417,8;-382,8;329;0
vpja36;5;6423;6543;-228,8;-319;120;0
vpja36;5;6598;6762;-276,5;-60,5;164;2,55e+08
vpja36;5;6809;6996;-254,1;-202,1;187;0
vpja36;5;7048;7203;-117;-244,6;155;255000
vpja36;5;7234;7526;-83,6;-241,4;292;0
vpja36;5;7618;7880;-534,2;-236,1;262;0
vpja36;5;7906;8137;-585,2;-296,9;231;0
vpja36;5;8159;8304;-606,4;-306,7;145;0
vpja36;5;8371;8718;-523,6;50,9000000000001;347;0
vpja36;5;8760;9052;-486,1;152,7;292;0
vpja36;5;9074;9201;-493,5;129,6;127;0
vpja36;5;9276;9389;-26,8;340;113;0
vpja36;5;9439;9667;82,4000000000001;475,9;228;0
vpja36;5;9739;9929;480,7;436,8;190;0
vpja36;5;9954;10000;538,6;444,2;46;0
vpja36;6;185;311;-65,3000000000001;-96,1;126;2,55e+08
vpja36;6;336;975;-89,9000000000001;-148,6;639;255000
vpja36;6;1041;1205;-178,1;178,7;164;0
vpja36;6;1235;1551;-267,1;193,9;316;0
vpja36;6;1618;1735;-113,5;-85,8;117;2,55e+08
vpja36;6;1775;1969;-108,4;-166,2;194;255000
vpja36;6;1985;2538;-103,4;-152,8;553;255000
vpja36;6;2586;2733;-111,9;52,7;147;2,55e+08
vpja36;6;2795;3120;-287,7;188,4;325;0
vpja36;6;3185;3510;14,4;155,1;325;255
vpja36;6;3565;3775;-88,5;333,6;210;0
vpja36;6;3807;3983;-105,3;384,7;176;0
vpja36;6;4012;4345;-36,2;382,8;333;0
vpja36;6;4374;4673;-123,6;353,9;299;0
vpja36;6;4696;4833;-133,8;395,7;137;0
vpja36;6;4872;5316;-41,8000000000001;373,6;444;0
vpja36;6;5341;5653;-21,6;345;312;0
vpja36;6;5783;6015;-398,3;10,1;232;0
vpja36;6;6037;6243;-420,1;-1,19999999999993;206;0
vpja36;6;6291;6839;-421,8;-221,7;548;0
vpja36;6;6906;7170;29,9;-311,1;264;0
vpja36;6;7213;7717;29,1999999999999;-387,2;504;0
vpja36;6;7734;8129;4,5;-407,9;395;0
vpja36;6;8156;8449;-3,90000000000009;-341,8;293;0
vpja36;6;8559;9385;377,7;-108;826;0
vpja36;6;9412;9537;443,5;-124,7;125;0
vpja36;6;9595;10000;237,5;150,9;405;0
vpja36;7;222;344;40,5;-215,8;122;255000
vpja36;7;372;790;66,4;-228,1;418;0
vpja36;7;862;1017;348,1;296,6;155;0
vpja36;7;1062;1257;351,2;213,4;195;255
vpja36;7;1327;1482;-210,5;297,2;155;255255000
vpja36;7;1520;1875;-300,9;191,7;355;255255000
vpja36;7;1926;2153;-261,9;-15,5999999999999;227;0
vpja36;7;2177;2360;-274,3;-58,1;183;0
vpja36;7;2409;2733;-268,2;189,3;324;255255000
vpja36;7;2818;3099;381,9;177,4;281;255
vpja36;7;3156;3325;436,6;-46,3;169;0
vpja36;7;3355;3570;506,2;-69,6;215;0
vpja36;7;3604;3770;348,5;-81,4999999999999;166;0
vpja36;7;3830;4239;370,8;166,3;409;255
vpja36;7;4333;4648;-251,6;-120,6;315;0
vpja36;7;4704;5032;-237,5;-331,6;328;0
vpja36;7;5086;5578;-66,2;-362,7;492;0
vpja36;7;5644;5764;254,9;-360,5;120;0
vpja36;7;5827;6127;508,7;-312,8;300;0
vpja36;7;6206;6387;-207,6;-53,1;181;0
vpja36;7;6424;6730;-264,7;-47,6;306;0
vpja36;7;6764;7141;-300,9;-15,3;377;0
vpja36;7;7173;7792;-338,9;-30,3;619;0
vpja36;7;7813;8381;-359,5;-4,5;568;0
vpja36;7;8407;9004;-308,2;-39,3;597;0
vpja36;7;9027;9436;-350,2;1,90000000000009;409;0
vpja36;7;9457;10000;-365,1;-31,3;543;0
vpja36;8;214;376;28,8043010752688;-217,154121863799;162;255000
vpja36;8;400;842;3,80430107526877;-227,254121863799;442;255000
vpja36;8;905;1089;-302,995698924731;154,645878136201;184;0
vpja36;8;1114;1450;-319,695698924731;159,145878136201;336;255
vpja36;8;1532;1789;269,204301075269;142,145878136201;257;255255000
vpja36;8;1812;1979;297,304301075269;148,545878136201;167;255255000
vpja36;8;2060;2427;-323,495698924731;165,745878136201;367;255
vpja36;8;2535;2725;-10,5956989247313;-210,354121863799;190;255000
vpja36;8;2750;2973;-11,9956989247313;-233,954121863799;223;255000
vpja36;8;3022;3250;-99,9956989247313;-330,354121863799;228;0
vpja36;8;3277;3659;-92,4956989247313;-382,454121863799;382;0
vpja36;8;3725;4524;-491,995698924731;-410,554121863799;799;0
vpja36;8;4619;4765;343,004301075269;-342,954121863799;146;0
vpja36;8;4792;5469;311,404301075269;-395,754121863799;677;0
vpja36;8;5546;5759;560,704301075269;103,945878136201;213;0
vpja36;8;5806;5960;578,504301075269;-10,0541218637992;154;0
vpja36;8;6073;6133;387,704301075269;-117,554121863799;60;0
vpja36;8;6144;6226;388,304301075269;-86,7541218637992;82;0
vpja36;8;6269;6339;400,904301075269;-145,054121863799;70;0
vpja36;8;6416;6707;545,504301075269;346,145878136201;291;0
vpja36;8;6728;6890;536,404301075269;378,445878136201;162;0
vpja36;8;6979;7128;-373,495698924731;549,745878136201;149;NA
vpja36;8;7177;7471;-540,595698924731;491,745878136201;294;NA
vpja36;8;7497;7934;-588,195698924731;469,845878136201;437;0
vpja36;8;8002;8299;-486,195698924731;23,0458781362007;297;0
vpja36;8;8343;8668;-456,895698924731;209,945878136201;325;0
vpja36;8;8734;8872;-457,895698924731;-308,854121863799;138;0
vpja36;8;8916;9361;-507,095698924731;-413,554121863799;445;0
vpja36;8;9415;9627;-235,395698924731;-374,354121863799;212;0
vpja36;8;9668;9934;-104,195698924731;-287,854121863799;266;0
vpja36;9;208;347;4,09999999999991;-295,9;139;255000
vpja36;9;371;635;-28;-286,7;264;255000
vpja36;9;646;1281;-43,8000000000001;-272,8;635;255000
vpja36;9;1312;1348;-116,1;-264,3;36;0
vpja36;9;1426;1749;-517,3;219,9;323;255
vpja36;9;1774;2130;-534;253,9;356;255
vpja36;9;2139;2345;-545,9;249;206;255
vpja36;9;2433;2956;225,5;330,5;523;255255000
vpja36;9;2985;3117;113,7;383;132;255255000
vpja36;9;3173;3377;-130,2;430,5;204;0
vpja36;9;3462;4031;433,8;152;569;0
vpja36;9;4078;4452;427,8;39,8;374;0
vpja36;9;4516;4850;399,6;-288;334;0
vpja36;9;4902;5511;491,6;-373,2;609;0
vpja36;9;5591;5797;-284,2;-259,3;206;0
vpja36;9;6337;6552;-371,4;73,1;215;0
vpja36;9;6590;6810;-381,9;173,4;220;0
vpja36;9;6829;6995;-411,4;180,3;166;0
vpja36;9;7042;7310;-366,7;-6,10000000000002;268;0
vpja36;9;7341;7729;-408,5;180,5;388;0
vpja36;9;7779;8043;-471,4;351;264;255
vpja36;9;8094;8247;-304,7;386,3;153;0
vpja36;9;8290;8473;-122;433,6;183;0
vpja36;9;8536;8974;207,1;360,5;438;255255000
vpja36;9;9030;9380;355,2;172,1;350;0
vpja36;9;9479;9623;383,2;-152,7;144;0
vpja36;9;9681;10000;460,2;-369,9;319;0
vpja36;10;196;367;-1,79999999999995;-246;171;255000
vpja36;10;390;864;15,6;-268,5;474;255000
vpja36;10;939;1119;-315,8;109,7;180;0
vpja36;10;1152;2005;-344,8;155,1;853;255255000
vpja36;10;2091;2510;302,5;75,6;419;255
vpja36;10;2526;2821;291,5;71,2;295;255
vpja36;10;2877;3006;464;-25,8;129;0
vpja36;10;3061;3319;538,5;-198,6;258;0
vpja36;10;3366;4250;558,8;-335,6;884;0
vpja36;10;4278;4469;542,4;-256,5;191;0
vpja36;10;4530;4615;619,2;91,3000000000001;85;0
vpja36;10;4639;5321;624,3;53,4000000000001;682;0
vpja36;10;5370;5475;492,8;190,1;105;0
vpja36;10;5596;5741;-418,5;-37,1999999999999;145;0
vpja36;10;5787;5996;-559,2;67;209;0
vpja36;10;6019;6331;-582,5;81,2;312;0
vpja36;10;6365;6657;-537,8;59,7;292;0
vpja36;10;6677;7467;-539,4;69;790;0
vpja36;10;7480;7873;-533,2;55,6;393;0
vpja36;10;7956;8185;-371;-427;229;0
vpja36;10;8255;8576;-42,1999999999999;-412,4;321;0
vpja36;10;8630;8935;26,8000000000001;-285,8;305;255000
vpja36;10;8955;9182;20,4000000000001;-274,7;227;255000
vpja36;10;9225;9522;-100,8;-323,5;297;0
vpja36;10;9578;9740;-268,7;-309;162;0
vpja36;10;9769;9984;-363,3;-299,9;215;0
vpja36;11;241;329;122,28768115942;-240,347101449275;88;255000
vpja36;11;355;595;158,18768115942;-157,247101449275;240;255000
vpja36;11;614;2073;161,08768115942;-164,347101449275;1459;255000
vpja36;11;2143;2331;175,58768115942;232,852898550725;188;255
vpja36;11;2359;2639;238,08768115942;223,452898550725;280;255
vpja36;11;2658;2912;246,18768115942;210,252898550725;254;255
vpja36;11;2958;3187;243,58768115942;358,852898550725;229;255
vpja36;11;3221;3406;238,38768115942;237,052898550725;185;255
vpja36;11;3432;3714;248,98768115942;181,452898550725;282;255
vpja36;11;3803;4085;-453,61231884058;211,252898550725;282;255255000
vpja36;11;4139;4417;-370,31231884058;-78,7471014492753;278;0
vpja36;11;4471;4656;-161,21231884058;-166,447101449275;185;0
vpja36;11;4707;4844;-132,51231884058;-359,547101449275;137;0
vpja36;11;4864;5231;-120,51231884058;-329,647101449275;367;0
vpja36;11;5252;5469;-136,11231884058;-331,047101449275;217;0
vpja36;11;5517;5742;-114,21231884058;-153,447101449275;225;0
vpja36;11;5767;5943;-102,21231884058;-117,347101449275;176;0
vpja36;11;5984;6217;-101,31231884058;-189,747101449275;233;0
vpja36;11;6225;6372;-108,41231884058;-181,947101449275;147;0
vpja36;11;6403;6842;-132,71231884058;-177,947101449275;439;0
vpja36;11;6859;7231;-120,91231884058;-183,847101449275;372;0
vpja36;11;7255;7468;-92,7123188405799;-182,947101449275;213;0
vpja36;11;7479;7764;-78,4123188405798;-182,947101449275;285;0
vpja36;11;7802;7971;-134,11231884058;-169,047101449275;169;0
vpja36;11;8066;8215;252,38768115942;-328,847101449275;149;0
vpja36;11;8255;8452;358,88768115942;-362,347101449275;197;0
vpja36;11;8478;8741;369,68768115942;-401,847101449275;263;0
vpja36;11;8761;8960;362,78768115942;-360,147101449275;199;0
vpja36;11;9013;9242;520,28768115942;-338,047101449275;229;0
vpja36;11;9264;9461;494,48768115942;-286,147101449275;197;0
vpja36;11;9492;9738;454,38768115942;-255,447101449275;246;0
vpja36;11;9785;10000;434,48768115942;-65,7471014492753;215;0
vpja36;12;1;178;-5,80000000000007;23,0999999999999;177;2,55e+08
vpja36;12;206;341;45;-26,7;135;255000
vpja36;12;363;740;77,6999999999999;-7,5;377;0
vpja36;12;796;1161;284,5;113,9;365;255
vpja36;12;1217;1617;65,6999999999999;227;400;0
vpja36;12;1644;1888;29,1999999999999;227,3;244;0
vpja36;12;1913;2137;-5,30000000000007;225,6;224;0
vpja36;12;2187;2300;21,1999999999999;54,8;113;2,55e+08
vpja36;12;2341;2476;51,4999999999999;-38,2;135;255000
vpja36;12;2495;2816;61,9;-31,5;321;255000
vpja36;12;2842;3329;46,3;27,6999999999999;487;2,55e+08
vpja36;12;3380;3869;-3,5;196;489;255255000
vpja36;12;3893;3968;34;168,1;75;255255000
vpja36;12;4030;4242;-134;-203;212;0
vpja36;12;4281;4586;-55;-194,9;305;0
vpja36;12;4606;4723;-32,4;-189,7;117;0
vpja36;12;4797;5076;383;-179;279;0
vpja36;12;5104;5191;404,8;-163,9;87;0
vpja36;12;5228;5528;312,5;-159,4;300;0
vpja36;12;5591;6188;38,6999999999999;241,9;597;0
vpja36;12;6214;6350;-18,5;236;136;0
vpja36;12;6411;6594;-288,4;-57,0000000000001;183;0
vpja36;12;6647;6777;-304,4;-262,7;130;0
vpja36;12;6836;7005;-504,1;-38,2;169;0
vpja36;12;7045;7319;-557,5;44,1999999999999;274;0
vpja36;12;7362;7617;-564,8;215,9;255;0
vpja36;12;7632;7868;-562,2;197,3;236;0
vpja36;12;7914;8413;-555,9;387,5;499;0
vpja36;12;8433;8687;-543,5;389;254;0
vpja36;12;8777;8955;148,6;477,5;178;0
vpja36;12;8988;9326;221,6;511,5;338;NA
vpja36;12;9406;9566;392,6;-50,5000000000001;160;0
vpja36;12;9623;9838;58,6;-38,5;215;255000
vpja36;12;9862;10000;73,9999999999999;-40,1;138;255000
vpja36;13;209;331;152,1;-133,5;122;255000
vpja36;13;351;553;181,1;-95,1;202;2,55e+08
vpja36;13;562;773;176,5;-99,9;211;255000
vpja36;13;833;1085;-109,5;321,3;252;255
vpja36;13;1119;1262;-173,4;329,4;143;255
vpja36;13;1285;1757;-208,7;332,2;472;255
vpja36;13;1839;2045;190,8;-104,4;206;2,55e+08
vpja36;13;2067;2331;170,7;-100,9;264;255000
vpja36;13;2388;2468;-103;-74,8;80;0
vpja36;13;2525;2794;-413,8;-90,3;269;0
vpja36;13;2849;3275;-417,9;-365,8;426;0
vpja36;13;3322;3504;-297,3;-317,9;182;0
vpja36;13;3574;3794;34,6;-326,4;220;0
vpja36;13;3831;3994;96,0000000000001;-335,5;163;0
vpja36;13;4062;4301;434,5;-348,5;239;0
vpja36;13;4365;4495;244,6;-80,3;130;2,55e+08
vpja36;13;4529;4890;179,4;-111,2;361;255000
vpja36;13;4956;5392;397,4;152,5;436;0
vpja36;13;5447;5596;323,5;289;149;255255000
vpja36;13;5634;5832;285,2;372;198;255255000
vpja36;13;5854;6143;305,5;388,4;289;255255000
vpja36;13;6206;6493;-61;330,9;287;0
vpja36;13;6520;6981;-141,7;317,6;461;255
vpja36;13;7037;7367;-315,6;216,5;330;0
vpja36;13;7424;7750;-538,1;353,2;326;0
vpja36;13;7843;7996;-137,3;-102,7;153;0
vpja36;13;8028;8217;-173,3;-82,6;189;0
vpja36;13;8251;8467;-209,3;-53;216;0
vpja36;13;8520;8858;-73,1;-234,7;338;0
vpja36;13;8882;9139;-114,7;-245,1;257;0
vpja36;13;9173;9503;-159,6;-330,6;330;0
vpja36;13;9527;9769;-158,6;-294;242;0
vpja36;13;9825;10000;32,3000000000001;-290;175;0
vpja36;14;205;309;-38,7;-253;104;0
vpja36;14;340;1003;-27,7;-279,8;663;255000
vpja36;14;1068;1353;-100,9;22,1;285;255
vpja36;14;1378;1826;-83,1;-29;448;255
vpja36;14;1871;2142;-212,8;-69,4;271;255255000
vpja36;14;2166;2763;-240,3;-106,9;597;255255000
vpja36;14;2838;3025;178,7;-76,1;187;0
vpja36;14;3048;3267;165,5;-42,1;219;0
vpja36;14;3279;3530;170,9;-24,6999999999999;251;0
vpja36;14;3581;3731;320,6;-42,8;150;0
vpja36;14;3757;4159;386;-62,4;402;0
vpja36;14;4186;4540;299,8;-55,6;354;0
vpja36;14;4568;5146;364,9;-56,1999999999999;578;0
vpja36;14;5177;5295;451,9;-73;118;0
vpja36;14;5329;5547;511,8;-86,6;218;0
vpja36;14;5578;5879;550,9;-67;301;0
vpja36;14;5937;6127;341,6;-270,9;190;0
vpja36;14;6172;6473;318,5;-373,7;301;0
vpja36;14;6528;6738;455,6;-306,2;210;0
vpja36;14;6756;7238;463,9;-299,5;482;0
vpja36;14;7260;7285;482,7;-257,1;25;0
vpja36;14;7296;7642;499,5;-196,9;346;0
vpja36;14;7675;7817;467;-274,4;142;0
vpja36;14;7865;8001;283,1;-247,1;136;0
vpja36;14;8060;8226;-52,6;-289,3;166;0
vpja36;14;8250;8481;-34,1;-277,1;231;255000
vpja36;14;8541;8696;-216,5;-28,8;155;255255000
vpja36;14;8724;9059;-241,5;-97,5;335;255255000
vpja36;14;9118;9271;-66,5;-293,4;153;0
vpja36;14;9303;9621;-28,2;-287,7;318;255000
vpja36;14;9707;9884;-537;-243,6;177;0
vpja36;14;9918;10000;-569,1;-185,2;82;0
vpja36;15;204;240;-94,6744680851064;-220,550354609929;36;0
vpja36;15;295;361;-391,774468085106;-179,450354609929;66;0
vpja36;15;539;616;-472,174468085106;-108,650354609929;77;255000
vpja36;15;1118;1291;-443,874468085106;-136,050354609929;173;255000
vpja36;15;1305;1506;-437,774468085106;-118,350354609929;201;255000
vpja36;15;1580;1797;-15,7744680851063;37,9496453900708;217;0
vpja36;15;1829;2059;19,3255319148936;-3,85035460992913;230;255
vpja36;15;2123;2263;-266,874468085106;172,849645390071;140;255255000
vpja36;15;2288;2589;-281,474468085106;130,349645390071;301;255255000
vpja36;15;2884;2997;-225,574468085106;-265,050354609929;113;0
vpja36;15;3040;3451;-153,174468085106;-283,650354609929;411;0
vpja36;15;3518;4083;110,225531914894;-417,250354609929;565;0
vpja36;15;4156;4395;474,525531914894;-386,750354609929;239;0
vpja36;15;4444;4651;537,925531914894;-210,650354609929;207;0
vpja36;15;4690;5118;471,025531914894;-176,850354609929;428;0
vpja36;15;5209;5652;-301,574468085106;-429,750354609929;443;0
vpja36;15;5705;5928;-448,274468085106;-310,050354609929;223;0
vpja36;15;5952;6303;-483,074468085106;-336,750354609929;351;0
vpja36;15;6383;6575;-568,174468085106;408,249645390071;192;0
vpja36;15;6608;6751;-540,974468085106;456,249645390071;143;0
vpja36;15;6805;6960;-344,574468085106;420,049645390071;155;0
vpja36;15;7016;7066;-172,974468085106;226,849645390071;50;255255000
vpja36;15;7108;7554;-275,074468085106;135,949645390071;446;255255000
vpja36;15;7980;8398;40,2255319148937;39,1496453900709;418;255
vpja36;15;8467;8611;410,725531914894;-72,2503546099291;144;0
vpja36;15;8651;8823;525,125531914894;-58,5503546099291;172;0
vpja36;15;8848;9057;528,425531914894;-112,750354609929;209;0
vpja36;15;9084;9420;582,625531914894;-170,550354609929;336;0
vpja36;15;9458;9658;533,425531914894;-83,3503546099291;200;0
vpja36;15;9797;10000;574,725531914894;50,5496453900709;203;0
vpja36;16;227;370;65,1;-253,5;143;255000
vpja36;16;391;1075;58,1;-274,6;684;255000
vpja36;16;1134;1467;-109,7;14,9;333;255
vpja36;16;1502;1848;-161,6;61,5999999999999;346;255
vpja36;16;1882;1922;-213,4;83,9;40;255
vpja36;16;1991;2115;-517,9;64,9;124;0
vpja36;16;2169;2402;-608,9;-147,4;233;0
vpja36;16;2442;2779;-600,4;-25,6;337;0
vpja36;16;2851;2975;-189,6;79,4;124;255
vpja36;16;3055;3258;407,2;90,8;203;255255000
vpja36;16;3289;3792;439,7;71,8;503;255255000
vpja36;16;3816;3883;376,6;86,1999999999999;67;255255000
vpja36;16;3951;4490;-127,4;73,0999999999999;539;255
vpja36;16;4542;4684;-278,9;27,6999999999999;142;0
vpja36;16;4707;5001;-310;6,29999999999995;294;0
vpja36;16;5034;5075;-349,3;-30;41;0
vpja36;16;5241;5647;-543,6;244,4;406;0
vpja36;16;5709;6004;-173,7;39,5;295;255
vpja36;16;6087;6425;429,7;33,4;338;255255000
vpja36;16;6444;10000;454,1;30,0999999999999;3556;255255000
vpja36;17;185;317;-43,1999999999999;-200,8;132;255000
vpja36;17;327;378;-47,1999999999999;-187,3;51;255000
vpja36;17;1301;1571;-327,6;191,4;270;255
vpja36;17;1603;1878;-347,7;116,4;275;255
vpja36;17;1892;2243;-347,9;83,0999999999999;351;255
vpja36;17;2295;2669;-489,1;-13,5;374;0
vpja36;17;2697;2904;-400;-56,3000000000001;207;0
vpja36;17;2928;3256;-410,9;-94,5000000000001;328;0
vpja36;17;3286;3506;-362;-36,3000000000001;220;0
vpja36;17;3518;3891;-364,7;-17,8000000000001;373;0
vpja36;17;4040;4230;364,5;148,6;190;0
vpja36;17;4256;5097;341,6;198,4;841;255255000
vpja36;17;5156;5325;412,3;-6;169;0
vpja36;17;5392;5554;-25,5;-204,3;162;255000
vpja36;17;5586;6206;-58,5;-202,7;620;255000
vpja36;17;6260;6512;-344,1;-378,3;252;0
vpja36;17;6537;6811;-440;-395,6;274;0
vpja36;17;6837;7463;-522,6;-419;626;0
vpja36;17;7487;7798;-560,3;-422,1;311;0
vpja36;17;7903;7924;449,7;-434,6;21;0
vpja36;17;7944;8319;454,6;-386,7;375;0
vpja36;17;8370;8736;583,3;-412,3;366;0
vpja36;17;8786;8980;346,6;-382;194;0
vpja36;17;9037;9148;16,7;-218,2;111;255000
vpja36;17;9184;9375;-33,6999999999999;-199,4;191;255000
vpja36;17;9445;9750;-430,2;-62,8000000000001;305;0
vpja36;17;9777;9981;-474;-1,5;204;0
vpja36;18;202;325;-85,9;-190,6;123;255000
vpja36;18;342;399;-93,0999999999999;-165,5;57;255000
vpja36;18;998;1221;83,4000000000001;130,9;223;0
vpja36;18;1240;1371;53,9000000000001;124,6;131;255
vpja36;18;1427;1647;-274;125,1;220;0
vpja36;18;1668;2376;-296,5;127,5;708;0
vpja36;18;2437;2569;168,5;57,4000000000001;132;0
vpja36;18;2620;3188;304,2;-71,6999999999999;568;0
vpja36;18;3212;3339;320;-92,9999999999999;127;0
vpja36;18;3395;3826;551,2;-245,3;431;0
vpja36;18;3855;4367;573,1;-263,3;512;0
vpja36;18;4417;4578;562,1;-50,0999999999999;161;0
vpja36;18;4633;4841;532;265,8;208;0
vpja36;18;4903;5075;196,5;52,7;172;0
vpja36;18;5114;5402;103,6;112,7;288;0
vpja36;18;5429;5609;50;122,1;180;255
vpja36;18;5667;5905;-289;108,8;238;0
vpja36;18;5932;6468;-303,8;134,3;536;0
vpja36;18;6648;6686;-464;-222,5;38;0
vpja36;18;6718;7145;-506,6;-341,4;427;0
vpja36;18;7195;7706;-338;-391,2;511;0
vpja36;18;7761;8870;-99,5;-389,5;1109;0
vpja36;18;8918;9274;-101,8;-196,5;356;255000
vpja36;18;9296;9560;-96,3;-169,6;264;255000
vpja36;18;9631;9882;346,1;-74,5;251;0
vpja36;18;9941;10000;560;-235;59;0
vpja36;19;224;329;-104,1;-49,1;105;2,55e+08
vpja36;19;373;421;-145,7;-201,2;48;255000
vpja36;19;1121;1329;-50,9;-384,9;208;0
vpja36;19;1354;1508;-14,1;-399,9;154;0
vpja36;19;1539;1920;95,2;-414,1;381;0
vpja36;19;1985;2229;369;-69,8;244;255255000
vpja36;19;2255;2567;295,8;-11,4;312;255255000
vpja36;19;2620;2887;357,9;245,3;267;0
vpja36;19;2912;3114;330,8;250,5;202;0
vpja36;19;3130;3348;311;234;218;0
vpja36;19;3397;3626;435,6;231,7;229;0
vpja36;19;3724;4063;-417,3;315,9;339;255
vpja36;19;4088;4302;-463,8;299,3;214;255
vpja36;19;4377;4514;-164,5;-249,8;137;255000
vpja36;19;4524;4724;-175,3;-237,9;200;255000
vpja36;19;4785;5121;-451;0,299999999999955;336;0
vpja36;19;5178;6075;-400,7;-293,4;897;0
vpja36;19;6142;6568;-487,9;58,1999999999999;426;0
vpja36;19;6599;7127;-529,8;7,89999999999998;528;0
vpja36;19;7177;7764;-498,7;289,7;587;255
vpja36;19;7795;8784;-514,9;413,2;989;0
vpja36;19;8921;9184;371;208,2;263;0
vpja36;19;9206;9448;340,2;194,1;242;0
vpja36;19;9499;9846;181,3;263,7;347;0
vpja36;19;9876;10000;85;268,1;124;0
vpja36;20;62;159;33,5000000000001;-10,9;97;0
vpja36;20;221;337;-259,9;-223,6;116;255000
vpja36;20;875;1080;162,4;314;205;255255000
vpja36;20;1118;1464;176;248,9;346;255255000
vpja36;20;1544;1767;-409,4;432,1;223;255
vpja36;20;1795;2433;-434,3;395;638;255
vpja36;20;2500;2654;-550,7;-165,9;154;0
vpja36;20;2705;3312;-571,8;-344,7;607;0
vpja36;20;3362;3590;-454,7;-399,9;228;0
vpja36;20;3695;3742;382;-98,6999999999999;47;0
vpja36;20;3752;3975;392,2;-47,4;223;0
vpja36;20;4028;4270;518;-117,3;242;0
vpja36;20;4302;4545;551,2;-124,9;243;0
vpja36;20;4572;5299;564,6;-178,4;727;0
vpja36;20;5355;6247;277,2;-297;892;0
vpja36;20;6302;6543;144,2;-54,6999999999999;241;0
vpja36;20;6621;7654;-319;-228,7;1033;255000
vpja36;20;7764;7992;192;298,6;228;255255000
vpja36;20;8015;8223;193,8;248;208;255255000
vpja36;20;8239;8454;184,1;267,5;215;255255000
vpja36;20;8523;8729;-408;413,2;206;255
vpja36;20;8755;9203;-440,3;430,4;448;255
vpja36;20;9228;9448;-454,6;497;220;NA
vpja36;20;9482;9608;-380,1;407,6;126;255
vpja36;20;9688;9848;-97,5999999999999;-179;160;0
vpja36;20;9898;10000;37,4000000000001;-119,1;102;0
vpja36;21;165;272;-89,1;-105,8;107;255000
vpja36;21;293;401;-69,9;-77,2;108;255000
vpja36;21;1657;1784;-101,9;-390,6;127;0
vpja36;21;1822;2502;-23,4;-374,5;680;0
vpja36;21;2561;2805;-386,4;-392,6;244;0
vpja36;21;2831;3247;-419,1;-376;416;0
vpja36;21;3301;3494;-417,2;-89,1;193;0
vpja36;21;3517;3766;-465;-93,9;249;0
vpja36;21;3823;4624;-429,1;176,7;801;255255000
vpja36;21;4666;5139;-379,5;292,6;473;0
vpja36;21;5174;5588;-302,2;319,5;414;0
vpja36;21;5617;5966;-326,2;257,1;349;0
vpja36;21;6047;6314;215,8;187;267;0
vpja36;21;6344;6828;221,9;112,5;484;255
vpja36;21;6843;7007;206;125,7;164;255
vpja36;21;7068;7298;379,8;43,3000000000001;230;0
vpja36;21;7335;7759;368,8;15,5;424;0
vpja36;21;7779;8187;382,1;29,5;408;0
vpja36;21;8211;8546;428,8;81,9;335;0
vpja36;21;8599;8969;605,5;31,9;370;0
vpja36;21;9020;9156;371,2;97,9;136;0
vpja36;21;9208;9406;229,2;269,5;198;0
vpja36;21;9432;9537;179,1;249;105;0
vpja36;21;9569;9749;34;256,8;180;0
vpja36;21;9798;9967;-101,9;353,5;169;0
vpja36;22;222;477;-8;-223,4;255;255000
vpja36;22;492;933;5;-238,2;441;255000
vpja36;22;951;1529;2,79999999999995;-264,5;578;255000
vpja36;22;1550;1737;-5,10000000000002;-232,1;187;255000
vpja36;22;1817;2083;480,5;-42,8000000000001;266;0
vpja36;22;2134;2299;452,5;178,8;165;255
vpja36;22;2343;2697;418,7;91,4;354;0
vpja36;22;2725;2923;399,4;163,2;198;255
vpja36;22;3050;3294;-378,9;266,3;244;255255000
vpja36;22;3335;3715;-469,5;135,6;380;0
vpja36;22;3778;3927;-526,9;-273,5;149;0
vpja36;22;3963;4303;-564,9;-238,5;340;0
vpja36;22;4389;4762;96,8;-386,3;373;0
vpja36;22;4789;5154;91;-438,3;365;0
vpja36;22;5224;5543;429,3;-41,6;319;0
vpja36;22;5582;5834;267,5;29,5999999999999;252;0
vpja36;22;5863;6156;155,7;35,1999999999999;293;0
vpja36;22;6178;6386;121,7;22,6999999999999;208;0
vpja36;22;6441;6540;-66,9;-122,2;99;2,55e+08
vpja36;22;6595;6688;-10,8;-289,8;93;255000
vpja36;22;6712;7302;-21,2;-256,3;590;255000
vpja36;22;7326;7491;-39;-287,2;165;255000
vpja36;22;7542;8448;-418,4;64,8;906;0
vpja36;22;8484;8763;-380,6;239,3;279;255255000
vpja36;22;8809;8869;-335,5;393,5;60;0
vpja36;22;8937;9069;-24,3;391,4;132;0
vpja36;22;9122;9516;152,5;392,8;394;0
vpja36;22;9573;9709;394,9;239,8;136;255
vpja36;22;9757;10000;432;93,8;243;0
vpja36;23;254;472;101,8;-184,1;218;2,55e+08
vpja36;23;532;743;-252,8;222;211;0
vpja36;23;766;1266;-277,7;243,1;500;0
vpja36;23;1349;1554;310,3;182,1;205;255
vpja36;23;1581;1943;312,3;164;362;255
vpja36;23;1972;2194;197,9;169,9;222;0
vpja36;23;2273;2435;135,7;-189,4;162;0
vpja36;23;2458;2787;122,5;-162,9;329;2,55e+08
vpja36;23;2862;3520;549,6;-46,3;658;0
vpja36;23;3573;4256;505,8;-283,2;683;0
vpja36;23;4308;4655;314,1;-288,5;347;0
vpja36;23;4703;4933;237,9;-383,9;230;0
vpja36;23;5008;5499;-178,8;-357,1;491;0
vpja36;23;5560;6393;-422,9;-332,3;833;0
vpja36;23;6461;6741;-385,2;36,8;280;0
vpja36;23;6767;6967;-388,8;4,10000000000002;200;0
vpja36;23;6996;7324;-433,2;-74,7;328;0
vpja36;23;7379;7792;-621;-17,6;413;0
vpja36;23;8002;8237;-611,5;-51,7;235;0
vpja36;23;8303;8725;-493,2;366,7;422;0
vpja36;23;8752;9067;-404,9;380,3;315;0
vpja36;23;9150;9614;287,9;338,1;464;0
vpja36;23;9657;10000;107,7;250,6;343;0
vpja36;24;262;374;-58,7;-148,8;112;2,55e+08
vpja36;24;771;961;-194,1;166;190;0
vpja36;24;1014;1171;-313,2;322,7;157;0
vpja36;24;1208;1343;-348,3;381,1;135;0
vpja36;24;1397;1535;-231,1;139,6;138;2,55e+08
vpja36;24;1588;2368;-452;128,7;780;255
vpja36;24;2443;2726;15,8;116,7;283;0
vpja36;24;2750;3151;15,6999999999999;94,6;401;255255000
vpja36;24;3200;3511;245,7;-5,79999999999995;311;0
vpja36;24;3560;4083;383,6;-29,9;523;0
vpja36;24;4142;4293;526,3;-18,3;151;0
vpja36;24;4334;4468;574,3;-73,1;134;0
vpja36;24;4492;5316;603,9;-84;824;0
vpja36;24;5371;5579;516,5;-303,5;208;0
vpja36;24;5595;5877;494;-296,1;282;0
vpja36;24;5906;6183;460,4;-361,4;277;0
vpja36;24;6266;6422;-244,3;-393;156;0
vpja36;24;6479;6701;-480,7;-371,7;222;0
vpja36;24;7340;7626;-215,1;174,4;286;0
vpja36;24;7680;7962;-446,1;116,1;282;255
vpja36;24;8007;8685;-462;-13,1;678;0
vpja36;24;8759;9405;-6,60000000000002;80,2;646;255255000
vpja36;24;9462;9745;146,6;-110,4;283;0
vpja36;24;9792;10000;263,8;-1,10000000000002;208;0
vpja36;25;240;549;101,7;-252,3;309;255000
vpja36;25;604;778;109,3;103,9;174;2,55e+08
vpja36;25;812;1143;165,9;88,0999999999999;331;2,55e+08
vpja36;25;1204;1554;124,5;-279,8;350;255000
vpja36;25;1644;2275;-414,2;-400;631;0
vpja36;25;2350;2600;-492,8;359,1;250;255255000
vpja36;25;2630;3264;-462,8;357,8;634;0
vpja36;25;3455;3722;447,4;340,1;267;255
vpja36;25;3769;4014;431,5;59,4;245;0
vpja36;25;4038;4202;488,5;44,8;164;0
vpja36;25;4255;4548;440,9;-111,4;293;0
vpja36;25;4572;4976;424,4;-155,9;404;0
vpja36;25;5030;5529;531,2;-10,7;499;0
vpja36;25;5562;5733;480,4;-6,70000000000005;171;0
vpja36;25;5975;6020;555,4;-391,6;45;0
vpja36;25;6043;6114;574,5;-346,3;71;0
vpja36;25;6159;6818;568,5;-430,2;659;0
vpja36;25;6852;7838;421,7;-442,9;986;0
vpja36;25;7939;8931;-393,7;-384,9;992;0
vpja36;25;9004;9615;-446,3;337,3;611;0
vpja36;25;9652;9950;-462,6;404,5;298;0
vpja36;25;9960;10000;-465,4;386,8;40;0
vpja36;26;211;416;-81,8;-330,6;205;255000
vpja36;26;446;685;-41,9;-349,5;239;255000
vpja36;26;701;933;-43,9;-372,2;232;255000
vpja36;26;942;1317;-47;-352,5;375;255000
vpja36;26;1437;1559;393,6;448;122;0
vpja36;26;1588;1807;411,6;351,6;219;255
vpja36;26;1853;2074;357,1;204,7;221;0
vpja36;26;2116;2213;215,3;201,4;97;0
vpja36;26;2227;2249;222;250,1;22;255
vpja36;26;2398;2442;-628,9;405,6;44;0
vpja36;26;2450;2854;-598,2;357,7;404;0
vpja36;26;2884;3135;-552,1;313,3;251;0
vpja36;26;3199;3304;-518;-27,5;105;0
vpja36;26;3362;3634;-530,6;-314,7;272;0
vpja36;26;3663;4101;-415;-391,6;438;0
vpja36;26;4134;4627;-449,3;-392,6;493;0
vpja36;26;4639;4895;-442,9;-374,8;256;0
vpja36;26;4949;5157;-286,4;-404,4;208;0
vpja36;26;5215;5382;-87,7;-367,8;167;255000
vpja36;26;5455;5785;281,6;-298,8;330;0
vpja36;26;5815;5934;301,4;-295,4;119;0
vpja36;26;5963;6181;199,4;-251,3;218;0
vpja36;26;6202;6453;172,1;-239,9;251;0
vpja36;26;6506;6908;306,2;-334,6;402;0
vpja36;26;6961;7170;463;-254,7;209;0
vpja36;26;7194;7673;488,6;-268,5;479;0
vpja36;26;7725;8233;563,4;-73;508;0
vpja36;26;8258;8471;578;-22;213;0
vpja36;26;8484;8814;584;-34,5;330;0
vpja36;26;8876;9161;318,2;-277,9;285;0
vpja36;26;9194;9388;156,2;-295,7;194;0
vpja36;26;9425;9605;-7,79999999999995;-319,8;180;255000
vpja36;26;9642;9816;-71,5;-329,7;174;255000
vpja36;26;9878;10000;-401,7;-301,7;122;0
