vp;trial;timest;timeend;x;y;duration;roi
vpja15;1;329;487;-29,1999999999999;-158,1;158;255000
vpja15;1;509;563;-55,3;-175,5;54;255000
vpja15;1;619;1355;-343;152,7;736;255
vpja15;1;1428;1806;218;187,7;378;255255000
vpja15;1;1870;2172;-29,1999999999999;-196,9;302;255000
vpja15;1;2216;2495;204,6;-219,5;279;0
vpja15;1;2561;2746;198;231,5;185;0
vpja15;1;2813;3004;294,7;-116,8;191;0
vpja15;1;3057;3243;198,4;241,6;186;0
vpja15;1;3269;3438;214,9;215,5;169;0
vpja15;1;3509;3615;8,80000000000007;-251,9;106;255000
vpja15;1;3643;3788;-32,5;-191,4;145;255000
vpja15;1;3835;4211;-281,4;-226,9;376;0
vpja15;1;4251;4468;-450,3;-290,4;217;0
vpja15;1;4619;4738;-26,3;-215,8;119;255000
vpja15;1;4762;5088;-25,1;-184,7;326;255000
vpja15;1;5143;5246;-8,39999999999998;64,7;103;2,55e+08
vpja15;1;5293;5432;-84,3;138,5;139;2,55e+08
vpja15;1;5456;5721;-135,5;141,1;265;2,55e+08
vpja15;1;5769;6083;-45,1;-189,8;314;255000
vpja15;1;6137;6496;-356,9;174,3;359;255
vpja15;1;6560;6980;210,8;210;420;255255000
vpja15;1;7044;7470;-324,7;139,4;426;255
vpja15;1;7492;7548;-326,8;112,8;56;0
vpja15;1;7630;8017;269,5;-263,9;387;0
vpja15;1;8041;8195;263,3;-227;154;0
vpja15;1;8243;8540;512,7;-14,1999999999999;297;0
vpja15;1;8612;8725;186,8;281,1;113;0
vpja15;1;8753;9011;211,9;218,5;258;0
vpja15;1;9127;9475;-289,2;-259;348;0
vpja15;1;9511;9685;-421,4;-203,8;174;0
vpja15;1;9726;9864;-420,9;12,3000000000001;138;0
vpja15;1;9927;10000;-429,3;-285,3;73;0
vpja15;2;327;444;-70,4870967741936;-158,316129032258;117;255000
vpja15;2;500;786;-214,287096774194;285,983870967742;286;0
vpja15;2;839;993;124,312903225806;213,983870967742;154;0
vpja15;2;1012;1396;149,212903225806;218,183870967742;384;0
vpja15;2;1405;1478;161,812903225806;222,183870967742;73;0
vpja15;2;1536;1764;-205,087096774193;290,583870967742;228;0
vpja15;2;1775;2001;-188,687096774193;295,183870967742;226;0
vpja15;2;2056;2266;152,812903225806;196,283870967742;210;0
vpja15;2;2315;2561;331,312903225806;-48,9161290322581;246;0
vpja15;2;2616;2747;-35,2870967741935;-191,316129032258;131;2,55e+08
vpja15;2;2772;3036;-65,0870967741935;-233,116129032258;264;255000
vpja15;2;3088;3243;-132,587096774193;-39,2161290322581;155;2,55e+08
vpja15;2;3269;3473;-150,687096774193;14,8838709677419;204;2,55e+08
vpja15;2;3517;3667;-68,5870967741935;-244,016129032258;150;255000
vpja15;2;3727;3941;135,612903225807;200,583870967742;214;0
vpja15;2;3993;4323;-194,787096774194;295,183870967742;330;0
vpja15;2;4401;4656;-469,087096774194;-72,4161290322581;255;0
vpja15;2;4697;4977;-538,387096774194;86,983870967742;280;0
vpja15;2;5046;5160;-137,787096774194;-205,316129032258;114;2,55e+08
vpja15;2;5189;5372;-79,3870967741935;-259,116129032258;183;255000
vpja15;2;5402;5568;-185,887096774194;-236,016129032258;166;255000
vpja15;2;5619;5805;-166,087096774193;2,08387096774186;186;2,55e+08
vpja15;2;5819;5891;-147,687096774193;13,7838709677419;72;2,55e+08
vpja15;2;5924;6136;-151,287096774194;-75,7161290322581;212;2,55e+08
vpja15;2;6194;6589;-535,287096774194;-266,316129032258;395;0
vpja15;2;6617;7204;-586,487096774194;-324,916129032258;587;0
vpja15;2;7298;7511;306,412903225807;-93,2161290322581;213;0
vpja15;2;7545;7730;392,512903225806;-21,2161290322581;185;0
vpja15;2;7913;8038;176,112903225807;223,583870967742;125;0
vpja15;2;8056;8216;139,212903225806;214,483870967742;160;0
vpja15;2;8266;8481;-215,387096774194;297,883870967742;215;0
vpja15;2;8502;8926;-187,987096774194;303,183870967742;424;0
vpja15;2;8977;9116;114,212903225806;214,583870967742;139;0
vpja15;2;9159;9307;-80,2870967741935;140,783870967742;148;2,55e+08
vpja15;2;9327;9589;-84,4870967741936;178,483870967742;262;2,55e+08
vpja15;2;9618;10000;-142,487096774194;174,783870967742;382;0
vpja15;3;241;316;94,6280632411067;-95,2588932806324;75;2,55e+08
vpja15;3;351;568;100,128063241107;-210,458893280632;217;255000
vpja15;3;633;736;-307,171936758893;6,54110671936758;103;0
vpja15;3;782;879;-391,371936758893;97,9411067193677;97;255
vpja15;3;954;1120;186,328063241107;341,341106719368;166;255255000
vpja15;3;1191;1404;-416,871936758893;137,841106719368;213;255
vpja15;3;1427;1664;-422,871936758893;97,9411067193677;237;255
vpja15;3;1731;1925;-345,271936758893;-202,758893280632;194;0
vpja15;3;1973;2111;-78,6719367588934;-248,258893280632;138;0
vpja15;3;2159;2289;127,828063241107;-247,958893280632;130;255000
vpja15;3;2309;2486;97,2280632411066;-256,658893280632;177;255000
vpja15;3;2534;2589;-202,471936758893;-285,658893280632;55;0
vpja15;3;2677;2910;-354,271936758893;-292,958893280632;233;0
vpja15;3;2958;3185;-84,4719367588934;-353,158893280632;227;0
vpja15;3;3207;3461;-82,4719367588934;-370,958893280632;254;0
vpja15;3;3539;3776;181,628063241107;273,041106719368;237;255255000
vpja15;3;3798;4037;206,028063241107;227,041106719368;239;255255000
vpja15;3;4054;4273;226,728063241107;228,441106719368;219;255255000
vpja15;3;4355;4623;432,228063241107;-265,558893280632;268;0
vpja15;3;4649;4781;363,128063241107;-287,958893280632;132;0
vpja15;3;4826;4966;135,028063241107;-274,758893280632;140;255000
vpja15;3;4989;5176;86,1280632411067;-266,058893280632;187;255000
vpja15;3;5249;5465;-422,171936758893;143,841106719368;216;255
vpja15;3;5513;5721;-578,271936758893;441,641106719368;208;0
vpja15;3;5793;5914;-250,371936758893;-8,15889328063236;121;0
vpja15;3;5969;6226;-114,371936758893;-194,958893280632;257;0
vpja15;3;6268;6419;-113,071936758893;-324,858893280632;151;0
vpja15;3;6447;6662;-96,3719367588934;-390,358893280632;215;0
vpja15;3;6678;7030;-70,2719367588934;-393,358893280632;352;0
vpja15;3;7081;7340;-207,971936758893;-281,958893280632;259;0
vpja15;3;7390;7774;-419,071936758893;-97,8588932806324;384;0
vpja15;3;7899;8113;-111,471936758893;-168,058893280632;214;0
vpja15;3;8136;8528;-72,3719367588934;-153,658893280632;392;0
vpja15;3;8572;8729;-83,6719367588934;-349,958893280632;157;0
vpja15;3;8752;8851;-102,071936758893;-379,358893280632;99;0
vpja15;3;8915;9317;-388,471936758893;-193,958893280632;402;0
vpja15;3;9373;9639;-460,571936758893;141,641106719368;266;255
vpja15;3;9670;9748;-391,271936758893;116,641106719368;78;255
vpja15;3;9812;10000;165,428063241107;256,741106719368;188;255255000
vpja15;4;254;358;-284,9;117,1;104;0
vpja15;4;394;571;-351,3;152,2;177;255
vpja15;4;640;879;-9,30000000000007;-259,7;239;255000
vpja15;4;953;1197;263,9;207,7;244;0
vpja15;4;1207;1367;258,4;194,2;160;0
vpja15;4;1431;1623;27,0999999999999;-267,7;192;255000
vpja15;4;1644;2091;-4,5;-259,4;447;255000
vpja15;4;2113;2733;23,5999999999999;-296,5;620;255000
vpja15;4;2822;3077;284,4;160,8;255;255255000
vpja15;4;3089;3422;279,9;177,6;333;0
vpja15;4;3431;4891;287,6;182,8;1460;0
vpja15;4;4910;5098;262,8;177;188;0
vpja15;4;5175;5402;-323,9;146,9;227;255
vpja15;4;5420;5860;-342,5;132,6;440;255
vpja15;4;5946;6132;-7,60000000000002;-349,9;186;255000
vpja15;4;6160;6435;-77,6;-354,2;275;0
vpja15;4;6459;6598;-24,3000000000001;-411,9;139;0
vpja15;4;6657;6862;235;-348;205;0
vpja15;4;6902;7997;283,3;-444,8;1095;0
vpja15;4;8007;8200;279,1;-439,9;193;0
vpja15;4;8366;8486;-210,9;206,1;120;0
vpja15;4;8520;8867;-336,3;160,7;347;255
vpja15;4;8931;9287;221,1;183;356;0
vpja15;4;9303;9650;202,9;186,1;347;0
vpja15;4;9710;9817;27,4;-187,4;107;2,55e+08
vpja15;4;9848;10000;7,69999999999993;-271,3;152;255000
vpja15;5;264;508;-3,76265060240962;-185,359036144578;244;255000
vpja15;5;531;801;10,0373493975903;-240,259036144578;270;255000
vpja15;5;877;1037;272,23734939759;315,540963855422;160;0
vpja15;5;1060;1303;263,83734939759;348,540963855422;243;0
vpja15;5;1313;1630;279,23734939759;352,240963855422;317;0
vpja15;5;1653;2006;242,33734939759;315,540963855422;353;0
vpja15;5;2020;2124;252,83734939759;332,040963855422;104;0
vpja15;5;2183;2441;374,83734939759;106,640963855422;258;0
vpja15;5;2494;2612;279,93734939759;344,940963855422;118;0
vpja15;5;2698;2911;-513,76265060241;346,740963855422;213;255255000
vpja15;5;2939;3086;-494,86265060241;394,940963855422;147;255255000
vpja15;5;3107;3439;-503,76265060241;415,740963855422;332;0
vpja15;5;3528;3666;322,13734939759;169,340963855422;138;0
vpja15;5;3696;3948;381,23734939759;96,1409638554217;252;0
vpja15;5;3986;4300;516,43734939759;93,8409638554217;314;0
vpja15;5;4344;4471;521,03734939759;10,1409638554217;127;0
vpja15;5;4592;5069;493,93734939759;-392,559036144578;477;0
vpja15;5;5076;5249;505,63734939759;-377,259036144578;173;0
vpja15;5;5289;5624;426,83734939759;-498,459036144578;335;NA
vpja15;5;5696;5914;236,13734939759;-13,7590361445783;218;0
vpja15;5;5996;6116;397,53734939759;-453,259036144578;120;0
vpja15;5;6140;6529;417,43734939759;-498,659036144578;389;NA
vpja15;5;6547;6967;441,53734939759;-508,959036144578;420;NA
vpja15;5;6987;7339;390,93734939759;-470,859036144578;352;0
vpja15;5;7435;7699;478,53734939759;132,540963855422;264;0
vpja15;5;7726;8199;391,83734939759;143,740963855422;473;0
vpja15;5;8240;8469;511,83734939759;42,0409638554216;229;0
vpja15;5;8497;8793;510,13734939759;118,340963855422;296;0
vpja15;5;8844;9070;242,93734939759;-29,5590361445784;226;0
vpja15;5;9160;9365;240,53734939759;-28,2590361445783;205;0
vpja15;5;9393;9537;249,93734939759;-93,8590361445783;144;0
vpja15;5;9594;9765;-47,4626506024097;164,040963855422;171;2,55e+08
vpja15;5;9793;9894;-74,8626506024096;109,240963855422;101;2,55e+08
vpja15;5;9928;10000;56,8373493975904;137,840963855422;72;2,55e+08
vpja15;6;246;386;-253;120,7;140;255255000
vpja15;6;436;582;-407,7;-118,6;146;255000
vpja15;6;600;797;-421,6;-130,4;197;255000
vpja15;6;847;1151;-139,6;-205,2;304;0
vpja15;6;1183;1384;-32,0999999999999;-192,6;201;0
vpja15;6;1433;1658;92,1000000000001;-381,6;225;0
vpja15;6;1670;1829;85;-402,4;159;0
vpja15;6;1893;2117;518,1;-190;224;0
vpja15;6;2145;2311;569,7;-132,8;166;0
vpja15;6;2329;2597;602,4;-148,8;268;0
vpja15;6;2633;3012;464;-118,1;379;0
vpja15;6;3026;3348;445,4;-105,8;322;0
vpja15;6;3364;3611;449;-122,9;247;0
vpja15;6;3742;3958;-277,9;178,4;216;255255000
vpja15;6;3993;4173;-328,1;60,1;180;0
vpja15;6;4231;4534;-557,9;491,4;303;NA
vpja15;6;4603;4790;23,2;46,8000000000001;187;255
vpja15;6;4817;4923;-4,19999999999993;-22,6999999999999;106;255
vpja15;6;4967;5150;-166,5;-156;183;0
vpja15;6;5185;5352;-197,9;-214,7;167;0
vpja15;6;5390;5837;-20;-215,6;447;0
vpja15;6;5861;5971;-78,3;-224,3;110;0
vpja15;6;6015;6211;106,2;-398,5;196;0
vpja15;6;6229;6400;90,3;-406,5;171;0
vpja15;6;6423;6875;36,4000000000001;-363,8;452;0
vpja15;6;6921;7218;-92,3;-200,7;297;0
vpja15;6;7252;7812;-168,3;-227,4;560;0
vpja15;6;7937;8208;-157,1;-210,2;271;0
vpja15;6;8234;8346;-103,4;-193,8;112;0
vpja15;6;8386;8704;-245,8;-71,5;318;0
vpja15;6;8713;8942;-255,2;-74,6;229;0
vpja15;6;8983;9101;-229,6;-205,3;118;0
vpja15;6;9156;9537;-442,1;-140,7;381;255000
vpja15;6;9553;9704;-428,3;-131,2;151;255000
vpja15;6;9766;9887;-254,5;-329,7;121;0
vpja15;6;9945;10000;91,9000000000001;-375;55;0
vpja15;7;266;460;-124,6;-64,0000000000001;194;2,55e+08
vpja15;7;505;845;107,6;136,8;340;0
vpja15;7;871;1506;179,5;132,1;635;0
vpja15;7;1539;1877;75,5;141,6;338;0
vpja15;7;1913;2104;208,9;145;191;0
vpja15;7;2120;2193;231,2;154,3;73;0
vpja15;7;2259;2438;-314,6;83,9;179;0
vpja15;7;2474;2640;-429,4;150,2;166;255255000
vpja15;7;2664;3370;-459,3;144,3;706;255255000
vpja15;7;3502;3633;-128;-14,8000000000001;131;2,55e+08
vpja15;7;3652;3853;-138,3;-38;201;2,55e+08
vpja15;7;3911;4080;-455,5;259,6;169;0
vpja15;7;4111;4261;-343,6;285,9;150;0
vpja15;7;4342;4465;-225;-348,4;123;0
vpja15;7;4503;4656;-83,1;-334,2;153;0
vpja15;7;4715;4837;-129,1;-39,3000000000001;122;2,55e+08
vpja15;7;4860;5287;-128,3;-58,3000000000001;427;2,55e+08
vpja15;7;5346;5609;317,5;54,4;263;0
vpja15;7;5641;5948;355,3;156,3;307;0
vpja15;7;5996;6234;178,7;382,4;238;0
vpja15;7;6281;6765;174,7;158;484;0
vpja15;7;6821;7088;87,3;460,5;267;0
vpja15;7;7105;7191;73,0999999999999;473,9;86;0
vpja15;7;7238;7787;-147,1;351,7;549;0
vpja15;7;7929;8194;-510;435,3;265;0
vpja15;7;8272;8498;-509,4;-78,8000000000001;226;0
vpja15;7;8521;9140;-478,9;-80,2;619;0
vpja15;7;9162;9486;-489,2;-39,7;324;0
vpja15;7;9557;9770;-104,7;-392;213;0
vpja15;7;9796;10000;-86;-333;204;0
vpja15;8;298;380;-1,60000000000002;-148,5;82;2,55e+08
vpja15;8;406;515;-10;-208;109;2,55e+08
vpja15;8;588;768;-349,6;129,5;180;255
vpja15;8;791;1371;-364;91;580;0
vpja15;8;1447;2276;284,9;145,8;829;255255000
vpja15;8;2360;2650;-251,7;287,6;290;0
vpja15;8;2795;2995;33,5;-243,7;200;255000
vpja15;8;3062;3222;533,4;89,3000000000001;160;0
vpja15;8;3251;3466;533,6;6;215;0
vpja15;8;3513;3651;375,4;-223,7;138;0
vpja15;8;3765;3988;32;441,8;223;0
vpja15;8;4016;4211;83,5;489,8;195;NA
vpja15;8;4255;4520;-27,5;275,7;265;0
vpja15;8;4556;4891;-52,9;148,8;335;0
vpja15;8;4911;5164;-27,7;171,6;253;0
vpja15;8;5180;5625;-28,2;149,6;445;0
vpja15;8;5666;5877;-31,7;-40,1999999999999;211;2,55e+08
vpja15;8;5897;7434;-29,2;-85;1537;2,55e+08
vpja15;8;7470;7655;-3,79999999999995;-207,2;185;2,55e+08
vpja15;8;7677;10000;-10,1;-212,1;2323;2,55e+08
vpja15;9;213;338;108,5;-39,9;125;2,55e+08
vpja15;9;357;470;99,1999999999999;-67,5;113;2,55e+08
vpja15;9;526;740;1;332,2;214;255
vpja15;9;781;915;-169,6;299,2;134;255
vpja15;9;936;1042;-202,8;294,3;106;255
vpja15;9;1109;1420;358,7;411,9;311;255255000
vpja15;9;1436;1520;361,5;440,9;84;255255000
vpja15;9;1600;1852;-121,5;-97,6;252;0
vpja15;9;1893;2037;-244,3;-116,4;144;0
vpja15;9;2079;2374;-409,4;-82,5;295;0
vpja15;9;2413;2515;-486,1;56;102;0
vpja15;9;2587;2914;-40,6;-162,8;327;0
vpja15;9;2944;3111;-153,1;-163;167;0
vpja15;9;3133;3344;-189,8;-170,1;211;0
vpja15;9;3388;3742;-416,8;-158,9;354;0
vpja15;9;3786;3806;-421,3;-98,8;20;0
vpja15;9;3885;4059;99,6;-122,6;174;255000
vpja15;9;4082;4256;127,6;-73,6;174;255000
vpja15;9;4324;4619;373,8;425,5;295;255255000
vpja15;9;4684;5036;120,1;-80,5;352;255000
vpja15;9;5069;5231;105,8;25,6;162;2,55e+08
vpja15;9;5263;5469;193,4;71,2;206;2,55e+08
vpja15;9;5522;5758;373,2;411;236;255255000
vpja15;9;5776;6162;359,9;439,6;386;255255000
vpja15;9;6175;6325;384;448,9;150;255255000
vpja15;9;6356;6654;433,9;401,8;298;255255000
vpja15;9;6787;7081;134,1;120,9;294;2,55e+08
vpja15;9;7127;7535;410;209,5;408;0
vpja15;9;7559;7885;399;164,9;326;0
vpja15;9;8056;8503;96,6999999999999;-102,2;447;255000
vpja15;9;8566;8735;-122,3;283,8;169;255
vpja15;9;8762;8991;-189,2;280,8;229;255
vpja15;9;8999;9422;-198,7;275;423;255
vpja15;9;9488;9736;-535,9;316,3;248;0
vpja15;9;9825;9919;81,5;-95,9;94;255000
vpja15;10;224;447;55,9200692041522;-6,95951557093429;223;2,55e+08
vpja15;10;466;1473;48,6200692041523;-26,8595155709343;1007;255000
vpja15;10;1519;1733;308,620069204152;162,540484429066;214;255255000
vpja15;10;1754;2211;303,820069204152;126,640484429066;457;255255000
vpja15;10;2255;2405;73,3200692041523;194,940484429066;150;255
vpja15;10;2426;2750;36,1200692041523;217,340484429066;324;0
vpja15;10;2764;3013;60,3200692041523;229,940484429066;249;0
vpja15;10;3069;3421;36,6200692041523;-48,6595155709342;352;255000
vpja15;10;3435;3732;48,8200692041523;-25,0595155709342;297;255000
vpja15;10;3808;3983;-527,179930795848;144,540484429066;175;0
vpja15;10;4007;4187;-562,879930795848;96,2404844290658;180;0
vpja15;10;4332;4404;-354,479930795848;-0,0595155709341952;72;0
vpja15;10;4446;4629;-534,479930795848;60,5404844290657;183;0
vpja15;10;4652;4948;-560,379930795848;77,2404844290658;296;0
vpja15;10;5035;5205;-60,4799307958477;-239,259515570934;170;0
vpja15;10;5266;5359;221,220069204152;-166,159515570934;93;0
vpja15;10;5399;5620;369,020069204152;-121,459515570934;221;0
vpja15;10;5644;5779;311,120069204152;-127,059515570934;135;0
vpja15;10;5828;6120;-22,4799307958477;-135,859515570934;292;0
vpja15;10;6128;6249;-27,2799307958477;-140,559515570934;121;0
vpja15;10;6444;6677;106,320069204152;495,040484429066;233;NA
vpja15;10;6727;6929;368,820069204152;321,940484429066;202;0
vpja15;10;7063;7214;53,2200692041523;-38,4595155709343;151;255000
vpja15;10;7234;7800;36,0200692041523;-22,5595155709342;566;255000
vpja15;10;7930;8112;-1065,77993079585;575,640484429066;182;NA
vpja15;10;8176;8331;-1383,17993079585;313,840484429066;155;NA
vpja15;10;8378;8512;-1426,27993079585;15,2404844290658;134;NA
vpja15;10;8662;8956;17,2200692041523;-40,6595155709342;294;255000
vpja15;10;8975;9515;37,5200692041523;-49,2595155709342;540;255000
vpja15;10;9545;9759;-13,6799307958477;-116,159515570934;214;0
vpja15;10;9801;10000;28,4200692041522;-37,8595155709343;199;255000
vpja15;11;275;436;-113,955789473684;-88,8957894736841;161;2,55e+08
vpja15;11;453;864;-131,955789473684;-92,9957894736842;411;2,55e+08
vpja15;11;874;1196;-125,155789473684;-106,995789473684;322;2,55e+08
vpja15;11;1243;1654;11,9442105263158;135,904210526316;411;255255000
vpja15;11;1703;2200;-309,955789473684;136,404210526316;497;255
vpja15;11;2223;2458;-268,655789473684;118,004210526316;235;0
vpja15;11;2818;2949;-9,45578947368415;149,604210526316;131;255255000
vpja15;11;3030;3211;118,344210526316;-321,295789473684;181;0
vpja15;11;3236;3470;96,4442105263158;-252,395789473684;234;0
vpja15;11;3650;3998;73,0442105263159;-342,095789473684;348;0
vpja15;11;4032;4165;7,14421052631587;-385,595789473684;133;0
vpja15;11;4241;4565;-410,855789473684;-72,7957894736842;324;0
vpja15;11;4608;4784;-439,955789473684;-5,79578947368418;176;0
vpja15;11;4800;5202;-449,655789473684;-22,5957894736841;402;0
vpja15;11;5254;5718;-483,055789473684;200,704210526316;464;0
vpja15;11;5754;5968;-434,755789473684;-17,3957894736842;214;0
vpja15;11;5989;6293;-411,255789473684;-46,4957894736841;304;0
vpja15;11;6316;6668;-450,955789473684;-104,595789473684;352;0
vpja15;11;6689;6905;-411,555789473684;-104,295789473684;216;0
vpja15;11;6927;7138;-402,455789473684;-140,195789473684;211;0
vpja15;11;7163;7348;-432,955789473684;-125,395789473684;185;0
vpja15;11;7450;7662;466,444210526316;47,5042105263159;212;0
vpja15;11;7836;8008;-26,1557894736841;218,404210526316;172;0
vpja15;11;8175;8236;-157,755789473684;405,204210526316;61;0
vpja15;11;8282;8353;-229,855789473684;413,804210526316;71;0
vpja15;11;8379;8406;-233,655789473684;417,004210526316;27;0
vpja15;11;8442;8803;-93,4557894736841;365,704210526316;361;0
vpja15;11;8824;8948;-60,7557894736841;365,704210526316;124;0
vpja15;11;8977;9234;-152,455789473684;328,904210526316;257;0
vpja15;11;9244;9510;-136,055789473684;330,704210526316;266;0
vpja15;12;32;247;-8,45499999999993;-16,3092857142856;215;2,55e+08
vpja15;12;287;420;33,2450000000001;-144,609285714286;133;2,55e+08
vpja15;12;441;530;56,845;-157,309285714286;89;255000
vpja15;12;593;902;307,445;276,690714285714;309;255
vpja15;12;922;1155;282,445;298,190714285714;233;0
vpja15;12;1228;1534;-349,355;224,890714285714;306;255255000
vpja15;12;1546;1752;-330,155;220,790714285714;206;255255000
vpja15;12;1784;2037;-433,555;253,390714285714;253;255255000
vpja15;12;2089;2271;-428,055;-36,5092857142856;182;0
vpja15;12;2286;2656;-445,655;-32,4092857142856;370;0
vpja15;12;2674;2987;-419,255;-26,5092857142856;313;0
vpja15;12;3012;3264;-374,355;11,0907142857144;252;0
vpja15;12;3275;3609;-382,455;5,49071428571438;334;0
vpja15;12;3618;3754;-390,855;6,29071428571444;136;0
vpja15;12;3819;3926;-10,4549999999999;-172,709285714286;107;255000
vpja15;12;3952;4354;71,9450000000002;-178,209285714286;402;255000
vpja15;12;4382;4953;-14,4549999999999;-169,309285714286;571;255000
vpja15;12;4997;5224;15,4450000000001;41,1907142857144;227;2,55e+08
vpja15;12;5246;5566;45,2450000000001;67,0907142857144;320;2,55e+08
vpja15;12;5639;6014;-560,155;71,3907142857144;375;0
vpja15;12;6034;6209;-560,655;35,3907142857144;175;0
vpja15;12;6240;6309;-481,955;-58,3092857142856;69;0
vpja15;12;6474;6817;508,945;-24,8092857142856;343;0
vpja15;12;6863;7050;579,445;-206,609285714286;187;0
vpja15;12;7545;7649;-100,155;344,590714285714;104;0
vpja15;12;7687;7828;-14,8549999999999;219,790714285714;141;0
vpja15;12;7865;7993;-174,455;206,390714285714;128;0
vpja15;12;8033;8209;-366,055;242,690714285714;176;255255000
vpja15;12;8230;8495;-402,555;233,790714285714;265;255255000
vpja15;12;8523;8824;-324,355;208,190714285714;301;255255000
vpja15;12;8836;9262;-318,955;192,290714285714;426;255255000
vpja15;12;9290;9530;-348,055;118,890714285714;240;255255000
vpja15;12;9542;10000;-337,555;136,990714285714;458;255255000
vpja15;13;240;456;-235,8;98,0999999999999;216;255255000
vpja15;13;503;929;-233,7;-145,7;426;2,55e+08
vpja15;13;939;2179;-232,6;-155,5;1240;2,55e+08
vpja15;13;2249;2577;233;54,1999999999999;328;255
vpja15;13;2597;2977;231;23,3;380;255
vpja15;13;2995;3345;211,9;42,8;350;255
vpja15;13;3372;3621;271,1;37,0999999999999;249;255
vpja15;13;3641;4147;299,5;42,4;506;255
vpja15;13;4167;4420;266;17;253;255
vpja15;13;4445;4518;246,5;51,3;73;255
vpja15;13;4660;5075;-272,3;178,7;415;255255000
vpja15;13;5099;5860;-282,5;145,2;761;255255000
vpja15;13;5891;6266;-285,8;221;375;0
vpja15;13;6295;6640;-275,4;296,9;345;255255000
vpja15;13;6711;6918;226,6;61,4;207;255
vpja15;13;6974;7175;415,8;-106,1;201;0
vpja15;13;7210;7332;243,8;-133,1;122;0
vpja15;13;7478;7826;-225,8;-117,2;348;2,55e+08
vpja15;13;7856;8077;-157,7;-171,1;221;0
vpja15;13;8099;8264;-133,7;-165,2;165;0
vpja15;13;8285;8589;-97,5;-187,7;304;0
vpja15;13;8633;8838;-292,7;-187,6;205;2,55e+08
vpja15;13;8862;9032;-250,2;-162,2;170;255000
vpja15;13;9086;9327;-549,5;-57,2;241;0
vpja15;13;9367;9686;-723,9;-196,3;319;NA
vpja15;13;9751;9907;-464,8;-362,7;156;0
vpja15;13;9928;10000;-497,5;-386,5;72;0
vpja15;14;313;481;-15,4000000000001;-208,7;168;255000
vpja15;14;503;590;-27,8000000000001;-228,9;87;255000
vpja15;14;666;851;-445,6;254,4;185;255
vpja15;14;874;1144;-477,3;192,4;270;255
vpja15;14;1183;1344;-475,9;289,2;161;255
vpja15;14;1363;2219;-449;306,5;856;255
vpja15;14;2241;2538;-470,1;312,5;297;255
vpja15;14;2561;2727;-430,5;284,5;166;255
vpja15;14;2751;2944;-396,8;234,7;193;255
vpja15;14;2959;3172;-383,9;218,6;213;255
vpja15;14;3362;3684;283,5;240,7;322;255255000
vpja15;14;3710;4078;301,9;200,7;368;255255000
vpja15;14;4162;4298;-398,1;256,6;136;255
vpja15;14;4326;4654;-482,4;284,9;328;255
vpja15;14;4741;4958;234,8;241,9;217;0
vpja15;14;4986;5196;297,2;191;210;255255000
vpja15;14;5259;5456;27,0999999999999;-53,1;197;2,55e+08
vpja15;14;5496;5630;-65,5;67;134;2,55e+08
vpja15;14;5708;5932;136,7;-369,2;224;0
vpja15;14;5969;6104;159,4;-312,3;135;0
vpja15;14;6193;6313;-285,9;198,2;120;0
vpja15;14;6350;6596;-426,9;242,9;246;255
vpja15;14;6615;7046;-400,7;243,4;431;255
vpja15;14;7082;7462;-468,2;164,6;380;255
vpja15;14;7527;7868;-498,8;-234,4;341;0
vpja15;14;7890;7981;-524,4;-249;91;0
vpja15;14;8153;8465;11,9;-260,9;312;255000
vpja15;14;8485;8571;-9,70000000000005;-242,4;86;255000
vpja15;14;8614;8905;151,5;-359,2;291;0
vpja15;14;8948;9136;13;-246;188;255000
vpja15;14;9158;9462;-27,8000000000001;-249,2;304;255000
vpja15;14;9508;9912;202,6;-262,2;404;0
vpja15;14;9957;10000;94,2;-375,5;43;0
vpja15;15;299;521;-108,147441860465;256,5;222;255
vpja15;15;542;698;-113,747441860465;228,7;156;255
vpja15;15;766;1105;-1,04744186046514;-182,6;339;255000
vpja15;15;1127;1275;-2,24744186046519;-153,8;148;255000
vpja15;15;1346;1580;-107,247441860465;260,5;234;255
vpja15;15;1608;1831;-104,547441860465;206,9;223;255
vpja15;15;1887;2414;-4,84744186046521;-156,8;527;255000
vpja15;15;2446;2606;23,4525581395349;-189,4;160;255000
vpja15;15;2657;2830;-56,2474418604652;192,5;173;2,55e+08
vpja15;15;2863;3032;-117,247441860465;233,3;169;255
vpja15;15;3095;3316;-583,747441860465;187,4;221;0
vpja15;15;3339;3613;-592,947441860465;160,9;274;0
vpja15;15;3763;3952;-105,547441860465;252,8;189;255
vpja15;15;3972;4218;-116,847441860465;219,5;246;255
vpja15;15;4247;4503;-67,0474418604651;164,3;256;2,55e+08
vpja15;15;4648;4876;-458,747441860465;88;228;0
vpja15;15;4902;5170;-402,747441860465;99,8000000000001;268;0
vpja15;15;5239;5338;11,5525581395349;19,5;99;2,55e+08
vpja15;15;5376;5583;-20,6474418604652;130,2;207;2,55e+08
vpja15;15;5607;5701;-49,2474418604652;165,3;94;2,55e+08
vpja15;15;5766;6177;10,2525581395348;-208,2;411;255000
vpja15;15;6198;6465;3,85255813953484;-156,6;267;255000
vpja15;15;6509;6772;69,7525581395349;-316,1;263;255000
vpja15;15;6796;7012;95,8525581395348;-365;216;0
vpja15;15;7052;7397;286,352558139535;-303,9;345;0
vpja15;15;7455;7622;47,0525581395349;-159,4;167;255000
vpja15;15;7672;7893;123,852558139535;116,3;221;2,55e+08
vpja15;15;7943;8093;298,952558139535;333,1;150;0
vpja15;15;8127;8261;443,452558139535;363,9;134;0
vpja15;15;8306;8523;433,552558139535;66,8000000000001;217;0
vpja15;15;8558;8712;449,752558139535;211,5;154;0
vpja15;15;8754;9098;402,252558139535;375,9;344;0
vpja15;15;9137;9389;191,252558139535;309,2;252;0
vpja15;15;9439;9528;-11,6474418604652;219;89;0
vpja15;15;9672;9890;-64,2474418604652;105,5;218;2,55e+08
vpja15;15;9910;10000;-33,3474418604652;120,1;90;2,55e+08
vpja15;16;256;363;-147,534812286689;-292,645392491468;107;255000
vpja15;16;420;527;-176,434812286689;-326,545392491468;107;0
vpja15;16;535;697;-165,034812286689;-265,845392491468;162;255000
vpja15;16;740;950;-64,1348122866893;23,6546075085324;210;255
vpja15;16;970;1149;-77,3348122866894;22,7546075085324;179;255
vpja15;16;1209;1432;-478,134812286689;-4,24539249146756;223;255255000
vpja15;16;1461;1708;-538,634812286689;110,754607508532;247;255255000
vpja15;16;1774;2005;-78,0348122866894;17,4546075085324;231;2,55e+08
vpja15;16;2018;2120;-72,9348122866894;11,0546075085324;102;2,55e+08
vpja15;16;2193;2492;519,165187713311;-191,045392491468;299;0
vpja15;16;2536;2848;244,365187713311;-126,045392491468;312;0
vpja15;16;2900;3143;433,465187713311;-58,1453924914675;243;0
vpja15;16;3186;3388;586,565187713311;-169,045392491468;202;0
vpja15;16;3553;3582;-97,9348122866894;275,254607508532;29;0
vpja15;16;3625;3841;-115,834812286689;265,754607508532;216;2,55e+08
vpja15;16;3916;4047;-177,434812286689;-280,545392491468;131;255000
vpja15;16;4076;4580;-168,034812286689;-295,445392491468;504;255000
vpja15;16;4643;4918;-142,134812286689;-25,3453924914676;275;2,55e+08
vpja15;16;4966;5153;-122,534812286689;214,854607508532;187;2,55e+08
vpja15;16;5174;5487;-96,0348122866894;209,154607508532;313;0
vpja15;16;5539;5949;-60,7348122866894;5,25460750853244;410;255
vpja15;16;6000;6375;251,065187713311;-155,045392491468;375;0
vpja15;16;6427;6583;469,065187713311;-84,3453924914676;156;0
vpja15;16;6758;6930;16,1651877133106;188,454607508532;172;0
vpja15;16;6964;7252;-77,6348122866893;33,1546075085324;288;255
vpja15;16;7449;7827;-483,534812286689;8,25460750853244;378;255255000
vpja15;16;7855;8041;-537,534812286689;-36,2453924914676;186;255255000
vpja15;16;8066;8266;-492,234812286689;-70,8453924914676;200;255255000
vpja15;16;9099;9121;-33,2348122866894;30,3546075085325;22;255
vpja15;16;9304;9616;-77,6348122866893;-33,0453924914676;312;0
vpja15;16;9828;9952;-138,234812286689;-202,345392491468;124;2,55e+08
vpja15;17;148;238;-24;-72,5;90;0
vpja15;17;287;487;-205,9;-237,6;200;255000
vpja15;17;809;880;-154,9;342,4;71;0
vpja15;17;947;1569;-487,8;321,9;622;255255000
vpja15;17;1962;2230;-467,9;315,3;268;255255000
vpja15;17;2319;2441;-128,4;-253,9;122;0
vpja15;17;2466;2490;-166,1;-242,1;24;255000
vpja15;17;2543;2693;169,1;-226,7;150;0
vpja15;17;2740;2911;295,6;-412;171;0
vpja15;17;2935;3138;314,3;-367,8;203;0
vpja15;17;3162;3625;277,1;-333,5;463;0
vpja15;17;3680;3905;-11,9;-261,6;225;0
vpja15;17;3931;4054;-71,9;-230,6;123;0
vpja15;17;4102;4436;170,8;-156,4;334;0
vpja15;17;4463;4846;150,4;-254;383;0
vpja15;17;4859;5367;149,6;-235;508;0
vpja15;17;5528;5719;286,5;-377;191;0
vpja15;17;5738;6092;314,9;-403,1;354;0
vpja15;17;6119;6369;290;-339;250;0
vpja15;17;6561;7208;94,3000000000001;-323,3;647;0
vpja15;17;7227;7281;67,4999999999999;-326,2;54;0
vpja15;17;7329;7629;338,5;-395,1;300;0
vpja15;17;7641;7755;318,3;-391,7;114;0
vpja15;17;7782;8033;295,6;-325,7;251;0
vpja15;17;8054;8358;277,9;-344,2;304;0
vpja15;17;8397;8432;71,1999999999999;-351,5;35;0
vpja15;17;8544;9063;58,9999999999999;-331,1;519;0
vpja15;17;9093;9418;222,5;-146,3;325;0
vpja15;17;9450;9757;326,7;-88,9;307;0
vpja15;17;9766;10000;314,1;-91;234;0
vpja15;18;211;646;75,8;207,3;435;255255000
vpja15;18;719;919;-496,7;351,9;200;255
vpja15;18;941;1668;-525,1;304,4;727;255
vpja15;18;1762;1919;-373,6;-280,4;157;255000
vpja15;18;1942;2289;-408;-292,2;347;255000
vpja15;18;2301;2580;-402,6;-261,4;279;255000
vpja15;18;2650;2843;74,7;227,8;193;255255000
vpja15;18;2862;3294;95,7;204,7;432;255255000
vpja15;18;3496;3766;22,7;223,1;270;0
vpja15;18;3793;3906;99,1000000000001;177,3;113;255255000
vpja15;18;3983;4151;395;-194,6;168;0
vpja15;18;4176;4370;412,9;-144,5;194;0
vpja15;18;4417;4888;243,9;17,4;471;0
vpja15;18;4973;5132;-482,7;-234;159;255000
vpja15;18;5165;5483;-585;-280,9;318;0
vpja15;18;5511;6010;-574,8;-328,8;499;0
vpja15;18;6047;6368;-607,3;-258,4;321;0
vpja15;18;6396;6913;-568,6;-330,7;517;0
vpja15;18;7172;7329;123,7;261,6;157;255255000
vpja15;18;7354;7559;80,1000000000001;210,8;205;255255000
vpja15;18;7628;7852;386,3;-151,1;224;0
vpja15;18;7870;8401;418,5;-140,6;531;0
vpja15;18;8598;8892;55,3000000000001;202,7;294;255255000
vpja15;18;8915;9041;36,3000000000001;231,7;126;0
vpja15;18;9066;9507;87,2;201,9;441;255255000
vpja15;18;9534;9812;21;220;278;0
vpja15;18;9840;10000;55,1;280,2;160;0
vpja15;19;264;373;-115,8;-133,2;109;2,55e+08
vpja15;19;399;643;-127,1;-190,8;244;255000
vpja15;19;651;846;-127;-204,6;195;255000
vpja15;19;924;1438;406,6;281,3;514;255
vpja15;19;1471;1557;461,9;396,5;86;0
vpja15;19;1656;2007;-429,2;205,6;351;0
vpja15;19;2036;2299;-464,3;69,9;263;0
vpja15;19;2328;2482;-408,8;107,2;154;0
vpja15;19;2535;2808;-329,2;260,9;273;0
vpja15;19;2834;2994;-267,4;256,8;160;0
vpja15;19;3035;3126;-403,7;97,1;91;0
vpja15;19;3226;3416;-412,4;94,9;190;0
vpja15;19;3472;3713;-134,7;-189,8;241;255000
vpja15;19;3770;4025;-29,7;263,8;255;2,55e+08
vpja15;19;4043;4199;-37,1;244,6;156;2,55e+08
vpja15;19;4227;4496;7,79999999999995;340,1;269;0
vpja15;19;4528;4755;78,9999999999999;379,2;227;0
vpja15;19;4782;4938;170,5;377,8;156;0
vpja15;19;5027;5100;78,4;-331,1;73;0
vpja15;19;5109;5307;78,4999999999999;-396,1;198;0
vpja15;19;5332;5580;39,6;-447,4;248;0
vpja15;19;5605;5937;0;-504,3;332;NA
vpja15;19;5959;6149;41,3;-524,4;190;NA
vpja15;19;6166;6702;37,1;-535,2;536;NA
vpja15;19;6726;6966;76,9;-545,3;240;NA
vpja15;19;6976;7752;63,6999999999999;-533,9;776;NA
vpja15;19;7760;8209;65,3000000000001;-536,7;449;NA
vpja15;19;8229;8766;38,4;-529;537;NA
vpja15;19;8776;9107;32,6;-533,8;331;NA
vpja15;19;9120;9372;48,9;-531,2;252;NA
vpja15;19;9382;9827;58,1;-527,1;445;NA
vpja15;20;285;324;-21,8000000000001;-236,2;39;2,55e+08
vpja15;20;357;585;27,5;-432,6;228;0
vpja15;20;606;653;25,9;-400;47;0
vpja15;20;706;852;-15,6;-197,2;146;2,55e+08
vpja15;20;882;1020;-19,7;-82,5;138;2,55e+08
vpja15;20;1083;1317;-408,4;-283,9;234;0
vpja15;20;1345;1483;-442,5;-373,5;138;0
vpja15;20;1552;1677;4;-362,8;125;255000
vpja15;20;1703;1978;30,4;-433,4;275;0
vpja15;20;2062;2204;286,9;289,2;142;255
vpja15;20;2228;2398;326,9;312,6;170;255
vpja15;20;2418;2825;348;292;407;255
vpja15;20;2903;3148;233,8;-234,7;245;0
vpja15;20;3175;3387;175,8;-261,9;212;0
vpja15;20;3417;3697;137,8;-333,8;280;0
vpja15;20;3738;3987;161,1;-185;249;0
vpja15;20;4011;4177;104,9;-210,7;166;0
vpja15;20;4225;4420;213,5;-350,4;195;0
vpja15;20;4473;4718;445,7;-104,5;245;0
vpja15;20;4751;4926;556,7;-134,2;175;0
vpja15;20;5012;5223;-19,7;102,5;211;0
vpja15;20;5295;5518;-349,9;-294;223;0
vpja15;20;5548;5778;-446,7;-315,8;230;0
vpja15;20;5829;6008;-290,3;-404;179;0
vpja15;20;6047;6521;-426,1;-383,1;474;0
vpja15;20;6545;6822;-419,8;-465,5;277;0
vpja15;20;6841;7145;-423,7;-485,2;304;NA
vpja15;20;7192;7434;-434,2;-379,2;242;0
vpja15;20;7606;7961;-112,5;-156,2;355;2,55e+08
vpja15;20;7985;8771;-149,6;-149;786;0
vpja15;20;8823;9132;158,4;-162,5;309;0
vpja15;20;9161;9395;219,4;-245,5;234;0
vpja15;20;9449;9739;546,6;-96,8000000000001;290;0
vpja15;20;9911;10000;-230,5;238,3;89;0
vpja15;21;295;473;-33,2842931937173;-226,360732984293;178;255000
vpja15;21;492;636;-52,9842931937172;-241,860732984293;144;255000
vpja15;21;703;856;-278,684293193717;230,639267015707;153;255
vpja15;21;899;1041;-481,784293193717;248,539267015707;142;255
vpja15;21;1133;1573;342,415706806283;244,539267015707;440;255255000
vpja15;21;1631;1788;422,415706806283;7,63926701570688;157;0
vpja15;21;1867;2045;-273,784293193717;6,7392670157069;178;0
vpja15;21;2100;2231;-61,9842931937172;-326,660732984293;131;255000
vpja15;21;2253;2459;-21,3842931937172;-334,260732984293;206;255000
vpja15;21;2513;2683;321,715706806283;-58,2607329842931;170;0
vpja15;21;2703;3037;292,715706806283;-78,3607329842931;334;0
vpja15;21;3115;3280;-106,684293193717;-203,360732984293;165;0
vpja15;21;3487;3708;42,3157068062827;135,839267015707;221;0
vpja15;21;3754;3984;327,615706806283;256,239267015707;230;255255000
vpja15;21;4067;4231;-201,484293193717;237,539267015707;164;255
vpja15;21;4273;4455;-372,084293193717;188,339267015707;182;255
vpja15;21;4475;4981;-383,684293193717;156,439267015707;506;255
vpja15;21;5043;5229;40,8157068062827;273,639267015707;186;0
vpja15;21;5275;5406;9,81570680628272;100,639267015707;131;0
vpja15;21;5430;5625;-23,7842931937173;70,9392670157068;195;2,55e+08
vpja15;21;5639;5914;-36,3842931937172;54,0392670157069;275;2,55e+08
vpja15;21;5938;6245;-30,8842931937172;14,1392670157069;307;2,55e+08
vpja15;21;6255;7023;-25,7842931937173;33,5392670157069;768;2,55e+08
vpja15;21;7050;7272;-13,2842931937173;-61,1607329842931;222;2,55e+08
vpja15;21;7291;10000;-4,48429319371724;-85,0607329842932;2709;2,55e+08
vpja15;22;305;365;61,5;-197,7;60;2,55e+08
vpja15;22;396;653;68,8;-317,6;257;255000
vpja15;22;671;966;72,5999999999999;-347,3;295;255000
vpja15;22;1027;1224;403,6;52,1;197;255255000
vpja15;22;1245;1569;416,8;89,7;324;255255000
vpja15;22;1631;1781;-78,2;50,4000000000001;150;0
vpja15;22;1805;2163;-123;60;358;255
vpja15;22;2206;2367;30,7;-74,9;161;2,55e+08
vpja15;22;2408;2635;72;-241,1;227;2,55e+08
vpja15;22;2659;2734;83,7;-193;75;2,55e+08
vpja15;22;2905;3143;26,6;27;238;0
vpja15;22;3192;3357;64,3;163,4;165;0
vpja15;22;3404;3564;39,2;330,9;160;0
vpja15;22;3587;3738;-14,7;283,3;151;0
vpja15;22;3808;3966;-498,3;208;158;0
vpja15;22;4004;4212;-587,8;130,9;208;0
vpja15;22;4242;4420;-574,2;31,1;178;0
vpja15;22;4452;4920;-496,3;128,9;468;0
vpja15;22;5011;5174;52;-399,4;163;0
vpja15;22;5196;5466;73,3;-365,2;270;255000
vpja15;22;5476;5966;69,3;-360,9;490;255000
vpja15;22;5994;6256;85;-299;262;255000
vpja15;22;6276;6513;76,4000000000001;-335,5;237;255000
vpja15;22;6544;6690;98,3;-233,9;146;2,55e+08
vpja15;22;6717;7792;86,5999999999999;-288,8;1075;255000
vpja15;22;7875;8231;83,3;-285,3;356;255000
vpja15;22;8238;8561;91,4000000000001;-278,6;323;255000
vpja15;22;8594;9002;101,4;-212,2;408;2,55e+08
vpja15;22;9018;9336;84,9000000000001;-237,4;318;2,55e+08
vpja15;22;9358;9628;86,3;-267,3;270;255000
vpja15;22;9645;9833;83,9000000000001;-291,4;188;255000
vpja15;22;9860;10000;75,8;-351,9;140;255000
vpja15;23;33;55;-3,60833333333323;17,3499999999999;22;2,55e+08
vpja15;23;222;317;21,5916666666667;3,94999999999993;95;2,55e+08
vpja15;23;370;806;14,6916666666667;-352,35;436;255000
vpja15;23;825;1181;-9,4083333333333;-364,25;356;255000
vpja15;23;1266;1503;144,591666666667;383,65;237;255255000
vpja15;23;1531;1738;163,591666666667;317,05;207;255255000
vpja15;23;1823;2121;-534,308333333333;226,55;298;255
vpja15;23;2134;2569;-522,108333333333;200,35;435;255
vpja15;23;2588;2868;-555,608333333333;208,65;280;255
vpja15;23;2887;3262;-524,508333333333;206,85;375;255
vpja15;23;3284;3460;-483,308333333333;247,45;176;255
vpja15;23;3470;4161;-471,108333333333;246,15;691;255
vpja15;23;4205;4381;-500,508333333333;146,55;176;255
vpja15;23;4427;4695;-237,308333333333;172,15;268;0
vpja15;23;4865;5079;386,091666666667;214,45;214;0
vpja15;23;5155;5329;54,3916666666668;-220,65;174;255000
vpja15;23;5363;5606;32,8916666666668;-26,85;243;2,55e+08
vpja15;23;5634;5937;27,0916666666667;52,15;303;2,55e+08
vpja15;23;5948;8165;27,2916666666667;30,4499999999999;2217;2,55e+08
vpja15;23;8172;8219;29,4916666666667;39,75;47;2,55e+08
vpja15;23;8250;8323;37,1916666666667;137,45;73;2,55e+08
vpja15;23;8347;8547;38,6916666666667;64,3499999999999;200;2,55e+08
vpja15;23;8609;9070;15,2916666666667;-354,95;461;255000
vpja15;23;9100;9374;-16,1083333333332;-416,05;274;255000
vpja15;23;9392;9696;-27,8083333333333;-396,45;304;255000
vpja15;23;9769;9961;-27,0083333333333;165,85;192;2,55e+08
vpja15;24;272;440;-61,8000000000001;-197,8;168;255000
vpja15;24;458;695;-79,1;-199,6;237;255000
vpja15;24;704;1131;-88,5;-205,9;427;255000
vpja15;24;1317;1480;51,1999999999999;128,9;163;0
vpja15;24;1502;1756;41,1999999999999;101,7;254;0
vpja15;24;1805;2040;-273,7;122,4;235;255
vpja15;24;2064;2333;-325,6;116,6;269;0
vpja15;24;2362;2748;-371,5;108,4;386;255
vpja15;24;2770;2936;-313,1;117,8;166;0
vpja15;24;3001;3479;-89,9000000000001;-221,6;478;255000
vpja15;24;3493;3810;-85,8000000000001;-202,2;317;255000
vpja15;24;3899;3940;-344,4;32,8000000000001;41;0
vpja15;24;3954;4482;-319,8;111,7;528;0
vpja15;24;4493;4738;-303,5;120,5;245;0
vpja15;24;4812;4912;201,7;67,4;100;0
vpja15;24;4950;5103;92,5;71,5;153;255255000
vpja15;24;5125;5451;35,3;99,5;326;0
vpja15;24;5503;5857;329,2;-56,5;354;0
vpja15;24;5871;6142;324,4;-69,1;271;0
vpja15;24;6161;6481;324,3;-96,5;320;0
vpja15;24;6505;6693;323;-61,4;188;0
vpja15;24;6881;7109;570,6;-133,8;228;0
vpja15;24;7142;7355;625,2;-230,7;213;0
vpja15;24;7382;7627;650,3;-349,3;245;NA
vpja15;24;7684;7918;582,6;4,80000000000007;234;0
vpja15;24;7956;8043;395,7;65,8000000000001;87;0
vpja15;24;8081;8261;295;-29,1999999999999;180;0
vpja15;24;8286;8770;314,6;-72,5;484;0
vpja15;24;8853;8971;120,5;426;118;0
vpja15;24;8980;9068;108,1;405;88;0
vpja15;24;9328;9646;-68,1;227,2;318;0
vpja15;24;9723;9893;48,8;33;170;0
vpja15;24;9952;10000;-68,6;-268,5;48;255000
vpja15;25;313;570;-20,1;-403,4;257;255000
vpja15;25;656;959;-556,7;410,5;303;0
vpja15;25;981;1300;-520,2;443,1;319;255
vpja15;25;1399;1520;336,9;398,5;121;0
vpja15;25;1554;1793;542,1;431,4;239;255255000
vpja15;25;1821;2093;518;379,7;272;255255000
vpja15;25;2108;2287;545;392,1;179;255255000
vpja15;25;2388;2523;-19,1;-383,2;135;255000
vpja15;25;2553;3303;-49,8000000000001;-442,1;750;255000
vpja15;25;3314;3515;-43;-426,2;201;255000
vpja15;25;3615;3809;-470;288,9;194;255
vpja15;25;3859;4209;-528,9;431,8;350;255
vpja15;25;4266;4334;-372,1;193,8;68;0
vpja15;25;4383;4600;-101,4;125,5;217;0
vpja15;25;4640;4748;34,8;85;108;2,55e+08
vpja15;25;4803;4966;282;292,6;163;255255000
vpja15;25;5010;5234;543,7;399,2;224;255255000
vpja15;25;5247;5403;524;387;156;255255000
vpja15;25;5546;5958;-18,4;-398,4;412;255000
vpja15;25;5984;6063;-54,2;-440,5;79;255000
vpja15;25;6112;6312;232,2;-261,2;200;0
vpja15;25;6343;6486;335,8;-253,5;143;0
vpja15;25;6539;6652;251,2;-85,1;113;0
vpja15;25;6721;6920;-344,4;-37,8;199;0
vpja15;25;6958;7055;-444,7;-98,5;97;0
vpja15;25;7089;7254;-553,4;-90,5;165;0
vpja15;25;7285;7499;-415,4;-92,2;214;0
vpja15;25;7509;7658;-419,1;-100,6;149;0
vpja15;25;7713;8001;-421,9;-386,2;288;0
vpja15;25;8034;8270;-529,4;-403;236;0
vpja15;25;8308;8418;-400,6;-316,5;110;0
vpja15;25;8488;8698;209,2;-262,4;210;0
vpja15;25;8727;8845;112;-354;118;0
vpja15;25;8892;9151;-154,7;-360,9;259;0
vpja15;25;9305;9472;-464,4;-408,4;167;0
vpja15;25;9567;9796;509;-57,2;229;0
vpja15;25;9832;10000;556,6;101,8;168;0
vpja15;26;311;497;-67,4;-163,3;186;2,55e+08
vpja15;26;519;692;-91;-219,8;173;0
vpja15;26;756;996;343,6;76,1999999999999;240;0
vpja15;26;1058;1166;88,5999999999999;-333,2;108;0
vpja15;26;1190;1432;42,6;-385,3;242;0
vpja15;26;1498;1625;-58,8;70,9;127;255
vpja15;26;1654;1845;-165,2;16,5999999999999;191;2,55e+08
vpja15;26;1870;1904;-204,6;-21,9000000000001;34;0
vpja15;26;2050;2184;-226,2;199,4;134;0
vpja15;26;2231;2385;1,10000000000002;345,1;154;2,55e+08
vpja15;26;2414;2775;27,8;435,7;361;2,55e+08
vpja15;26;2802;2942;38,2;360,6;140;2,55e+08
vpja15;26;3029;3059;293,7;-74,2;30;0
vpja15;26;3102;3321;439,2;-83,8000000000001;219;0
vpja15;26;3344;3548;405,5;-36;204;0
vpja15;26;3573;3731;348,6;-36,6;158;0
vpja15;26;3754;3955;305,6;-37,3000000000001;201;0
vpja15;26;3983;4215;314,8;38,5999999999999;232;0
vpja15;26;4280;4541;12,8;-350,6;261;255000
vpja15;26;4556;4873;18,5;-368,4;317;255000
vpja15;26;4908;5189;-99,4;-237,4;281;0
vpja15;26;5255;5388;-382,2;23,3;133;0
vpja15;26;5430;5620;-550;154,1;190;0
vpja15;26;5656;5852;-591,3;35,3;196;0
vpja15;26;6015;6130;-228,2;-27,3000000000001;115;255255000
vpja15;26;6185;6348;-211,9;-261;163;0
vpja15;26;6378;6562;-104,3;-252,1;184;0
vpja15;26;6604;6864;-206,2;-234,3;260;0
vpja15;26;6896;7172;-111,1;-252,3;276;0
vpja15;26;7211;7504;-109,4;-190,3;293;0
vpja15;26;7525;7729;-137,5;-228,8;204;0
vpja15;26;7757;7927;-174,8;-336,6;170;0
vpja15;26;7965;8264;-314,2;-387,7;299;0
vpja15;26;8311;8482;-316,5;-228,5;171;0
vpja15;26;8503;8921;-337;-207;418;0
vpja15;26;8965;9156;-183,7;-76,2;191;0
vpja15;26;9333;9553;422;-200,6;220;0
vpja15;26;9575;9686;459,8;-202,1;111;0
vpja15;26;9727;10000;411,6;-9,90000000000009;273;0
