vp;trial;timest;timeend;x;y;duration;roi
vpja19;1;276;331;-1,29999999999995;-207,7;55;2,55e+08
vpja19;1;352;720;-4,09999999999991;-245,8;368;255000
vpja19;1;728;967;-10,1999999999999;-249,5;239;255000
vpja19;1;975;1238;5,10000000000002;-248,1;263;255000
vpja19;1;1304;1394;-332,7;81,4;90;0
vpja19;1;1414;1608;-336,7;109,9;194;255
vpja19;1;1622;1774;-297,7;117,4;152;0
vpja19;1;1844;2026;298,7;118,7;182;255255000
vpja19;1;2077;2250;485,2;3,39999999999998;173;0
vpja19;1;2291;2479;615,4;-189,2;188;0
vpja19;1;2519;2907;592,9;-321;388;0
vpja19;1;3082;3191;-42,0999999999999;-256;109;0
vpja19;1;3209;4280;5;-254,6;1071;255000
vpja19;1;4290;4686;-15,3;-257,4;396;255000
vpja19;1;4702;4866;-8,09999999999991;-238,4;164;255000
vpja19;1;4907;5086;-101,6;-40,3000000000001;179;0
vpja19;1;5105;5342;-130,7;-15,9000000000001;237;2,55e+08
vpja19;1;5371;5702;-43,0999999999999;-26,4000000000001;331;2,55e+08
vpja19;1;5724;5935;-101,1;-23,7;211;2,55e+08
vpja19;1;5978;6239;96,8;-16,7;261;2,55e+08
vpja19;1;6249;6399;106,3;-5,10000000000002;150;2,55e+08
vpja19;1;6438;6574;-82,8;-5,10000000000002;136;2,55e+08
vpja19;1;6626;6734;-374;163,9;108;0
vpja19;1;6747;6909;-342,3;130,1;162;255
vpja19;1;6920;7300;-340,7;109,8;380;255
vpja19;1;7457;7725;-347,6;104,6;268;255
vpja19;1;7767;7948;-495;114,7;181;0
vpja19;1;7987;8133;-324,2;125,4;146;255
vpja19;1;8203;8401;252,9;102;198;255255000
vpja19;1;8414;8730;264,7;90,5;316;255255000
vpja19;1;8741;8936;242,6;79,9;195;255255000
vpja19;1;8990;9091;152,7;384,8;101;0
vpja19;1;9117;9212;167,7;446,4;95;0
vpja19;1;9269;9353;248,9;124;84;255255000
vpja19;1;9369;9551;245,9;103,8;182;255255000
vpja19;1;9564;9862;256,4;80,3;298;255255000
vpja19;1;9888;9979;276,4;5;91;0
vpja19;2;80;164;-7,29999999999995;0,100000000000023;84;2,55e+08
vpja19;2;215;326;3,60000000000002;-268,3;111;255000
vpja19;2;343;478;-29,1999999999999;-269;135;255000
vpja19;2;492;748;-61,0999999999999;-263;256;255000
vpja19;2;774;969;3,30000000000007;-263,8;195;255000
vpja19;2;1050;1115;-479,2;87,6;65;0
vpja19;2;1154;1277;-512,2;221,5;123;0
vpja19;2;1295;1504;-499,3;250,9;209;255
vpja19;2;1516;1866;-481,2;235,5;350;255
vpja19;2;1931;2148;44,9000000000001;182,5;217;255255000
vpja19;2;2178;2327;46,4000000000001;290;149;255255000
vpja19;2;2358;2490;56,1;172,3;132;255255000
vpja19;2;2690;3084;33,6;134,8;394;255255000
vpja19;2;3122;3388;48,4000000000001;290,7;266;255255000
vpja19;2;3404;3616;85,1000000000001;302,8;212;255255000
vpja19;2;3667;3815;394,5;293,9;148;0
vpja19;2;3842;4081;417,7;222;239;0
vpja19;2;4105;4204;425,3;157,2;99;0
vpja19;2;4289;4443;-28,8;-271,9;154;255000
vpja19;2;4459;4601;-30,1999999999999;-287,1;142;255000
vpja19;2;4619;5175;-67,6999999999999;-264,6;556;255000
vpja19;2;5188;5345;-46,5999999999999;-253,7;157;255000
vpja19;2;5368;5540;16,7;-247,6;172;255000
vpja19;2;5548;6001;0,700000000000045;-258,4;453;255000
vpja19;2;6025;6248;-31,1999999999999;-325,3;223;255000
vpja19;2;6263;6463;-16,5;-357,7;200;255000
vpja19;2;6485;6580;-4,29999999999995;-423,9;95;255000
vpja19;2;6630;6962;-224,5;-237,5;332;0
vpja19;2;6988;7196;-153,4;-257,6;208;0
vpja19;2;7255;7677;-488,9;-244,4;422;0
vpja19;2;7890;8074;-22,5999999999999;-277,7;184;255000
vpja19;2;8082;8204;-53,5999999999999;-273,8;122;255000
vpja19;2;8213;8472;-59,6999999999999;-282,5;259;255000
vpja19;2;8494;9212;-8,79999999999995;-277,5;718;255000
vpja19;2;9233;9278;-13,4;-216,4;45;255000
vpja19;2;9295;9528;-38,6999999999999;-185,6;233;255000
vpja19;2;9568;9802;100,7;-258;234;0
vpja19;2;9839;10000;123;-86,9;161;2,55e+08
vpja19;3;216;308;-261,8;-189,3;92;255000
vpja19;3;331;448;-264,8;-237,2;117;255000
vpja19;3;459;1670;-239,7;-237,7;1211;0
vpja19;3;1746;1834;222,9;133,6;88;255
vpja19;3;1853;2346;210,3;160,4;493;255
vpja19;3;2357;2653;192,4;172,6;296;255
vpja19;3;2708;2787;340,5;-25,5;79;0
vpja19;3;2831;2992;489,9;-249;161;0
vpja19;3;3011;3189;496,6;-284,5;178;0
vpja19;3;3210;3582;503,2;-336,9;372;0
vpja19;3;3605;3825;530,6;-393;220;0
vpja19;3;3842;3996;510,3;-362,3;154;0
vpja19;3;4164;4463;553,4;-393,8;299;0
vpja19;3;4484;4756;555,5;-410,2;272;0
vpja19;3;4764;5069;543,5;-391,3;305;0
vpja19;3;5092;5200;590,2;-438;108;0
vpja19;3;5229;5590;499,8;-318,5;361;0
vpja19;3;5672;5703;-165,2;-255;31;0
vpja19;3;5737;6323;-256,2;-241,8;586;255000
vpja19;3;6372;6524;-25;-311,5;152;0
vpja19;3;6541;6902;9,70000000000005;-316,6;361;0
vpja19;3;6977;7139;-510,4;-211,2;162;0
vpja19;3;7163;7333;-556,6;-177,6;170;0
vpja19;3;7373;7412;-383,7;-121;39;2,55e+08
vpja19;3;7452;7581;-282,2;-223,4;129;255000
vpja19;3;7597;8439;-250,4;-235,9;842;255000
vpja19;3;8461;8569;-275;-189,7;108;255000
vpja19;3;8669;9049;-382,2;336;380;255255000
vpja19;3;9069;9199;-381,7;367,2;130;255255000
vpja19;3;9257;9369;48,6;282,2;112;0
vpja19;3;9409;9637;194,5;184;228;255
vpja19;3;9650;9819;216;187,6;169;255
vpja19;4;130;176;-5,79999999999995;-3,39999999999998;46;0
vpja19;4;222;348;-239,7;-99,1;126;255000
vpja19;4;355;1003;-243,6;-104,5;648;255000
vpja19;4;1014;1234;-229,4;-112,5;220;255000
vpja19;4;1250;1453;-245,3;-83,1999999999999;203;255000
vpja19;4;1489;1572;-167,7;0,700000000000045;83;2,55e+08
vpja19;4;1608;1901;-235,7;-91,6;293;255000
vpja19;4;2066;2262;-115,3;273,9;196;255
vpja19;4;2280;2505;-76,5;281,1;225;255
vpja19;4;2540;2671;9,79999999999995;227,8;131;0
vpja19;4;2702;2994;-74,1;267,9;292;255
vpja19;4;3007;3339;-97,8;297,2;332;255
vpja19;4;3352;3543;-69,1;278,8;191;255
vpja19;4;3597;3710;227,8;100,1;113;0
vpja19;4;3727;3823;243,8;74,1;96;255255000
vpja19;4;3994;4167;262;55,7;173;255255000
vpja19;4;4216;4412;568,9;-87;196;0
vpja19;4;4436;4894;624,7;-143,3;458;0
vpja19;4;4944;5057;299;-76,8;113;0
vpja19;4;5081;5196;237,9;-75,1999999999999;115;0
vpja19;4;5251;5374;174,5;-362,7;123;0
vpja19;4;5397;5574;174,3;-414,7;177;0
vpja19;4;5636;5776;-204,5;-223,7;140;255000
vpja19;4;5810;5916;-277,9;-153,3;106;255000
vpja19;4;5936;6434;-249,7;-115,9;498;255000
vpja19;4;6444;6572;-258,7;-114,2;128;255000
vpja19;4;6626;6889;-572,8;-82,9;263;0
vpja19;4;6938;7161;-248,3;-115;223;255000
vpja19;4;7173;7214;-230,7;-116,4;41;255000
vpja19;4;7360;8273;-252,2;-118,3;913;255000
vpja19;4;8284;8569;-253,8;-113,7;285;255000
vpja19;4;8580;8781;-234,2;-108,4;201;255000
vpja19;4;8800;9095;-251,8;-77,1999999999999;295;255000
vpja19;4;9146;9313;-481,3;-35;167;0
vpja19;4;9358;9484;-227,3;-145;126;255000
vpja19;4;9492;9786;-242,4;-114,8;294;255000
vpja19;4;9794;9944;-232;-101,1;150;255000
vpja19;4;9971;10000;-203,7;-189,4;29;255000
vpja19;5;165;226;47,6;-157,1;61;2,55e+08
vpja19;5;250;359;93,9;-216;109;255000
vpja19;5;375;534;113,7;-238,5;159;255000
vpja19;5;545;775;94,6999999999999;-248,5;230;255000
vpja19;5;795;861;141,1;-237,3;66;255000
vpja19;5;1006;1342;123,1;-243,2;336;255000
vpja19;5;1361;1580;76,4;-248,9;219;255000
vpja19;5;1588;1824;92,6999999999999;-252,3;236;255000
vpja19;5;1845;2002;120,8;-206,7;157;255000
vpja19;5;2061;2241;362,3;140,5;180;255
vpja19;5;2263;2433;308,4;162,2;170;255
vpja19;5;2456;2602;358,1;149,3;146;255
vpja19;5;2623;2925;313,4;156,4;302;255
vpja19;5;2943;3155;280,4;122,2;212;255
vpja19;5;3192;3322;400,1;124,7;130;255
vpja19;5;3335;3613;400,7;105,1;278;255
vpja19;5;3627;3928;369,6;85,1;301;255
vpja19;5;3955;4102;329,7;158,1;147;255
vpja19;5;4111;4154;320,6;171,1;43;255
vpja19;5;4323;4436;376,1;193,9;113;255
vpja19;5;4458;4736;437,4;205,1;278;255
vpja19;5;4759;5029;491,5;218,6;270;255
vpja19;5;5054;5275;528,3;296,8;221;255
vpja19;5;5361;5464;80;-208,2;103;255000
vpja19;5;5485;5650;113,8;-251,2;165;255000
vpja19;5;5666;5927;85,4;-255,1;261;255000
vpja19;5;5943;6261;119;-238,5;318;255000
vpja19;5;6276;6741;87,1999999999999;-241,9;465;255000
vpja19;5;6750;7017;101,9;-240,4;267;255000
vpja19;5;7024;7231;116,6;-230,9;207;255000
vpja19;5;7251;7492;89,8000000000001;-199,9;241;255000
vpja19;5;7531;7792;-1,70000000000005;-116,6;261;2,55e+08
vpja19;5;7825;7902;65,1999999999999;-139,6;77;2,55e+08
vpja19;5;8041;8182;71,8;-13,7;141;2,55e+08
vpja19;5;8207;8739;6,60000000000002;6;532;2,55e+08
vpja19;5;8773;8976;112,2;27,3;203;2,55e+08
vpja19;5;9016;9220;1,19999999999993;122,2;204;2,55e+08
vpja19;5;9259;9299;-178,2;139;40;0
vpja19;5;9348;9548;-437,4;203,1;200;255255000
vpja19;5;9572;9736;-497,1;190,9;164;255255000
vpja19;5;9768;9937;-526,1;68,2;169;0
vpja19;5;9960;10000;-503,2;18,4;40;0
vpja19;6;190;297;-150,9;-216,1;107;0
vpja19;6;315;524;-182,5;-231,2;209;255000
vpja19;6;540;780;-224,6;-227,9;240;255000
vpja19;6;795;1058;-200,4;-228,1;263;255000
vpja19;6;1066;1455;-213,1;-226,3;389;255000
vpja19;6;1630;1683;-152,4;224,8;53;2,55e+08
vpja19;6;1721;1851;-141,3;351,8;130;255
vpja19;6;1869;3099;-121,4;323,6;1230;255
vpja19;6;3113;3427;-99,6;325,8;314;255
vpja19;6;3440;3636;-113;350,8;196;255
vpja19;6;3689;3732;140,4;217,3;43;0
vpja19;6;3761;3802;176,1;105,4;41;0
vpja19;6;3845;4005;225,8;-16,1;160;0
vpja19;6;4194;4500;-475,5;270,2;306;255255000
vpja19;6;4534;4646;-615;236,2;112;0
vpja19;6;4699;4799;-256,4;5,39999999999998;100;2,55e+08
vpja19;6;4846;4944;-169,1;-168,9;98;2,55e+08
vpja19;6;4970;5255;-190,5;-235,6;285;255000
vpja19;6;5283;5421;-109,6;-210,1;138;0
vpja19;6;5449;5737;-195,9;-222,5;288;255000
vpja19;6;5752;6114;-216,7;-230,9;362;255000
vpja19;6;6154;6502;-63,2;-224,3;348;0
vpja19;6;6511;6754;-79;-205;243;0
vpja19;6;6764;7110;-85,3000000000001;-220,1;346;0
vpja19;6;7269;7669;-82,6;-220,9;400;0
vpja19;6;7699;7836;-180,8;-228;137;0
vpja19;6;7852;8646;-211,6;-226,8;794;255000
vpja19;6;8684;8824;-204,2;-67,9;140;2,55e+08
vpja19;6;8852;9155;-244,7;18,6;303;2,55e+08
vpja19;6;9187;9422;-236;115,8;235;2,55e+08
vpja19;6;9482;9584;-86,2;-185,9;102;0
vpja19;6;9600;10000;-88,8000000000001;-212;400;0
vpja19;7;84;187;-1,5;-7,89999999999998;103;2,55e+08
vpja19;7;226;322;-83;-155;96;2,55e+08
vpja19;7;341;1093;-92,3;-190,8;752;255000
vpja19;7;1153;1285;-405,5;-111,9;132;0
vpja19;7;1320;1443;-497,6;-37,9;123;255
vpja19;7;1464;1680;-442,8;-59,6999999999999;216;255
vpja19;7;1741;2447;-88,3;-195,3;706;255000
vpja19;7;2506;2869;-445,5;-98,3;363;255
vpja19;7;2893;3104;-500,3;-77,4;211;255
vpja19;7;3127;3670;-436;-76,5999999999999;543;255
vpja19;7;3705;3848;-353,3;-92,9;143;0
vpja19;7;3865;3923;-328,1;-96,5999999999999;58;0
vpja19;7;3955;4283;-445,1;-51;328;255
vpja19;7;4325;4454;-534,2;103,5;129;255
vpja19;7;4480;4648;-511;184,5;168;0
vpja19;7;4670;4852;-449,8;209,8;182;0
vpja19;7;4981;5189;-454,9;268,7;208;0
vpja19;7;5247;5339;-439,8;-47,5999999999999;92;255
vpja19;7;5361;5596;-429;-84,5999999999999;235;255
vpja19;7;5635;5843;-306,4;-162,7;208;0
vpja19;7;5859;6470;-293,7;-187,1;611;0
vpja19;7;6486;6630;-277,8;-203;144;0
vpja19;7;6678;6826;-343,6;3,10000000000002;148;0
vpja19;7;6847;7145;-333,3;37,1;298;0
vpja19;7;7161;7286;-302,5;28,8000000000001;125;0
vpja19;7;7314;7522;-385,8;75,1;208;0
vpja19;7;7570;7699;-133,2;31,4000000000001;129;2,55e+08
vpja19;7;7845;7972;-63,8;-200;127;255000
vpja19;7;7983;8181;-83,4;-209,8;198;255000
vpja19;7;8209;8307;-13,6;-268,8;98;0
vpja19;7;8333;8866;-88,1;-199,3;533;255000
vpja19;7;8902;9085;7;-288;183;0
vpja19;7;9095;9158;6,89999999999998;-304,3;63;0
vpja19;7;9190;9484;-91,8;-198,7;294;255000
vpja19;7;9534;9723;62,2;-345;189;0
vpja19;7;9750;10000;144,1;-401,2;250;0
vpja19;8;176;224;-0,115915139220419;-187,977764726684;48;2,55e+08
vpja19;8;250;382;-1,81591513922035;-277,177764726684;132;255000
vpja19;8;393;913;-27,1159151392204;-266,177764726684;520;255000
vpja19;8;1046;1161;-18,1159151392204;-276,177764726684;115;255000
vpja19;8;1170;1461;-33,9159151392204;-272,477764726684;291;255000
vpja19;8;1472;1655;-14,8159151392204;-250,277764726684;183;0
vpja19;8;1708;1885;-227,01591513922;-55,1777647266845;177;255
vpja19;8;1896;2296;-201,91591513922;-61,0777647266844;400;255
vpja19;8;2323;2465;-211,31591513922;-125,777764726684;142;0
vpja19;8;2488;3020;-206,91591513922;-75,7777647266845;532;255
vpja19;8;3043;3221;-187,51591513922;-139,677764726684;178;0
vpja19;8;3243;3571;-205,21591513922;-75,0777647266844;328;255
vpja19;8;3777;3919;2,18408486077965;-280,577764726684;142;255000
vpja19;8;3930;4686;-23,5159151392204;-277,477764726684;756;255000
vpja19;8;4694;5788;-22,3159151392204;-272,877764726684;1094;255000
vpja19;8;5831;6194;-182,41591513922;-245,177764726684;363;0
vpja19;8;6210;6643;-205,81591513922;-235,077764726684;433;0
vpja19;8;6658;6889;-179,71591513922;-264,877764726684;231;0
vpja19;8;6939;7183;-71,8159151392204;-26,8777647266845;244;255255000
vpja19;8;7201;7237;-38,8159151392204;-23,6777647266845;36;255255000
vpja19;8;7450;7654;256,08408486078;-20,5777647266844;204;0
vpja19;8;7683;7855;363,28408486078;-31,9777647266844;172;0
vpja19;8;7888;8119;496,28408486078;-89,1777647266845;231;0
vpja19;8;8167;8284;420,48408486078;-247,277764726684;117;0
vpja19;8;8314;8439;288,18408486078;-178,277764726684;125;0
vpja19;8;8472;8893;357,18408486078;-367,377764726684;421;0
vpja19;8;8926;9041;441,18408486078;-279,277764726684;115;0
vpja19;8;9065;9240;402,58408486078;-343,077764726684;175;0
vpja19;8;9267;9706;348,58408486078;-383,977764726684;439;0
vpja19;8;9761;9845;439,78408486078;-116,277764726684;84;0
vpja19;8;9874;10000;562,68408486078;-134,477764726684;126;0
vpja19;9;165;277;-29,7;-101,5;112;0
vpja19;9;294;962;-64,9;-84,5;668;255000
vpja19;9;994;1089;7,20000000000005;-36,4;95;0
vpja19;9;1116;1373;-73;-83,6999999999999;257;255000
vpja19;9;1432;1621;215,2;155,6;189;0
vpja19;9;1636;2130;203,1;115,5;494;255
vpja19;9;2271;2482;206,2;123,7;211;255
vpja19;9;2500;2665;257,5;140,4;165;0
vpja19;9;2678;2901;270,9;150,9;223;0
vpja19;9;2925;3087;206,2;130,9;162;255
vpja19;9;3121;3209;114,2;73,6;88;0
vpja19;9;3255;3360;-53,9;-74,1999999999999;105;255000
vpja19;9;3370;4264;-66,9;-88,8;894;255000
vpja19;9;4311;4513;-11,9;119,9;202;2,55e+08
vpja19;9;4670;4699;-61,7;149,8;29;0
vpja19;9;4738;4862;-42,2;332,5;124;0
vpja19;9;4875;5081;-78,1;324,7;206;2,55e+08
vpja19;9;5133;5381;-360;147;248;255255000
vpja19;9;5402;5498;-390,3;121,6;96;255255000
vpja19;9;5539;5673;-393,4;-50,0999999999999;134;0
vpja19;9;5711;5780;-375,8;-175,6;69;0
vpja19;9;5825;6018;-337,7;-316,5;193;0
vpja19;9;6054;6176;-216,8;-331,7;122;0
vpja19;9;6221;6517;-11,6;-409,5;296;0
vpja19;9;6600;6885;-381,9;127,8;285;255255000
vpja19;9;6905;7062;-330,7;120,7;157;255255000
vpja19;9;7120;7230;156,8;105,5;110;0
vpja19;9;7269;7405;296,3;78,4000000000001;136;0
vpja19;9;7432;7544;357,5;49,8000000000001;112;0
vpja19;9;7581;8153;195,1;133,3;572;255
vpja19;9;8339;8558;212,3;123,9;219;255
vpja19;9;8570;8761;200,5;110,1;191;255
vpja19;9;8815;8975;-79,4;-87,5999999999999;160;255000
vpja19;9;8982;10000;-61,5;-88,9;1018;255000
vpja19;10;169;223;14,1;-202,5;54;2,55e+08
vpja19;10;244;363;15,2;-259;119;255000
vpja19;10;376;862;24,1;-276,9;486;255000
vpja19;10;882;1244;57,3000000000001;-281,4;362;255000
vpja19;10;1427;1504;290,1;159,6;77;0
vpja19;10;1521;1979;299,9;189,7;458;255
vpja19;10;1988;2224;280,3;194,6;236;255
vpja19;10;2234;2427;294,5;192,9;193;255
vpja19;10;2500;2784;-302,9;122,2;284;255255000
vpja19;10;2794;3007;-284,1;103,8;213;255255000
vpja19;10;3027;3217;-337,3;100,9;190;0
vpja19;10;3290;3359;38,1;-261,3;69;255000
vpja19;10;3380;3535;49,6;-294,3;155;255000
vpja19;10;3549;3821;18,8000000000001;-282,4;272;255000
vpja19;10;3896;4155;300,5;202,5;259;255
vpja19;10;4164;4949;306,9;196,4;785;255
vpja19;10;5136;5211;15,6;-263,3;75;255000
vpja19;10;5268;5514;-326,2;113,2;246;255255000
vpja19;10;5534;5770;-348,8;119,6;236;255255000
vpja19;10;5785;5940;-328,1;130,6;155;255255000
vpja19;10;5958;6040;-290,2;116,2;82;255255000
vpja19;10;6112;6316;30,3000000000001;-272,4;204;255000
vpja19;10;6327;6516;15,6;-291,7;189;255000
vpja19;10;6534;6820;45;-291;286;255000
vpja19;10;6838;7121;-8,69999999999993;-274,5;283;255000
vpja19;10;7140;7315;32,5;-272,7;175;255000
vpja19;10;7322;7642;46;-281;320;255000
vpja19;10;7664;8086;1,90000000000009;-289,9;422;255000
vpja19;10;8107;8304;59,2;-295,4;197;255000
vpja19;10;8484;8797;18,1;-271;313;255000
vpja19;10;8807;9338;4,60000000000002;-278,8;531;255000
vpja19;10;9359;9792;64,9000000000001;-293;433;255000
vpja19;10;9819;9920;151,7;-248,3;101;0
vpja19;11;173;272;-16,5099315068494;-154,041780821918;99;0
vpja19;11;292;635;-66,8099315068494;-155,241780821918;343;255000
vpja19;11;665;685;-34,9099315068494;-72,9417808219179;20;2,55e+08
vpja19;11;729;820;8,09006849315062;160,858219178082;91;0
vpja19;11;838;1017;2,69006849315065;188,558219178082;179;0
vpja19;11;1038;1204;61,3900684931507;171,458219178082;166;255
vpja19;11;1267;1390;-52,7099315068493;-156,441780821918;123;255000
vpja19;11;1401;2036;-45,3099315068494;-161,741780821918;635;255000
vpja19;11;2268;2424;12,1900684931506;165,658219178082;156;255
vpja19;11;2441;2680;-19,7099315068493;182,358219178082;239;255
vpja19;11;2692;2856;-1,20993150684933;177,958219178082;164;255
vpja19;11;2880;3078;68,6900684931506;166,258219178082;198;0
vpja19;11;3103;3239;8,39006849315069;220,958219178082;136;0
vpja19;11;3263;3653;-22,0099315068494;300,158219178082;390;0
vpja19;11;3665;3902;-47,2099315068493;324,658219178082;237;0
vpja19;11;3931;4074;-168,909931506849;352,158219178082;143;0
vpja19;11;4096;4187;-226,709931506849;348,258219178082;91;0
vpja19;11;4312;4493;-321,109931506849;112,758219178082;181;255255000
vpja19;11;4511;4638;-282,409931506849;98,6582191780822;127;255255000
vpja19;11;4681;4989;-466,209931506849;229,858219178082;308;0
vpja19;11;5049;5150;-3,40993150684938;208,658219178082;101;0
vpja19;11;5171;5330;36,8900684931507;177,658219178082;159;0
vpja19;11;5349;5643;76,4900684931506;168,058219178082;294;0
vpja19;11;5670;5858;-16,8099315068494;182,858219178082;188;255
vpja19;11;5916;5998;-60,3099315068494;-129,641780821918;82;2,55e+08
vpja19;11;6151;6477;-56,7099315068493;-165,341780821918;326;255000
vpja19;11;6489;7180;-59,6099315068493;-176,441780821918;691;255000
vpja19;11;7206;7509;5,79006849315067;-220,141780821918;303;0
vpja19;11;7534;7900;-65,4099315068494;-159,841780821918;366;255000
vpja19;11;7910;8111;-48,2099315068493;-151,841780821918;201;255000
vpja19;11;8120;8231;-62,1099315068493;-143,241780821918;111;255000
vpja19;11;8263;8378;7,69006849315065;-234,941780821918;115;0
vpja19;11;8406;8527;84,8900684931507;-293,841780821918;121;0
vpja19;11;8668;8897;80,3900684931507;-456,041780821918;229;0
vpja19;11;8921;9165;133,990068493151;-453,641780821918;244;0
vpja19;11;9201;9432;266,090068493151;-455,441780821918;231;0
vpja19;11;9470;9595;343,590068493151;-322,841780821918;125;0
vpja19;11;9633;9732;300,090068493151;-141,941780821918;99;0
vpja19;11;9767;9896;249,990068493151;-9,14178082191779;129;0
vpja19;11;9929;10000;231,690068493151;68,7582191780822;71;0
vpja19;12;165;282;-68,5;-141,6;117;255000
vpja19;12;302;499;-38,8;-179,1;197;255000
vpja19;12;508;1394;-53,8;-178,6;886;255000
vpja19;12;1463;1543;251,9;205,7;80;0
vpja19;12;1558;1694;243,1;225,9;136;255
vpja19;12;1708;1769;208,6;220,7;61;255
vpja19;12;1927;2191;281,6;241,3;264;255
vpja19;12;2219;2448;200,8;219;229;255
vpja19;12;2473;2640;263,5;235;167;255
vpja19;12;2718;2923;-64,1;-170,1;205;255000
vpja19;12;2991;3192;286,4;256,8;201;0
vpja19;12;3242;3277;-21,3;270,9;35;0
vpja19;12;3314;3468;-176,6;326,8;154;0
vpja19;12;3483;3641;-132;333;158;255255000
vpja19;12;3694;3922;252,8;232,6;228;255
vpja19;12;3941;4339;293,6;247,2;398;0
vpja19;12;4492;4902;-145,1;325,2;410;255255000
vpja19;12;4913;5127;-158,9;319,3;214;255255000
vpja19;12;5135;5585;-135,4;330,3;450;255255000
vpja19;12;5640;5891;260,5;245,1;251;255
vpja19;12;5908;6265;287,8;265,3;357;0
vpja19;12;6295;6514;188;219;219;255
vpja19;12;6540;6715;272,5;258,6;175;0
vpja19;12;6729;7019;294,3;268,7;290;0
vpja19;12;7222;7397;-45,3;-203,3;175;255000
vpja19;12;7404;8383;-53,6999999999999;-179,8;979;255000
vpja19;12;8412;8589;-145,8;-174,3;177;255000
vpja19;12;8624;8743;-59,4;-121,2;119;2,55e+08
vpja19;12;8752;9091;-53,1999999999999;-123,9;339;2,55e+08
vpja19;12;9130;9328;-151,8;21,6;198;2,55e+08
vpja19;12;9367;9529;-277;-68,0999999999999;162;2,55e+08
vpja19;12;9575;9723;-478;56,3000000000001;148;0
vpja19;12;9758;9893;-558,8;128,5;135;0
vpja19;12;9947;10000;-513,9;-141,8;53;0
vpja19;13;171;276;6;-152,9;105;255000
vpja19;13;293;474;-13,2;-172,6;181;255000
vpja19;13;526;580;-206,6;-19,1999999999999;54;0
vpja19;13;630;842;-18,9;-169,8;212;255000
vpja19;13;854;1278;-10,3000000000001;-188,8;424;255000
vpja19;13;1294;1621;-36,2;-200,2;327;255000
vpja19;13;1632;1784;-16,7;-200;152;255000
vpja19;13;1937;2041;-15,5;-199,8;104;255000
vpja19;13;2059;2196;-25,2;-150,1;137;255000
vpja19;13;2252;2529;-307,9;113,8;277;255
vpja19;13;2591;2806;-5,89999999999998;-171,7;215;255000
vpja19;13;2821;3043;-26,2;-159,1;222;255000
vpja19;13;3102;3268;-352,9;141,5;166;255
vpja19;13;3280;4103;-314;118,1;823;255
vpja19;13;4114;4339;-317,5;129,9;225;255
vpja19;13;4406;4609;251;155,6;203;255255000
vpja19;13;4621;4754;256,6;182,8;133;255255000
vpja19;13;4763;5238;226,7;185,6;475;255255000
vpja19;13;5409;5515;232,7;160,7;106;255255000
vpja19;13;5584;5748;-349;120,9;164;255
vpja19;13;5760;5905;-327,9;107;145;0
vpja19;13;5966;6161;8,39999999999998;-190,9;195;255000
vpja19;13;6170;6531;-19,4;-191,5;361;255000
vpja19;13;6546;6696;-50,2;-189,2;150;255000
vpja19;13;6757;6902;-362,6;138,5;145;255
vpja19;13;6919;7275;-327,2;104,9;356;0
vpja19;13;7288;7537;-352,1;93,9;249;255
vpja19;13;7604;7737;-3,10000000000002;-171,8;133;255000
vpja19;13;7749;8000;-7,39999999999998;-190,6;251;255000
vpja19;13;8009;8299;0,600000000000023;-191,8;290;255000
vpja19;13;8365;8506;-329,7;86;141;0
vpja19;13;8519;8771;-327;100,3;252;0
vpja19;13;8779;8909;-343;97,6;130;255
vpja19;13;8926;9123;-330,2;133,7;197;255
vpja19;13;9292;9553;-332,8;129;261;255
vpja19;13;9564;10000;-346,2;94,6;436;255
vpja19;14;165;264;1,30000000000007;-138,7;99;255000
vpja19;14;278;436;-29,8;-131,1;158;255000
vpja19;14;445;592;-22,1999999999999;-128,4;147;255000
vpja19;14;664;748;-512,2;90,4;84;0
vpja19;14;767;883;-506,2;122;116;255
vpja19;14;905;1072;-456,7;93,9;167;0
vpja19;14;1097;1205;-530,5;140,5;108;255
vpja19;14;1266;1447;-31,5;350,4;181;255255000
vpja19;14;1456;1534;-43,6;327,4;78;255255000
vpja19;14;1718;2051;-35,1999999999999;324,2;333;255255000
vpja19;14;2063;2183;-19,9;337,1;120;255255000
vpja19;14;2251;2413;-545,7;151,9;162;255
vpja19;14;2427;2706;-551,5;143;279;255
vpja19;14;2725;2892;-495,1;112;167;0
vpja19;14;2904;3031;-474,3;99;127;0
vpja19;14;3056;3695;-537,2;136,1;639;255
vpja19;14;3720;4031;-453,3;99,6;311;255
vpja19;14;4097;4243;-10,3;-117,2;146;255000
vpja19;14;4255;5065;-20,5;-133,8;810;255000
vpja19;14;5086;5266;-25,1;-84,8;180;255000
vpja19;14;5333;5577;-547;151,2;244;255
vpja19;14;5602;5862;-513,4;224,6;260;255
vpja19;14;5880;6164;-474,3;235,9;284;255
vpja19;14;6196;6476;-532;150,8;280;255
vpja19;14;6486;6623;-530,2;129,6;137;255
vpja19;14;6796;6885;17,8000000000001;-174,5;89;255000
vpja19;14;6906;7212;-35,3;-135;306;255000
vpja19;14;7241;7456;31;-192,8;215;255000
vpja19;14;7513;7649;-41,6999999999999;117,7;136;2,55e+08
vpja19;14;7685;7772;-48,6;251,4;87;0
vpja19;14;7795;7924;-38,5;312,5;129;255255000
vpja19;14;7953;8110;45,6;253,1;157;0
vpja19;14;8152;8298;61,6;109,3;146;2,55e+08
vpja19;14;8339;8483;33,7;-18,4;144;2,55e+08
vpja19;14;8515;8629;-13,3;-103,6;114;255000
vpja19;14;8645;9001;-36,6;-124,4;356;255000
vpja19;14;9020;9222;-37,8;-82;202;2,55e+08
vpja19;14;9263;9388;63,4;47,6;125;2,55e+08
vpja19;14;9405;9591;57,3000000000001;87,7;186;2,55e+08
vpja19;14;9613;9651;-6,60000000000002;97,1;38;2,55e+08
vpja19;14;9857;10000;-506,2;159,9;143;255
vpja19;15;17;147;5,69999999999993;-1,29999999999995;130;2,55e+08
vpja19;15;196;243;-1,80000000000007;-253,2;47;2,55e+08
vpja19;15;276;426;9,29999999999995;-378,7;150;255000
vpja19;15;441;576;-16,2;-377,8;135;255000
vpja19;15;593;773;-13,7;-402,1;180;255000
vpja19;15;781;923;-3,70000000000005;-404,4;142;255000
vpja19;15;949;1384;-27,5;-295,4;435;255000
vpja19;15;1414;1563;-12,1;-391,1;149;255000
vpja19;15;1662;1795;-472,9;381,9;133;0
vpja19;15;1818;2018;-491,4;413,6;200;0
vpja19;15;2040;2421;-545,6;438,1;381;255
vpja19;15;2494;2601;-10,6;165,1;107;0
vpja19;15;2627;2807;-20,3000000000001;108,9;180;2,55e+08
vpja19;15;2872;3158;-491,1;437,1;286;255
vpja19;15;3183;3562;-533,6;442,7;379;255
vpja19;15;3650;3784;364,8;332,9;134;255255000
vpja19;15;3810;3958;303,1;283,3;148;255255000
vpja19;15;4004;4333;523,6;396,7;329;255255000
vpja19;15;4384;4513;282,2;280,8;129;255255000
vpja19;15;4533;4783;251;249,4;250;255255000
vpja19;15;4861;5044;-488,2;390,3;183;0
vpja19;15;5065;5258;-509,5;443,3;193;255
vpja19;15;5278;5511;-567;440,6;233;255
vpja19;15;5538;5884;-461,6;419,4;346;255
vpja19;15;5967;6068;158,4;256,4;101;0
vpja19;15;6092;6255;228,5;251,8;163;255255000
vpja19;15;6441;6619;479,1;362,5;178;255255000
vpja19;15;6645;6883;547;401,1;238;255255000
vpja19;15;6932;7118;210,8;287,8;186;0
vpja19;15;7136;7208;241,3;258,2;72;255255000
vpja19;15;7284;7359;12,8;-253;75;2,55e+08
vpja19;15;7394;7471;10,6999999999999;-342,5;77;255000
vpja19;15;7495;7947;6;-408,8;452;255000
vpja19;15;7968;8241;-44,1;-400,6;273;255000
vpja19;15;8264;8460;-18,1;-319,3;196;255000
vpja19;15;8616;8727;-485,8;367,3;111;255
vpja19;15;8751;8915;-521,9;422,1;164;255
vpja19;15;8936;9104;-467,1;432,4;168;255
vpja19;15;9139;9533;-457,8;304;394;255
vpja19;15;9566;9613;-557,4;395,1;47;0
vpja19;15;9666;10000;-627,6;134,6;334;0
vpja19;16;178;200;31;-174,8;22;2,55e+08
vpja19;16;227;349;125;-182;122;255000
vpja19;16;368;495;147,4;-139,5;127;255000
vpja19;16;546;684;221,6;160,7;138;255
vpja19;16;703;1126;235,7;184;423;255
vpja19;16;1155;1204;214,2;104,7;49;0
vpja19;16;1263;1756;147,1;-191,2;493;255000
vpja19;16;1849;2012;-398,6;87,2;163;255255000
vpja19;16;2037;2160;-428,4;150,5;123;255255000
vpja19;16;2227;2390;201;203,2;163;255
vpja19;16;2410;2910;238,1;202,2;500;255
vpja19;16;2924;3271;264,4;215,1;347;255
vpja19;16;3459;3863;-405;109;404;255255000
vpja19;16;3879;4033;-375,3;124,7;154;255255000
vpja19;16;4114;4215;194,5;-167,9;101;2,55e+08
vpja19;16;4238;4355;161,2;-209,1;117;255000
vpja19;16;4369;4515;155;-176,6;146;255000
vpja19;16;4531;4800;117,4;-201,2;269;255000
vpja19;16;4812;4991;139,7;-194,4;179;255000
vpja19;16;5042;5412;-94,9;-259,6;370;0
vpja19;16;5440;5676;-202,5;-248,5;236;0
vpja19;16;5699;5897;-156,9;-290,1;198;0
vpja19;16;5941;6096;-305,2;-183,8;155;0
vpja19;16;6141;6358;-160,4;-288,1;217;0
vpja19;16;6384;6637;-98,5;-308,3;253;0
vpja19;16;6805;6928;102,8;-212,6;123;255000
vpja19;16;6946;7090;138,2;-200,1;144;255000
vpja19;16;7136;7310;411,1;-410,7;174;0
vpja19;16;7340;7530;468,5;-505,4;190;NA
vpja19;16;7553;7764;485,8;-566;211;NA
vpja19;16;7815;7932;141,4;-231,4;117;255000
vpja19;16;7957;8251;135,5;-167,3;294;255000
vpja19;16;8415;8529;133,8;103,5;114;255
vpja19;16;8548;8680;167,8;133,9;132;255
vpja19;16;8707;8915;231,6;209,8;208;255
vpja19;16;8955;9191;155,4;357,8;236;255
vpja19;16;9210;9372;205,3;352,9;162;255
vpja19;16;9408;9563;223,1;220,8;155;255
vpja19;16;9624;9788;137,4;-151,7;164;255000
vpja19;16;9806;9969;137,1;-179;163;255000
vpja19;17;160;215;-11,8000000000001;-150,1;55;2,55e+08
vpja19;17;237;319;-20;-216,2;82;255000
vpja19;17;334;511;-3,5;-225,9;177;255000
vpja19;17;519;798;-15,4;-224;279;255000
vpja19;17;813;928;-7,30000000000007;-196,4;115;255000
vpja19;17;996;1190;345,3;197,8;194;255
vpja19;17;1436;1596;-14;-256,3;160;255000
vpja19;17;1611;2013;-14,8000000000001;-257,6;402;255000
vpja19;17;2083;2228;324,2;227,9;145;255
vpja19;17;2242;2680;340,8;202,4;438;255
vpja19;17;2690;2792;322,3;220,4;102;255
vpja19;17;2864;2986;-342;228,3;122;255255000
vpja19;17;3009;3114;-389;217,5;105;255255000
vpja19;17;3139;3322;-416,3;153,4;183;255255000
vpja19;17;3349;3473;-399,6;242,5;124;255255000
vpja19;17;3494;3655;-350,3;206,7;161;255255000
vpja19;17;3677;4057;-395,9;248,9;380;255255000
vpja19;17;4085;4332;-412,9;160,2;247;255255000
vpja19;17;4362;4503;-476,4;223,8;141;255255000
vpja19;17;4512;4617;-491,3;233,2;105;255255000
vpja19;17;4643;4839;-406,6;283,7;196;255255000
vpja19;17;4861;5110;-400,6;223,6;249;255255000
vpja19;17;5202;5457;353;241,8;255;255
vpja19;17;5466;5639;349,8;219,4;173;255
vpja19;17;5809;6060;346,6;209,8;251;255
vpja19;17;6080;6575;367,3;253,7;495;255
vpja19;17;6589;6867;356,6;227;278;255
vpja19;17;6883;6961;371,4;262,1;78;255
vpja19;17;7048;7207;13,6;-229;159;255000
vpja19;17;7221;7390;-1,39999999999998;-232,4;169;255000
vpja19;17;7435;7589;163,2;-330,9;154;0
vpja19;17;7635;8052;-8,10000000000002;-204,2;417;255000
vpja19;17;8068;8238;-7,80000000000007;-231,2;170;255000
vpja19;17;8245;8541;-18,1;-234,8;296;255000
vpja19;17;8594;8888;369,1;-503,2;294;NA
vpja19;17;8922;9302;246,1;-460,9;380;0
vpja19;17;9346;9433;13,3;-274,8;87;255000
vpja19;17;9455;9632;-16,1;-234,4;177;255000
vpja19;17;9699;9779;-432,8;-51,4;80;0
vpja19;17;9801;9951;-420,4;6,40000000000009;150;0
vpja19;18;175;218;-120,1;-117;43;2,55e+08
vpja19;18;248;528;-181,9;-193,9;280;255000
vpja19;18;537;801;-181,2;-196,4;264;255000
vpja19;18;847;954;-62;-31,5;107;255
vpja19;18;995;1180;-23,4;135,8;185;255
vpja19;18;1213;1415;-118,4;38,4000000000001;202;255
vpja19;18;1587;1705;-190,6;-192,7;118;255000
vpja19;18;1717;1947;-171,3;-216,5;230;255000
vpja19;18;1955;2566;-184,7;-206,4;611;255000
vpja19;18;2580;2673;-169,6;-187,9;93;0
vpja19;18;2719;2819;-34,7;9,60000000000002;100;255
vpja19;18;2860;2988;-178,3;139;128;2,55e+08
vpja19;18;3031;3193;-70,2;286,5;162;2,55e+08
vpja19;18;3203;3589;-57,1;280,4;386;2,55e+08
vpja19;18;3612;4073;-5,10000000000002;274,6;461;2,55e+08
vpja19;18;4096;4203;-9,79999999999995;236,4;107;0
vpja19;18;4258;4571;-16,6;24,4000000000001;313;255
vpja19;18;4585;4738;-43,3;27,3000000000001;153;255
vpja19;18;4764;4938;-119,3;44,7;174;255
vpja19;18;4952;5288;-144,9;41,2;336;2,55e+08
vpja19;18;5296;5435;-157,5;52,2;139;2,55e+08
vpja19;18;5461;5669;-233,9;87,2;208;0
vpja19;18;5687;5860;-207,1;86,3000000000001;173;2,55e+08
vpja19;18;5900;5947;-27,9;42,6;47;255
vpja19;18;6090;6525;-26,6;9,90000000000009;435;255
vpja19;18;6580;6769;-183,7;-194,8;189;255000
vpja19;18;6777;7506;-179,1;-202,2;729;255000
vpja19;18;7553;7686;-220,2;-23,0999999999999;133;2,55e+08
vpja19;18;7706;7909;-252,5;12,1;203;2,55e+08
vpja19;18;7933;8059;-170,7;-27,9;126;2,55e+08
vpja19;18;8087;8278;-188,9;-129,8;191;2,55e+08
vpja19;18;8330;8470;-471,2;15,3000000000001;140;255255000
vpja19;18;8494;8704;-500,5;75,8000000000001;210;255255000
vpja19;18;8718;8965;-522,6;48,9000000000001;247;255255000
vpja19;18;8986;9119;-465,7;52;133;255255000
vpja19;18;9172;9230;-38,4;11,8000000000001;58;255
vpja19;18;9364;9761;35,6;-17,0999999999999;397;255
vpja19;18;9781;10000;-23,8;8,10000000000002;219;255
vpja19;19;170;217;-5,90000000000009;-153,4;47;2,55e+08
vpja19;19;257;327;-30,2;-309,9;70;255000
vpja19;19;345;465;-41,5;-345,3;120;255000
vpja19;19;474;842;-50,1;-327,9;368;255000
vpja19;19;915;995;-346,4;130,7;80;0
vpja19;19;1017;1350;-351,5;165,6;333;255
vpja19;19;1408;1725;-426,5;250,2;317;255
vpja19;19;1751;1871;-356,2;185,6;120;255
vpja19;19;2044;2123;-71,4000000000001;-301,8;79;2,55e+08
vpja19;19;2142;2422;-45;-322,8;280;255000
vpja19;19;2430;2748;-47,7;-328;318;255000
vpja19;19;2789;2838;-43;-124,3;49;2,55e+08
vpja19;19;2864;3021;-23,3000000000001;-20,2;157;2,55e+08
vpja19;19;3051;3177;-29,4000000000001;86,3;126;0
vpja19;19;3199;3366;-42,2;122,8;167;2,55e+08
vpja19;19;3440;3662;-44,4000000000001;-329,2;222;255000
vpja19;19;3710;3997;-292,4;-240,7;287;0
vpja19;19;4020;4170;-284;-293,6;150;0
vpja19;19;4211;4425;-464,1;-289,8;214;0
vpja19;19;4631;4736;375,6;148,3;105;255255000
vpja19;19;4763;4946;288,3;191,5;183;255255000
vpja19;19;4968;5308;297,2;246,8;340;0
vpja19;19;5339;5535;383,3;180,6;196;255255000
vpja19;19;5595;5854;-22,3000000000001;119;259;0
vpja19;19;5869;6029;-46;134;160;2,55e+08
vpja19;19;6083;6267;-414,7;182,9;184;255
vpja19;19;6291;6429;-412,8;242,4;138;255
vpja19;19;6445;6928;-431,9;251;483;255
vpja19;19;7096;7192;-57,6;-273,7;96;2,55e+08
vpja19;19;7214;7366;-36,7;-314,5;152;2,55e+08
vpja19;19;7375;8129;-43,2;-327,3;754;255000
vpja19;19;8141;8365;-48,8000000000001;-311,1;224;2,55e+08
vpja19;19;8413;8672;158,4;-260,3;259;0
vpja19;19;8690;8862;162,9;-301,2;172;0
vpja19;19;8905;9050;-39,3000000000001;-318,6;145;2,55e+08
vpja19;19;9061;9210;-52,1;-324,3;149;255000
vpja19;19;9325;9589;-33,1;-363,4;264;255000
vpja19;19;9644;9947;-21,1;-41,6;303;2,55e+08
vpja19;20;166;307;-57,2;-141,5;141;0
vpja19;20;319;436;-66,8;-159;117;255000
vpja19;20;487;663;95,2;116,6;176;0
vpja19;20;715;826;-243,7;119,6;111;255255000
vpja19;20;881;1054;-89,9;-190,2;173;255000
vpja19;20;1064;1390;-74,7;-176,6;326;255000
vpja19;20;1444;1576;-233,5;86,5;132;0
vpja19;20;1593;1665;-204,7;88,9;72;0
vpja19;20;1688;2159;-266,7;112,1;471;255255000
vpja19;20;2387;3045;89,6;88,8;658;255
vpja19;20;3060;3218;115,6;89;158;0
vpja19;20;3273;3427;-60,4;-162;154;255000
vpja19;20;3445;4292;-81,7;-174,7;847;255000
vpja19;20;4302;4441;-65,7;-165,4;139;255000
vpja19;20;4452;4782;-78,9;-144,8;330;255000
vpja19;20;4831;4851;68,1;-3,20000000000005;20;0
vpja19;20;4974;5324;104,1;85,6;350;255
vpja19;20;5336;5558;68;88,1;222;0
vpja19;20;5601;5670;229,4;54,5;69;0
vpja19;20;5699;5886;311,7;-32;187;0
vpja19;20;5939;6077;0,100000000000023;35,1999999999999;138;2,55e+08
vpja19;20;6107;6616;97,6;109,4;509;255
vpja19;20;6670;6842;-241,5;114,3;172;255255000
vpja19;20;6869;7076;-315,2;115,9;207;0
vpja19;20;7089;7411;-284,4;118,5;322;255255000
vpja19;20;7423;7892;-264,4;108,1;469;255255000
vpja19;20;7928;8067;-167,7;2,60000000000002;139;2,55e+08
vpja19;20;8101;8214;-95;-45,2;113;2,55e+08
vpja19;20;8241;8370;-95,8;-137,7;129;2,55e+08
vpja19;20;8386;8550;-80,4;-169,7;164;255000
vpja19;20;8560;9175;-86,6;-182,7;615;255000
vpja19;20;9187;9369;-68,3;-184;182;255000
vpja19;20;9378;9510;-81,4;-185,4;132;255000
vpja19;20;9692;9780;-8;-185;88;0
vpja19;20;9802;10000;-75,4;-173,6;198;255000
vpja19;21;214;311;-284,004273504273;-184,424786324786;97;255000
vpja19;21;330;602;-317,004273504273;-136,624786324786;272;255000
vpja19;21;611;852;-325,804273504274;-138,724786324786;241;255000
vpja19;21;861;1060;-307,204273504273;-153,124786324786;199;255000
vpja19;21;1078;1456;-316,604273504273;-133,724786324786;378;255000
vpja19;21;1465;1660;-307,404273504274;-156,424786324786;195;255000
vpja19;21;1668;1905;-293,904273504274;-156,124786324786;237;255000
vpja19;21;1922;2280;-312,004273504273;-127,624786324786;358;255000
vpja19;21;2323;2396;-247,404273504274;38,1752136752137;73;2,55e+08
vpja19;21;2417;2578;-245,404273504274;73,7752136752138;161;255
vpja19;21;2624;3083;-314,404273504274;-138,624786324786;459;255000
vpja19;21;3099;3366;-341,904273504274;-135,124786324786;267;255000
vpja19;21;3377;3654;-327,404273504274;-121,224786324786;277;255000
vpja19;21;3669;3908;-307,004273504273;-141,224786324786;239;255000
vpja19;21;3918;4226;-319,504273504273;-133,124786324786;308;255000
vpja19;21;4241;4594;-329,104273504273;-105,124786324786;353;255000
vpja19;21;4757;4992;28,9957264957266;-28,3247863247863;235;255255000
vpja19;21;5024;5124;46,7957264957265;56,9752136752138;100;255255000
vpja19;21;5171;5305;-230,604273504273;89,5752136752137;134;255
vpja19;21;5355;5547;-321,804273504274;-137,724786324786;192;255000
vpja19;21;5558;5711;-315,704273504273;-148,324786324786;153;255000
vpja19;21;5720;6072;-299,004273504273;-158,824786324786;352;255000
vpja19;21;6080;6210;-305,704273504273;-155,824786324786;130;255000
vpja19;21;6226;6345;-321,304273504274;-116,624786324786;119;255000
vpja19;21;6398;6597;42,7957264957265;-30,8247863247863;199;255255000
vpja19;21;6620;6745;-8,10427350427346;-52,8247863247863;125;0
vpja19;21;6759;6914;10,1957264957265;-21,8247863247863;155;255255000
vpja19;21;6959;7181;-13,9042735042735;-238,524786324786;222;0
vpja19;21;7209;7373;63,1957264957265;-291,224786324786;164;0
vpja19;21;7413;7472;38,3957264957265;-146,724786324786;59;0
vpja19;21;7506;7703;19,7957264957265;-37,8247863247863;197;255255000
vpja19;21;7760;8031;-319,504273504273;-133,824786324786;271;255000
vpja19;21;8043;8526;-326,004273504273;-153,424786324786;483;255000
vpja19;21;8541;8726;-310,804273504274;-140,024786324786;185;255000
vpja19;21;8736;8893;-314,904273504274;-129,224786324786;157;255000
vpja19;21;8912;9174;-299,004273504273;-166,824786324786;262;255000
vpja19;21;9183;9323;-303,604273504273;-150,824786324786;140;255000
vpja19;21;9515;9694;-303,204273504273;85,0752136752137;179;255
vpja19;21;9729;9789;-348,604273504273;-18,4247863247863;60;2,55e+08
vpja19;21;9829;10000;-245,704273504273;-117,224786324786;171;0
vpja19;22;116;207;0,600000000000023;-18,4;91;2,55e+08
vpja19;22;249;275;-24,6999999999999;-194,2;26;2,55e+08
vpja19;22;301;452;-86,1;-257,4;151;255000
vpja19;22;475;663;-101,4;-297,2;188;255000
vpja19;22;676;858;-129;-292,3;182;255000
vpja19;22;897;996;29,4;-254,2;99;255000
vpja19;22;1055;1183;616,9;-523,9;128;NA
vpja19;22;1249;1552;-80,8;-290,6;303;255000
vpja19;22;1566;1885;-72,4;-322,8;319;255000
vpja19;22;1924;2049;-109,2;-199,3;125;255000
vpja19;22;2070;2171;-94,9;-252,1;101;255000
vpja19;22;2194;2380;-88,3;-308,7;186;255000
vpja19;22;2584;2814;-428,9;257,7;230;0
vpja19;22;2835;2978;-430,6;309,9;143;255
vpja19;22;2996;3395;-459,1;342,5;399;255
vpja19;22;3431;3587;-390,3;284,2;156;255
vpja19;22;3610;3850;-440,7;300,3;240;255
vpja19;22;3871;4116;-458,7;351,6;245;255
vpja19;22;4199;4409;280,8;293;210;255255000
vpja19;22;4425;4504;313,7;289,2;79;0
vpja19;22;4866;5034;-90,8;-287,2;168;255000
vpja19;22;5042;5682;-77,3;-304,2;640;255000
vpja19;22;5728;5882;-1,89999999999998;-104;154;2,55e+08
vpja19;22;5933;6023;207;149,4;90;0
vpja19;22;6057;6177;284,8;248,3;120;0
vpja19;22;6188;6277;268,3;256,1;89;0
vpja19;22;6320;6609;369,5;104,7;289;0
vpja19;22;6637;6698;363,2;18,5;61;0
vpja19;22;6837;7027;587,9;-465,8;190;0
vpja19;22;7096;7243;-146,3;-286,3;147;255000
vpja19;22;7312;7509;-440,3;263,9;197;0
vpja19;22;7530;7603;-413,9;294,7;73;255
vpja19;22;7628;7994;-463,7;341;366;255
vpja19;22;8007;8459;-487,3;358,1;452;255
vpja19;22;8492;8671;-409,2;275,9;179;255
vpja19;22;8728;8885;-234,4;68;157;2,55e+08
vpja19;22;8913;9006;-128,4;101,7;93;2,55e+08
vpja19;22;9056;9275;-432,4;286,6;219;255
vpja19;22;9328;9462;-102,4;127;134;2,55e+08
vpja19;22;9502;9646;34,6;85;144;2,55e+08
vpja19;22;9709;9929;-451,1;288,8;220;255
vpja19;22;9943;10000;-412,1;279,2;57;255
vpja19;23;177;288;18,9;-26;111;255000
vpja19;23;306;630;56,6999999999999;-25,6;324;255000
vpja19;23;682;917;314,8;176,7;235;255
vpja19;23;970;1095;21,8;-27,1999999999999;125;255000
vpja19;23;1243;1340;7,29999999999995;38,8000000000001;97;2,55e+08
vpja19;23;1363;1484;35,3;-10;121;255000
vpja19;23;1502;1702;58;-39,6999999999999;200;255000
vpja19;23;1739;1891;-30,6;94,1;152;255255000
vpja19;23;1930;2039;19,5;-9,69999999999993;109;2,55e+08
vpja19;23;2102;2270;-504,4;97,3000000000001;168;0
vpja19;23;2334;2495;93,5;-57,3;161;0
vpja19;23;2509;3003;73,3;-36,6999999999999;494;255000
vpja19;23;3055;3346;330,2;181,7;291;255
vpja19;23;3406;3788;74,8;-41;382;255000
vpja19;23;3826;4018;-24,9;106,8;192;255255000
vpja19;23;4034;4236;-42;75,9;202;255255000
vpja19;23;4252;4521;-53,4;106,3;269;255255000
vpja19;23;4540;4827;-47,2;59,7;287;255255000
vpja19;23;4986;5161;288,4;157,6;175;0
vpja19;23;5174;5507;321,4;177,9;333;255
vpja19;23;5525;5772;265,3;182,8;247;255
vpja19;23;5788;6932;309,9;169,4;1144;255
vpja19;23;6940;7005;321;175,6;65;255
vpja19;23;7057;7163;50,1999999999999;-13,4;106;255000
vpja19;23;7180;7327;40,1;-41,9;147;255000
vpja19;23;7341;7842;64,1999999999999;-43,6;501;255000
vpja19;23;7885;8109;-37,3000000000001;103,3;224;255255000
vpja19;23;8122;8745;-39,1;74,8000000000001;623;255255000
vpja19;23;8757;8923;-26,1;99,2;166;255255000
vpja19;23;8949;9132;-40,7;29,9;183;0
vpja19;23;9147;9254;-44,6;54,3000000000001;107;255255000
vpja19;23;9292;9470;62,6;-50,1999999999999;178;255000
vpja19;23;9506;9750;81;-156,2;244;0
vpja19;23;9773;9874;59,1999999999999;-99,6;101;255000
vpja19;23;9908;10000;-2,20000000000005;-179,7;92;0
vpja19;24;17;137;7,41632653061231;0,222448979591945;120;2,55e+08
vpja19;24;178;220;7,71632653061226;-177,577551020408;42;2,55e+08
vpja19;24;248;404;-18,7836734693877;-270,477551020408;156;255000
vpja19;24;414;786;-35,8836734693876;-275,277551020408;372;255000
vpja19;24;805;1003;-33,1836734693877;-238,277551020408;198;255000
vpja19;24;1063;1221;-278,083673469388;135,622448979592;158;255
vpja19;24;1245;1332;-346,683673469388;156,322448979592;87;255
vpja19;24;1367;1521;-457,383673469388;228,422448979592;154;255
vpja19;24;1544;1811;-501,183673469388;255,822448979592;267;255
vpja19;24;1849;2107;-355,783673469388;182,122448979592;258;255
vpja19;24;2151;2173;-142,283673469388;154,122448979592;22;255
vpja19;24;2229;2357;276,616326530612;219,022448979592;128;0
vpja19;24;2382;2456;345,416326530612;218,722448979592;74;255255000
vpja19;24;2734;2825;254,616326530612;-22,0775510204081;91;0
vpja19;24;2845;3073;253,716326530612;-48,8775510204081;228;0
vpja19;24;3084;3411;250,016326530612;-68,7775510204081;327;0
vpja19;24;3473;3601;-254,683673469388;-76,2775510204081;128;0
vpja19;24;3617;3795;-273,683673469388;-85,3775510204081;178;0
vpja19;24;3852;3980;-68,1836734693877;-295,977551020408;128;255000
vpja19;24;3995;4552;-34,2836734693877;-266,377551020408;557;255000
vpja19;24;4567;4737;-55,0836734693877;-267,677551020408;170;255000
vpja19;24;4812;4958;-289,483673469388;114,922448979592;146;255
vpja19;24;4983;5220;-351,883673469388;130,622448979592;237;255
vpja19;24;5248;5428;-444,683673469388;190,422448979592;180;255
vpja19;24;5438;5688;-427,483673469388;181,522448979592;250;255
vpja19;24;5705;5870;-455,983673469388;206,222448979592;165;255
vpja19;24;5889;5929;-485,383673469388;235,022448979592;40;255
vpja19;24;6094;6361;-495,283673469388;240,122448979592;267;255
vpja19;24;6404;6540;-322,183673469388;175,622448979592;136;255
vpja19;24;6561;6795;-296,983673469388;130,722448979592;234;255
vpja19;24;6871;7027;-20,2836734693877;-249,977551020408;156;255000
vpja19;24;7040;7508;-29,1836734693877;-262,877551020408;468;255000
vpja19;24;7522;7658;-48,7836734693877;-268,677551020408;136;255000
vpja19;24;7669;7898;-69,6836734693877;-265,477551020408;229;255000
vpja19;24;7915;8104;-31,7836734693877;-267,777551020408;189;255000
vpja19;24;8124;8295;-39,3836734693876;-231,077551020408;171;255000
vpja19;24;8303;8572;-30,4836734693877;-212,977551020408;269;255000
vpja19;24;8595;8739;-28,3836734693876;-133,277551020408;144;2,55e+08
vpja19;24;8797;8903;249,116326530612;142,822448979592;106;0
vpja19;24;8929;9020;284,116326530612;195,622448979592;91;0
vpja19;24;9154;9315;222,216326530612;-91,5775510204081;161;0
vpja19;24;9350;9487;243,016326530612;-182,777551020408;137;0
vpja19;24;9547;9660;-14,8836734693876;-345,177551020408;113;255000
vpja19;24;9687;10000;-66,8836734693876;-413,377551020408;313;0
vpja19;25;182;225;79,9000000000001;-187,3;43;2,55e+08
vpja19;25;250;339;107,2;-266,2;89;2,55e+08
vpja19;25;357;607;145;-272,7;250;255000
vpja19;25;615;1265;150,2;-273,5;650;255000
vpja19;25;1666;1827;329,6;123,1;161;255
vpja19;25;1854;2002;370,2;73,4;148;255
vpja19;25;2018;2193;404,4;56,9;175;0
vpja19;25;2231;2399;301,7;127,2;168;255
vpja19;25;2427;2555;378,9;86,3;128;0
vpja19;25;2579;2785;444,5;53,3;206;0
vpja19;25;2801;3131;469,8;42,1;330;0
vpja19;25;3157;3436;382;64,4;279;255
vpja19;25;3464;3571;308,9;128,9;107;255
vpja19;25;3627;3663;-101,8;62,6999999999999;36;255255000
vpja19;25;3796;4005;-111,6;58,3;209;255255000
vpja19;25;4016;4190;-83,3;53,1999999999999;174;255255000
vpja19;25;4202;4440;-67,8;39,5;238;255255000
vpja19;25;4478;4718;-209,8;46,1;240;0
vpja19;25;4743;4879;-137,6;49,1999999999999;136;255255000
vpja19;25;4935;5059;274,4;83,8;124;0
vpja19;25;5103;5234;411,2;60,8;131;0
vpja19;25;5244;5555;408,3;47;311;255
vpja19;25;5573;5730;423;21,6;157;255
vpja19;25;5748;5873;391,1;45,1;125;255
vpja19;25;5904;5984;301,7;126,2;80;255
vpja19;25;6163;6295;275,8;115,5;132;255
vpja19;25;6328;6462;359,7;87,8;134;255
vpja19;25;6483;6729;367,6;40,4;246;0
vpja19;25;6765;7093;262,8;4,5;328;0
vpja19;25;7135;7414;427,4;10,8;279;255
vpja19;25;7427;7591;440,5;25,1999999999999;164;255
vpja19;25;7657;7716;108,4;-215,8;59;2,55e+08
vpja19;25;7738;7822;132,7;-272;84;255000
vpja19;25;7845;8657;166,3;-295,5;812;255000
vpja19;25;8664;8920;175,9;-288,5;256;255000
vpja19;25;8928;9102;164,3;-290,4;174;255000
vpja19;25;9113;9426;166,5;-271,2;313;255000
vpja19;25;9441;9568;143,7;-242,1;127;2,55e+08
vpja19;25;9582;9879;120,8;-215,9;297;2,55e+08
vpja19;25;9905;10000;93,6;-146,7;95;2,55e+08
vpja19;26;160;235;84,1;-96,1;75;255000
vpja19;26;255;379;116,3;-120,8;124;255000
vpja19;26;394;651;135,8;-120,1;257;255000
vpja19;26;689;758;68;-21,5;69;2,55e+08
vpja19;26;785;900;118,3;-83,6999999999999;115;2,55e+08
vpja19;26;922;1281;128,5;-126,7;359;255000
vpja19;26;1435;1553;143,7;-138,4;118;255000
vpja19;26;1610;1700;-133,9;218,3;90;255255000
vpja19;26;1719;1799;-125,9;259,6;80;255255000
vpja19;26;1855;2053;389,7;326,1;198;255
vpja19;26;2076;2607;429,8;310,1;531;255
vpja19;26;2641;2723;325,3;362;82;255
vpja19;26;2740;2958;302,1;389,3;218;255
vpja19;26;2999;3129;459,8;304,1;130;255
vpja19;26;3201;3355;-112,5;289,3;154;255255000
vpja19;26;3387;3613;-217,1;279,8;226;255255000
vpja19;26;3642;3790;-148,6;350,7;148;255255000
vpja19;26;3818;3969;-60,4;302,1;151;255255000
vpja19;26;4181;4323;356,1;292,7;142;255
vpja19;26;4345;4697;418,6;297,6;352;255
vpja19;26;4712;5423;446,7;307,3;711;255
vpja19;26;5447;5632;513,5;340,7;185;255
vpja19;26;5680;5840;380,9;161,1;160;0
vpja19;26;5854;5972;392,7;136,9;118;0
vpja19;26;6029;6054;110,4;-90,5;25;2,55e+08
vpja19;26;6212;6375;115,9;-162,8;163;255000
vpja19;26;6386;6621;128,1;-139,8;235;255000
vpja19;26;6646;6783;204,9;-155,4;137;0
vpja19;26;6806;7094;137;-133,5;288;255000
vpja19;26;7125;7160;34,6;-133,3;35;0
vpja19;26;7191;7344;125,3;-138,1;153;255000
vpja19;26;7414;7830;-379,2;-53,8;416;0
vpja19;26;7854;8148;-294,9;-64,5999999999999;294;0
vpja19;26;8165;8384;-273,8;-84,1999999999999;219;0
vpja19;26;8402;8595;-308,7;-59,1999999999999;193;0
vpja19;26;8632;8747;-436,3;10,8000000000001;115;0
vpja19;26;8924;9025;-579,5;85,7;101;0
vpja19;26;9054;9184;-550,6;184,5;130;0
vpja19;26;9245;9483;-498,3;-197,6;238;0
vpja19;26;9524;9585;-353,8;-239,3;61;0
vpja19;26;9642;9767;98,7;-229,3;125;255000
vpja19;26;9795;9935;110;-146,6;140;255000
vpja19;26;9952;10000;118;-113,3;48;255000
