vp;trial;timest;timeend;x;y;duration;roi
vpja18;1;281;476;-15,7000000000002;-242,9;195;255000
vpja18;1;493;833;-29,7000000000002;-269,1;340;255000
vpja18;1;851;1125;-9,60000000000014;-270,2;274;255000
vpja18;1;1179;1290;-250,6;-42,3000000000001;111;0
vpja18;1;1313;1445;-231,3;-89,5000000000001;132;0
vpja18;1;1485;1785;-208,5;105,2;300;255
vpja18;1;1805;1909;-175,2;113,8;104;255
vpja18;1;1973;2112;331,1;141,5;139;255255000
vpja18;1;2139;2357;433,4;104,8;218;0
vpja18;1;2397;2741;573,6;-2,30000000000007;344;0
vpja18;1;2827;3042;-334,5;-10,8000000000001;215;0
vpja18;1;3101;3274;-537,5;69,0999999999999;173;0
vpja18;1;3307;3533;-586;154;226;0
vpja18;1;3583;3774;-245,4;-104,2;191;0
vpja18;1;3798;4122;-209,9;-126,8;324;0
vpja18;1;4129;4297;-214,3;-116,7;168;0
vpja18;1;4342;4836;1,99999999999989;-286,1;494;255000
vpja18;1;4845;5033;0,499999999999886;-287,2;188;255000
vpja18;1;5073;5377;50,8999999999999;-113,6;304;2,55e+08
vpja18;1;5427;5635;-215,4;107,4;208;255
vpja18;1;5700;5971;330,5;137,4;271;255255000
vpja18;1;5998;6320;411,6;118,4;322;0
vpja18;1;6352;6625;274,8;188,1;273;255255000
vpja18;1;6702;6888;-209,8;126,3;186;255
vpja18;1;6933;7234;-226,5;-97,5000000000001;301;0
vpja18;1;7263;7365;-200,5;-53,9000000000001;102;0
vpja18;1;7444;7692;545,6;-29,1;248;0
vpja18;1;7730;7973;429,9;-131,4;243;0
vpja18;1;8021;8222;391,2;-331,8;201;0
vpja18;1;8287;8496;-81,6000000000001;-357,4;209;0
vpja18;1;8559;8816;-442;-167,9;257;0
vpja18;1;8869;9060;-524,2;-4,60000000000002;191;0
vpja18;1;9100;9536;-565,6;143,4;436;0
vpja18;1;9578;9758;-366,3;127;180;0
vpja18;1;9768;9856;-383,4;123,2;88;0
vpja18;1;9903;9999;-479,2;382,7;96;0
vpja18;2;285;395;-144,7;-174,3;110;2,55e+08
vpja18;2;416;778;-182,3;-194,8;362;255000
vpja18;2;825;949;-19,4;-283,9;124;0
vpja18;2;990;1279;-186,1;-185,5;289;255000
vpja18;2;1324;1498;-12,4;-349,8;174;0
vpja18;2;1557;1724;367,1;-50,1999999999999;167;255255000
vpja18;2;1776;1923;371,6;166,3;147;0
vpja18;2;1956;2240;349,9;281,2;284;0
vpja18;2;2263;2459;299,2;280,8;196;0
vpja18;2;2505;2774;343,1;97,4000000000001;269;0
vpja18;2;2827;3044;4,20000000000005;58,6;217;0
vpja18;2;3109;3352;-426,9;340,5;243;255
vpja18;2;3378;3599;-416,5;398,3;221;0
vpja18;2;3634;3834;-544,1;362,8;200;0
vpja18;2;3863;3987;-443,4;284,6;124;255
vpja18;2;4027;4254;-499,4;116,1;227;0
vpja18;2;4276;4466;-487,6;156,6;190;0
vpja18;2;4499;4699;-500,4;59,5;200;0
vpja18;2;4716;5088;-465,6;66;372;0
vpja18;2;5137;5281;-368;-152,5;144;0
vpja18;2;5307;5684;-377,9;-236,9;377;0
vpja18;2;5732;5939;-8;-379,6;207;0
vpja18;2;5996;6163;-380,4;-222,2;167;0
vpja18;2;6179;6580;-393,2;-222,5;401;0
vpja18;2;6628;6803;-158,6;-210,6;175;255000
vpja18;2;6853;7015;-379,5;-208;162;0
vpja18;2;7056;7211;-407;-31,6999999999999;155;0
vpja18;2;7260;7536;-332,1;-273,7;276;0
vpja18;2;7585;7808;-472,9;21,6;223;0
vpja18;2;7832;8007;-489,7;54,5;175;0
vpja18;2;8026;8262;-463,6;80,2;236;0
vpja18;2;8290;8439;-482,7;165,4;149;0
vpja18;2;8517;8685;311,1;228,3;168;0
vpja18;2;8741;8951;332,6;-84,4999999999999;210;255255000
vpja18;2;8982;9179;236,8;22,9000000000001;197;0
vpja18;2;9200;9429;269,6;35,8000000000001;229;0
vpja18;2;9487;9671;13,8000000000001;-45;184;0
vpja18;2;9712;9786;255,2;44;74;0
vpja18;2;9861;10000;-40,6999999999999;-368,4;139;0
vpja18;3;229;458;20,1999999999999;-177,1;229;255000
vpja18;3;471;775;38,4;-167,2;304;255000
vpja18;3;789;1123;52,1999999999999;-165;334;255000
vpja18;3;1178;1518;249,2;210,7;340;0
vpja18;3;1541;1734;273,9;165,6;193;255
vpja18;3;1808;2023;-292,8;188,3;215;255255000
vpja18;3;2087;2374;245,7;185,4;287;255
vpja18;3;2457;2832;-317,8;154,4;375;0
vpja18;3;2897;3257;-393,8;-216,1;360;0
vpja18;3;3308;3443;-116,9;-289,8;135;0
vpja18;3;3490;3613;79,1;-190,7;123;0
vpja18;3;3679;3893;578,5;-34;214;0
vpja18;3;3956;4125;42,8;-152,6;169;255000
vpja18;3;4176;4308;273,7;106,8;132;0
vpja18;3;4362;4617;50,4;-168,5;255;255000
vpja18;3;4628;4824;54;-180,7;196;255000
vpja18;3;4862;5053;253,4;-220,5;191;0
vpja18;3;5079;5210;210,7;-288,6;131;0
vpja18;3;5277;5492;-356,1;-246,2;215;0
vpja18;3;5545;5757;-552,1;4,39999999999998;212;0
vpja18;3;5789;5908;-375,4;47,6999999999999;119;0
vpja18;3;5967;6089;16;-158,1;122;255000
vpja18;3;6112;6545;48,5;-191,6;433;255000
vpja18;3;6579;6745;53,4;-81,9;166;2,55e+08
vpja18;3;6779;7012;61,8;-180,2;233;255000
vpja18;3;7025;7416;40,6999999999999;-194,5;391;255000
vpja18;3;7429;7751;60,9;-184,4;322;255000
vpja18;3;7817;8065;-292,4;179,1;248;255255000
vpja18;3;8138;8259;364,5;163,9;121;0
vpja18;3;8298;8417;547,2;91;119;0
vpja18;3;8468;8856;245,5;183,5;388;255
vpja18;3;8912;9115;-276,9;157,4;203;255255000
vpja18;3;9197;9374;-434,3;-88,8;177;0
vpja18;3;9410;9539;-609,2;2,5;129;0
vpja18;3;9635;9854;465,8;-73,7;219;0
vpja18;3;9882;10000;555,8;-67,5;118;0
vpja18;4;222;336;-41,1;-308,9;114;255000
vpja18;4;366;683;-67,2;-385,2;317;255000
vpja18;4;699;1024;-41,3000000000001;-391,6;325;255000
vpja18;4;1046;1489;-52,9000000000001;-369,5;443;255000
vpja18;4;1506;1683;-23,6;-392;177;255000
vpja18;4;1696;2077;-29,5;-411,8;381;255000
vpja18;4;2161;2318;-486,5;264,5;157;0
vpja18;4;2362;2563;-477,5;392,3;201;0
vpja18;4;2645;2849;378,1;279,2;204;0
vpja18;4;2887;2999;554,3;363,1;112;255255000
vpja18;4;3073;3116;-4,90000000000009;-275,9;43;2,55e+08
vpja18;4;3152;3288;-51,8000000000001;-351,9;136;255000
vpja18;4;3310;3479;-51,4000000000001;-395,5;169;255000
vpja18;4;3536;3736;-379,7;-285;200;0
vpja18;4;3815;4042;-500,9;396,6;227;255
vpja18;4;4067;4489;-485,3;445,1;422;255
vpja18;4;4501;4676;-466,4;447,1;175;255
vpja18;4;4759;5205;414,4;356,5;446;255255000
vpja18;4;5249;5525;271,7;273,7;276;255255000
vpja18;4;5610;5914;-505,2;434,6;304;0
vpja18;4;6016;6272;-336,1;-230,1;256;0
vpja18;4;6318;6442;-61,8000000000001;-372,2;124;255000
vpja18;4;6512;6664;-462,8;-345,8;152;0
vpja18;4;6705;6851;-290;-379,1;146;0
vpja18;4;6906;7274;-547,2;-330,9;368;0
vpja18;4;7317;7581;-254,2;-313,1;264;0
vpja18;4;7630;7738;16,9;-295,1;108;2,55e+08
vpja18;4;7780;7957;250,9;-257,5;177;0
vpja18;4;7995;8150;295,7;-83,1;155;0
vpja18;4;8204;8431;398,3;-304,6;227;0
vpja18;4;8481;8619;-38,3000000000001;-378;138;255000
vpja18;4;8692;8794;544,6;-241,1;102;0
vpja18;4;8831;9097;356,5;-331,1;266;0
vpja18;4;9113;9388;377,4;-357,7;275;0
vpja18;4;9429;9689;232,9;-332,1;260;0
vpja18;4;9715;9970;258;-267,4;255;0
vpja18;5;209;416;58,6;-31,8000000000001;207;255000
vpja18;5;426;910;59,1999999999999;-18,5;484;255000
vpja18;5;960;1135;85,4999999999999;-226,8;175;0
vpja18;5;1186;1390;-186,4;-250,9;204;0
vpja18;5;1464;1671;-552,5;192,8;207;0
vpja18;5;1684;1800;-567,2;185,8;116;0
vpja18;5;1850;2040;-294,3;-26,6;190;0
vpja18;5;2083;2237;-57,4;158,8;154;0
vpja18;5;2261;2399;5,69999999999993;171,2;138;255255000
vpja18;5;2426;2819;-34,1;106,9;393;255255000
vpja18;5;2850;2997;49,4999999999999;-16,7;147;255000
vpja18;5;3013;3218;68,4;-39,9000000000001;205;255000
vpja18;5;3259;3876;-14,3000000000001;-181,6;617;0
vpja18;5;3894;4087;6,89999999999998;-178,2;193;0
vpja18;5;4134;4335;336,4;-146,1;201;0
vpja18;5;4346;4512;316,6;-151,4;166;0
vpja18;5;4542;4826;409,5;-163,7;284;0
vpja18;5;4841;5007;413,1;-138,7;166;0
vpja18;5;5060;5263;326,4;202;203;0
vpja18;5;5283;5631;294,5;182,7;348;255
vpja18;5;5647;5826;319,5;184;179;255
vpja18;5;5880;6061;-3,20000000000005;141,7;181;255255000
vpja18;5;6086;6112;-32,9;77,9;26;255255000
vpja18;5;6160;6423;289,7;113,8;263;0
vpja18;5;6446;6609;293,2;159,8;163;255
vpja18;5;6671;6845;357;-166,6;174;0
vpja18;5;6868;7078;299,7;-176,9;210;0
vpja18;5;7132;7271;13,6;-43,9000000000001;139;255000
vpja18;5;7293;7584;51,1999999999999;-52,9000000000001;291;255000
vpja18;5;7632;7871;242,8;-232,6;239;0
vpja18;5;7908;8238;83,4;-282,5;330;0
vpja18;5;8309;8549;533,3;-283,7;240;0
vpja18;5;8581;8739;409,5;-187,1;158;0
vpja18;5;8786;9100;530,6;-445;314;0
vpja18;5;9191;9423;-271,3;-295,2;232;0
vpja18;5;9495;9622;-528,9;90,5999999999999;127;0
vpja18;5;9647;9951;-564,3;163,6;304;0
vpja18;6;211;386;72,5073943661971;-131,394014084507;175;255000
vpja18;6;398;713;80,6073943661972;-107,494014084507;315;255000
vpja18;6;770;1027;-240,992605633803;253,805985915493;257;255255000
vpja18;6;1058;1166;-159,392605633803;295,505985915493;108;255255000
vpja18;6;1220;1422;354,507394366197;381,905985915493;202;255
vpja18;6;1446;1528;386,307394366197;429,905985915493;82;255
vpja18;6;1607;2053;-227,692605633803;-254,094014084507;446;0
vpja18;6;2111;2268;-466,692605633803;-127,994014084507;157;0
vpja18;6;2336;2507;130,607394366197;-187,094014084507;171;0
vpja18;6;2579;2748;397,207394366197;329,405985915493;169;255
vpja18;6;2775;2976;382,407394366197;422,905985915493;201;255
vpja18;6;3002;3251;420,707394366197;381,505985915493;249;255
vpja18;6;3262;3452;430,207394366197;397,605985915493;190;255
vpja18;6;3474;3557;389,107394366197;432,205985915493;83;255
vpja18;6;3599;3856;386,507394366197;216,005985915493;257;0
vpja18;6;3922;4079;-152,292605633803;334,005985915493;157;255255000
vpja18;6;4108;4220;-40,7926056338029;334,505985915493;112;255255000
vpja18;6;4284;4414;444,907394366197;279,405985915493;130;0
vpja18;6;4464;4645;65,4073943661972;-109,194014084507;181;255000
vpja18;6;4665;5151;90,2073943661971;-112,294014084507;486;255000
vpja18;6;5186;5495;52,6073943661972;23,105985915493;309;2,55e+08
vpja18;6;5517;5739;35,9073943661972;63,4059859154929;222;2,55e+08
vpja18;6;5766;6066;135,207394366197;48,705985915493;300;2,55e+08
vpja18;6;6112;6257;301,907394366197;98,605985915493;145;0
vpja18;6;6289;6506;395,207394366197;174,705985915493;217;0
vpja18;6;6523;6643;370,607394366197;157,405985915493;120;0
vpja18;6;6673;6897;443,607394366197;260,205985915493;224;0
vpja18;6;6916;7034;472,207394366197;274,105985915493;118;0
vpja18;6;7086;7575;175,107394366197;-133,294014084507;489;0
vpja18;6;7635;7803;556,007394366197;-92,894014084507;168;0
vpja18;6;7853;8013;448,407394366197;184,305985915493;160;0
vpja18;6;8036;8209;393,807394366197;178,605985915493;173;0
vpja18;6;8241;8517;468,307394366197;275,405985915493;276;0
vpja18;6;8555;8783;390,807394366197;164,805985915493;228;0
vpja18;6;8826;9130;217,007394366197;-70,794014084507;304;0
vpja18;6;9165;9288;324,907394366197;-89,194014084507;123;0
vpja18;6;9352;9553;-96,5926056338028;279,005985915493;201;255255000
vpja18;6;9610;9842;357,907394366197;385,005985915493;232;255
vpja18;6;9864;10000;394,507394366197;418,905985915493;136;255
vpja18;7;93;193;-10,1443298969073;-8,70618556701027;100;0
vpja18;7;244;354;44,6556701030927;-319,60618556701;110;255000
vpja18;7;375;945;8,95567010309264;-341,20618556701;570;255000
vpja18;7;1007;1177;-420,644329896907;-290,40618556701;170;0
vpja18;7;1226;1342;-178,344329896907;-215,60618556701;116;0
vpja18;7;1396;1597;-445,344329896907;-292,90618556701;201;0
vpja18;7;1667;1862;148,555670103093;-278,90618556701;195;0
vpja18;7;1919;2048;470,155670103093;-124,40618556701;129;0
vpja18;7;2095;2252;314,655670103093;203,99381443299;157;255255000
vpja18;7;2280;2523;364,255670103093;271,59381443299;243;255255000
vpja18;7;2624;2820;-339,344329896907;76,6938144329897;196;255
vpja18;7;2879;3078;-159,744329896907;-168,70618556701;199;0
vpja18;7;3132;3300;32,0556701030927;-347,80618556701;168;255000
vpja18;7;3350;3598;-144,444329896907;-223,70618556701;248;0
vpja18;7;3618;3720;-120,444329896907;-205,50618556701;102;0
vpja18;7;3749;3947;-210,544329896907;-257,50618556701;198;0
vpja18;7;3956;4107;-202,544329896907;-252,80618556701;151;0
vpja18;7;4154;4365;-431,544329896907;-424,90618556701;211;0
vpja18;7;4426;4557;10,7556701030927;-320,30618556701;131;2,55e+08
vpja18;7;4576;4759;13,3556701030927;-358,90618556701;183;255000
vpja18;7;4769;5216;5,05567010309267;-358,90618556701;447;255000
vpja18;7;5287;5501;-296,144329896907;63,9938144329897;214;255
vpja18;7;5540;5663;-388,844329896907;196,89381443299;123;0
vpja18;7;5737;5890;296,955670103093;245,69381443299;153;255255000
vpja18;7;5915;6083;354,055670103093;284,39381443299;168;255255000
vpja18;7;6148;6376;500,655670103093;-114,40618556701;228;0
vpja18;7;6401;6801;509,755670103093;-186,00618556701;400;0
vpja18;7;6827;7081;566,755670103093;-229,10618556701;254;0
vpja18;7;7120;7287;368,555670103093;-196,30618556701;167;0
vpja18;7;7322;7474;512,855670103093;-219,60618556701;152;0
vpja18;7;7527;7889;136,455670103093;-335,80618556701;362;0
vpja18;7;7910;8088;156,855670103093;-364,60618556701;178;0
vpja18;7;8133;8291;-110,244329896907;-353,20618556701;158;0
vpja18;7;8338;8599;79,8556701030927;-287,70618556701;261;255000
vpja18;7;8679;8937;-393,344329896907;-239,30618556701;258;0
vpja18;7;8974;9045;-435,144329896907;-324,30618556701;71;0
vpja18;7;9102;9388;119,255670103093;-375,80618556701;286;0
vpja18;7;9424;9581;138,455670103093;-267,20618556701;157;0
vpja18;7;9637;9815;-176,844329896907;-227,90618556701;178;0
vpja18;7;9837;10000;-143,644329896907;-198,90618556701;163;0
vpja18;8;318;442;-292,050126452954;-152,059282258026;124;255000
vpja18;8;466;1080;-259,750126452954;-149,959282258026;614;255000
vpja18;8;1139;1310;-109,950126452954;322,040717741974;171;255255000
vpja18;8;1367;1816;261,149873547046;58,5407177419736;449;255
vpja18;8;1837;1993;300,649873547046;40,5407177419736;156;255
vpja18;8;2021;2267;258,249873547046;121,040717741974;246;255
vpja18;8;2344;2505;-492,950126452954;-210,559282258026;161;0
vpja18;8;2531;2743;-556,450126452954;-305,459282258026;212;0
vpja18;8;2761;2876;-530,350126452954;-302,259282258026;115;0
vpja18;8;2917;3079;-273,650126452953;-162,159282258026;162;255000
vpja18;8;3100;3628;-242,850126452954;-158,559282258026;528;255000
vpja18;8;3672;3866;-308,750126452954;59,3407177419737;194;2,55e+08
vpja18;8;3922;4145;91,4498735470464;-135,259282258026;223;0
vpja18;8;4208;4462;500,649873547046;-94,4592822580263;254;0
vpja18;8;4517;4633;108,049873547047;-157,859282258026;116;0
vpja18;8;4659;4873;17,9498735470464;-176,359282258026;214;0
vpja18;8;4916;5114;-241,850126452954;-181,959282258026;198;255000
vpja18;8;5137;5316;-199,850126452954;-170,159282258026;179;0
vpja18;8;5332;5741;-220,150126452953;-195,959282258026;409;255000
vpja18;8;5769;5963;-144,450126452954;-138,259282258026;194;0
vpja18;8;5999;6332;45,4498735470464;-175,159282258026;333;0
vpja18;8;6373;6505;-117,750126452954;-201,459282258026;132;0
vpja18;8;6552;6788;149,549873547047;-391,859282258026;236;0
vpja18;8;6844;7010;394,949873547046;-85,8592822580264;166;0
vpja18;8;7051;7263;594,649873547046;-74,1592822580263;212;0
vpja18;8;7283;7517;544,049873547047;-67,2592822580264;234;0
vpja18;8;7566;7749;610,849873547047;130,140717741974;183;0
vpja18;8;7806;8015;212,749873547046;81,7407177419736;209;0
vpja18;8;8075;8346;-123,250126452954;321,540717741974;271;255255000
vpja18;8;8406;8798;272,249873547046;77,2407177419736;392;255
vpja18;8;8853;9005;-45,9501264529536;231,040717741974;152;0
vpja18;8;9068;9213;-282,750126452954;-173,159282258026;145;255000
vpja18;8;9236;9936;-245,250126452954;-154,759282258026;700;255000
vpja18;9;218;365;75,1;-191,5;147;255000
vpja18;9;381;617;63,5;-199,8;236;255000
vpja18;9;632;993;82,4999999999999;-191,4;361;255000
vpja18;9;1054;1218;378,3;243,1;164;255
vpja18;9;1242;1601;330,2;282,8;359;255
vpja18;9;1621;1906;367,6;292,1;285;0
vpja18;9;1933;2183;275,7;271,3;250;255
vpja18;9;2220;2463;404,7;224,7;243;0
vpja18;9;2490;2640;312,6;222,7;150;255
vpja18;9;2711;2952;-351,3;204,9;241;255255000
vpja18;9;2977;3184;-302,4;158,1;207;255255000
vpja18;9;3236;3506;78,9;-191,7;270;255000
vpja18;9;3554;3830;52,6;47,6999999999999;276;2,55e+08
vpja18;9;3849;4044;8;18,6999999999999;195;2,55e+08
vpja18;9;4088;4476;58;-211,1;388;255000
vpja18;9;4495;4726;76,4999999999999;-196,8;231;255000
vpja18;9;4792;4912;358,7;193,1;120;255
vpja18;9;4978;5186;95,9999999999999;-178,2;208;255000
vpja18;9;5211;5401;65,9999999999999;-221,6;190;255000
vpja18;9;5413;5546;82,4;-209;133;255000
vpja18;9;5613;5906;-402,6;-14,7;293;0
vpja18;9;5939;6097;-453,9;-26,9000000000001;158;0
vpja18;9;6118;6311;-413,6;-28,8000000000001;193;0
vpja18;9;6333;6632;-423,4;-83,2;299;0
vpja18;9;6674;6875;-520,2;39,3;201;0
vpja18;9;6910;7135;-426,1;-72,4000000000001;225;0
vpja18;9;7161;7400;-395,8;-28,9000000000001;239;0
vpja18;9;7414;7778;-375,7;-25,7;364;0
vpja18;9;7805;8048;-312,3;4,09999999999991;243;0
vpja18;9;8062;8450;-327,8;9,5;388;0
vpja18;9;8468;8697;-349,4;14,1999999999999;229;0
vpja18;9;8712;9154;-317,1;7,09999999999991;442;0
vpja18;9;9192;9367;-317,4;193,1;175;255255000
vpja18;9;9420;9567;-466,6;-4,40000000000009;147;0
vpja18;9;9592;9824;-403,3;-48,7;232;0
vpja18;9;9907;10000;310,3;177,4;93;255
vpja18;10;227;371;-26,1;-252,4;144;255000
vpja18;10;395;773;2,70000000000005;-289;378;255000
vpja18;10;843;1041;264,5;356,3;198;0
vpja18;10;1061;1168;292,2;333,4;107;0
vpja18;10;1249;1471;-514,6;365,1;222;255255000
vpja18;10;1492;1585;-472;377,3;93;255255000
vpja18;10;1645;1936;-44,9;-37,8;291;2,55e+08
vpja18;10;1990;2229;10,5;-293;239;255000
vpja18;10;2247;2542;29,9;-314,7;295;255000
vpja18;10;2587;2698;-68,1;-146,4;111;2,55e+08
vpja18;10;2722;2899;-59;-96,9;177;2,55e+08
vpja18;10;2958;3418;272,1;-109,8;460;0
vpja18;10;3462;3779;416,6;71,1;317;0
vpja18;10;3816;4063;567,7;2,10000000000002;247;0
vpja18;10;4153;4327;-392,3;-251,1;174;0
vpja18;10;4410;4549;453,5;-341,5;139;0
vpja18;10;4572;4914;494,2;-349;342;0
vpja18;10;4933;5233;478,8;-318,3;300;0
vpja18;10;5244;5603;467,7;-314,6;359;0
vpja18;10;5627;5947;516,4;-342,4;320;0
vpja18;10;5989;6101;300,3;-371;112;0
vpja18;10;6143;6405;274,1;-151,7;262;0
vpja18;10;6425;6673;278;-106,9;248;0
vpja18;10;6718;6926;502,9;67,2;208;0
vpja18;10;6954;7207;581,9;20;253;0
vpja18;10;7218;7421;567,6;-1,69999999999993;203;0
vpja18;10;7453;7781;535,6;83,4;328;0
vpja18;10;7814;8033;568,4;52,2;219;0
vpja18;10;8066;8536;416,8;51,1;470;0
vpja18;10;8548;8890;431,9;34,3000000000001;342;0
vpja18;10;8928;9261;584,5;10,3000000000001;333;0
vpja18;10;9286;9586;549,9;80,1;300;0
vpja18;10;9605;9882;572,2;102;277;0
vpja18;10;9902;10000;536,8;84,1;98;0
vpja18;11;226;328;75,2917293233085;-298,070676691729;102;255000
vpja18;11;349;616;41,0917293233084;-316,570676691729;267;255000
vpja18;11;675;952;-194,208270676692;86,7293233082706;277;255
vpja18;11;1009;1226;43,4917293233084;-293,170676691729;217;255000
vpja18;11;1246;1654;37,3917293233084;-320,470676691729;408;255000
vpja18;11;1722;1872;313,891729323308;59,6293233082706;150;0
vpja18;11;1947;2229;-190,508270676692;38,8293233082707;282;255
vpja18;11;2294;2423;50,9917293233084;-286,570676691729;129;255000
vpja18;11;2447;3234;51,6917293233083;-334,770676691729;787;255000
vpja18;11;3243;3541;64,6917293233083;-333,470676691729;298;255000
vpja18;11;3556;4027;48,5917293233084;-328,670676691729;471;255000
vpja18;11;4107;4345;-146,808270676692;0,829323308270659;238;255
vpja18;11;4408;4805;62,1917293233083;-335,170676691729;397;255000
vpja18;11;4825;5038;65,0917293233084;-309,470676691729;213;255000
vpja18;11;5091;5441;119,491729323308;-24,3706766917294;350;0
vpja18;11;5520;5643;23,8917293233084;-305,270676691729;123;0
vpja18;11;5661;6144;60,3917293233084;-322,170676691729;483;255000
vpja18;11;6156;6500;45,5917293233084;-315,170676691729;344;255000
vpja18;11;6553;6719;-104,808270676692;-1,27067669172936;166;255
vpja18;11;6751;7342;-183,908270676692;87,6293233082706;591;255
vpja18;11;7405;7609;263,891729323308;127,529323308271;204;255255000
vpja18;11;7636;7734;338,191729323308;82,8293233082707;98;255255000
vpja18;11;7799;8095;-153,708270676692;68,6293233082706;296;255
vpja18;11;8133;8288;-41,6082706766916;36,0293233082706;155;0
vpja18;11;8332;8484;197,891729323308;80,5293233082706;152;0
vpja18;11;8545;8843;532,191729323308;64,7293233082706;298;0
vpja18;11;8926;9051;52,7917293233085;-199,570676691729;125;2,55e+08
vpja18;11;9113;9330;-349,308270676692;47,0293233082706;217;0
vpja18;11;9362;9541;-460,008270676692;115,429323308271;179;0
vpja18;11;9584;9762;-164,008270676692;35,5293233082706;178;255
vpja18;11;9827;10000;286,491729323308;124,729323308271;173;255255000
vpja18;12;198;245;-29,5;-264,4;47;255000
vpja18;12;282;372;2,19999999999993;-305,7;90;255000
vpja18;12;383;641;-12,7;-286,6;258;255000
vpja18;12;652;812;-2,80000000000007;-279,4;160;255000
vpja18;12;868;1223;293,4;104,8;355;255
vpja18;12;1284;1428;-329,7;159,1;144;0
vpja18;12;1451;1719;-372,9;137,4;268;255255000
vpja18;12;1801;1904;250,5;82,3;103;255
vpja18;12;1953;2154;-22,3000000000001;-274,1;201;255000
vpja18;12;2167;2729;-5,60000000000002;-285,1;562;255000
vpja18;12;2769;2918;64,4999999999999;-164;149;2,55e+08
vpja18;12;2974;3299;268,5;64,3;325;255
vpja18;12;3373;3718;-325,1;134,7;345;255255000
vpja18;12;3796;4128;262,8;91,5;332;255
vpja18;12;4195;4311;73,1;438,7;116;0
vpja18;12;4444;4660;-34,4;-270,5;216;255000
vpja18;12;4757;4874;519,4;-5,20000000000005;117;0
vpja18;12;4921;5145;307,7;93,6999999999999;224;255
vpja18;12;5234;5470;-314,9;126,5;236;255255000
vpja18;12;5544;5766;179,3;67,6;222;0
vpja18;12;5837;6163;519,1;-157,6;326;0
vpja18;12;6206;6390;235,7;0,600000000000023;184;0
vpja18;12;6440;6625;-2,70000000000005;-275,5;185;255000
vpja18;12;6655;7085;19,6;-293,9;430;255000
vpja18;12;7148;7292;-214,8;85,3;144;0
vpja18;12;7320;7423;-321,8;105,4;103;0
vpja18;12;7492;7775;269,5;90,9;283;255
vpja18;12;7838;8043;-14,4;-255,9;205;255000
vpja18;12;8066;8637;5,29999999999995;-304,6;571;255000
vpja18;12;8715;8963;580,3;-133,5;248;0
vpja18;12;9001;9137;591,3;-61,6;136;0
vpja18;12;9191;9452;599;-266,6;261;0
vpja18;12;9517;9797;8;-283;280;255000
vpja18;12;9878;9927;-351,2;205;49;0
vpja18;13;214;678;-109,6;-166;464;255000
vpja18;13;689;974;-108,1;-158,8;285;255000
vpja18;13;994;1345;-132,6;-160,9;351;255000
vpja18;13;1359;1486;-109,8;-162,1;127;255000
vpja18;13;1545;1800;-287,2;147,1;255;0
vpja18;13;1823;2152;-261,2;130,9;329;0
vpja18;13;2200;2441;61,5000000000001;144,6;241;0
vpja18;13;2467;2725;128,7;143,8;258;0
vpja18;13;2783;2938;-272;133;155;0
vpja18;13;2986;3147;-80,5;-159,5;161;255000
vpja18;13;3168;3313;-112,2;-168,6;145;255000
vpja18;13;3364;3637;100,5;120,5;273;0
vpja18;13;3659;3840;50,7;134,3;181;0
vpja18;13;3870;4171;135,4;140,9;301;0
vpja18;13;4218;4385;360,2;-6,5;167;0
vpja18;13;4410;4560;351,5;-57,1;150;0
vpja18;13;4609;4737;611,5;-145,2;128;0
vpja18;13;4764;4997;593,4;-220,5;233;0
vpja18;13;5008;5252;611,9;-233,5;244;0
vpja18;13;5317;5620;594;303,7;303;0
vpja18;13;5690;5823;595,8;-160;133;0
vpja18;13;5853;6111;606;-229;258;0
vpja18;13;6183;6594;-92,6999999999999;-178,6;411;255000
vpja18;13;6637;6818;-101;-10,1;181;2,55e+08
vpja18;13;6866;7039;-112,8;144,9;173;0
vpja18;13;7077;7360;81,1;139,8;283;0
vpja18;13;7410;7619;-264,4;132,5;209;0
vpja18;13;7668;7827;-79,4;-137,7;159;2,55e+08
vpja18;13;7848;8099;-116,5;-170;251;255000
vpja18;13;8149;8527;72,1;127,3;378;0
vpja18;13;8583;8688;330;-36,2;105;0
vpja18;13;8747;9072;-90,4;-177,2;325;255000
vpja18;13;9089;9453;-106,3;-169,4;364;255000
vpja18;13;9513;9729;111,8;113,7;216;0
vpja18;13;9776;10000;345,1;-17,1;224;0
vpja18;14;201;362;-72;-102,2;161;255000
vpja18;14;371;609;-102;-100,8;238;0
vpja18;14;616;1000;-101,4;-98,5;384;0
vpja18;14;1050;1335;-67,9;-368,1;285;0
vpja18;14;1464;1649;183,9;161,7;185;0
vpja18;14;1728;1938;-468;155,4;210;255
vpja18;14;2005;2391;152,3;97,5;386;255255000
vpja18;14;2417;2568;212,9;103,7;151;255255000
vpja18;14;2610;2915;327,1;-11,3000000000001;305;0
vpja18;14;2937;3196;286;-26,7;259;0
vpja18;14;3228;3461;319,7;134;233;0
vpja18;14;3490;3775;361,4;56,9;285;0
vpja18;14;3849;3997;-169,5;136,2;148;2,55e+08
vpja18;14;4053;4383;-456,7;170,1;330;255
vpja18;14;4396;4557;-446,6;140,7;161;255
vpja18;14;4581;4759;-390,9;143,4;178;255
vpja18;14;4786;4923;-452,9;133,2;137;255
vpja18;14;4993;5119;-440,8;-206,7;126;0
vpja18;14;5168;5343;-432,2;-385,8;175;0
vpja18;14;5401;5644;-452,4;-95,2;243;0
vpja18;14;5690;5978;-246;49,1;288;0
vpja18;14;6022;6180;-150,1;133;158;2,55e+08
vpja18;14;6223;6370;-36,8;-35,1;147;2,55e+08
vpja18;14;6395;7226;-73,2;-114,5;831;255000
vpja18;14;7280;7562;-86,7;-370,4;282;0
vpja18;14;7594;7761;-75,9;-281,1;167;0
vpja18;14;7798;8112;-79,1;-391,5;314;0
vpja18;14;8163;8243;5,20000000000005;-258,9;80;0
vpja18;14;8302;8467;-495,4;-137,4;165;0
vpja18;14;8488;8605;-465;-123,6;117;0
vpja18;14;8654;8801;-423,7;-381,9;147;0
vpja18;14;8844;9061;-460,8;-113,1;217;0
vpja18;14;9104;9270;-456,4;4,29999999999995;166;0
vpja18;14;9314;9544;-425,3;133,3;230;255
vpja18;14;9570;9694;-365,6;140,9;124;255
vpja18;14;9760;10000;142,9;104,1;240;255255000
vpja18;15;222;339;-224,1;-177,6;117;255000
vpja18;15;359;576;-276;-174,4;217;0
vpja18;15;584;810;-273,1;-168,1;226;0
vpja18;15;878;1131;-405;314,3;253;255
vpja18;15;1160;1435;-460,1;382;275;255
vpja18;15;1479;1770;-152,7;401,9;291;0
vpja18;15;1846;2018;-269,8;-189,3;172;0
vpja18;15;2031;2486;-266,1;-175,7;455;0
vpja18;15;2510;2643;-232,3;-165,3;133;255000
vpja18;15;2702;2890;-242,5;128,1;188;2,55e+08
vpja18;15;2940;3161;-229,2;-105,9;221;2,55e+08
vpja18;15;3200;3371;-275,1;-163,7;171;0
vpja18;15;3446;3584;-419,7;365,3;138;255
vpja18;15;3686;3862;187,1;-124,9;176;0
vpja18;15;3905;4060;341;-277,8;155;0
vpja18;15;4129;4335;-86,3;-175,7;206;0
vpja18;15;4361;4589;-6,89999999999998;-198,3;228;0
vpja18;15;4600;5117;10,1;-210,9;517;0
vpja18;15;5128;5174;-7,70000000000005;-216,2;46;0
vpja18;15;5216;5470;-130;-169;254;0
vpja18;15;5496;5757;-64,9;-175,8;261;0
vpja18;15;5804;6043;-372,8;-280,4;239;0
vpja18;15;6108;6394;-597,3;-76,7;286;0
vpja18;15;6447;6693;-402,3;-271,7;246;0
vpja18;15;6765;7050;-361,6;188,4;285;0
vpja18;15;7101;7251;-577,2;66,9;150;0
vpja18;15;7286;7392;-615,6;-6,79999999999995;106;0
vpja18;15;7446;7738;-562;-266,7;292;0
vpja18;15;7827;7960;-411;396;133;0
vpja18;15;7992;8106;-452,8;334,2;114;255
vpja18;15;8159;8449;-145,8;378,8;290;255255000
vpja18;15;8525;9336;-263,5;-184,7;811;0
vpja18;15;9386;9640;-161,9;59,8;254;2,55e+08
vpja18;15;9683;9848;-253;159;165;2,55e+08
vpja18;15;9906;10000;-230,5;-173,5;94;255000
vpja18;16;228;334;-437,150126452953;-159,759282258026;106;255000
vpja18;16;352;949;-449,550126452954;-111,659282258026;597;255000
vpja18;16;957;1266;-448,250126452954;-96,8592822580264;309;255000
vpja18;16;1308;1440;-283,150126452953;43,4407177419737;132;255255000
vpja18;16;1482;1932;27,2498735470465;85,0407177419736;450;255
vpja18;16;1998;2139;-470,550126452954;-95,2592822580264;141;255000
vpja18;16;2156;2488;-458,450126452954;-114,959282258026;332;255000
vpja18;16;2532;2813;-193,450126452954;-223,259282258026;281;0
vpja18;16;2869;3116;-287,350126452954;102,540717741974;247;255255000
vpja18;16;3154;3288;-342,050126452954;34,6407177419736;134;0
vpja18;16;3327;3627;-456,450126452954;-126,359282258026;300;255000
vpja18;16;3650;3746;-420,950126452954;-104,959282258026;96;255000
vpja18;16;3810;3990;4,04987354704645;94,2407177419736;180;255
vpja18;16;4020;4183;95,7498735470464;49,6407177419736;163;255
vpja18;16;4249;4489;485,849873547047;-141,059282258026;240;0
vpja18;16;4545;4648;538,549873547047;-403,659282258026;103;0
vpja18;16;4721;4884;-8,65012645295349;55,8407177419737;163;255
vpja18;16;4959;5160;-442,750126452954;-104,559282258026;201;255000
vpja18;16;5179;5729;-425,350126452954;-125,859282258026;550;255000
vpja18;16;5788;5999;2,64987354704647;93,2407177419736;211;255
vpja18;16;6074;6258;-427,150126452953;-117,959282258026;184;255000
vpja18;16;6296;6568;-267,950126452954;68,8407177419737;272;255255000
vpja18;16;6624;7222;-428,850126452954;-122,159282258026;598;255000
vpja18;16;7290;7635;39,2498735470465;83,7407177419736;345;255
vpja18;16;7681;7890;-249,150126452953;158,340717741974;209;255255000
vpja18;16;7928;8081;-306,450126452954;58,9407177419737;153;255255000
vpja18;16;8105;8382;-271,750126452954;72,5407177419736;277;255255000
vpja18;16;8425;8562;-99,9501264529536;98,2407177419736;137;0
vpja18;16;8612;9049;-303,450126452954;80,2407177419736;437;255255000
vpja18;16;9233;9673;-273,950126452954;85,7407177419736;440;255255000
vpja18;16;9722;9934;-56,3501264529535;85,9407177419737;212;0
vpja18;16;9963;10000;49,2498735470465;60,4407177419737;37;255
vpja18;17;217;322;-179,2;-185,7;105;2,55e+08
vpja18;17;346;648;-218,4;-198,5;302;255000
vpja18;17;655;878;-219,1;-190,1;223;2,55e+08
vpja18;17;928;1104;-74,5;80,5;176;255
vpja18;17;1149;1377;-71,6;334;228;0
vpja18;17;1385;1543;-83;335,1;158;0
vpja18;17;1587;1861;-36,9;159,7;274;255
vpja18;17;1898;2125;-34,4;45,7;227;255
vpja18;17;2179;2323;297,2;-54;144;0
vpja18;17;2386;2664;-215,8;-196,6;278;255000
vpja18;17;2674;2844;-210,3;-205,8;170;255000
vpja18;17;2890;3068;-231;15,3000000000001;178;2,55e+08
vpja18;17;3115;3211;-213,9;-194,3;96;255000
vpja18;17;3283;3569;367,8;-374,2;286;0
vpja18;17;3612;3764;581,6;-346,5;152;0
vpja18;17;3835;4076;272,7;-77,8;241;0
vpja18;17;4120;4255;434,5;-22,5999999999999;135;0
vpja18;17;4300;4445;625,9;-123;145;0
vpja18;17;4502;4688;537,3;174,2;186;0
vpja18;17;4751;4878;51,5;120,4;127;0
vpja18;17;4913;5014;-38,6;33,8000000000001;101;255
vpja18;17;5092;5471;-498,7;76,6;379;255255000
vpja18;17;5494;5614;-451,1;69,5;120;255255000
vpja18;17;5669;5810;-83,9;29,3000000000001;141;255
vpja18;17;5880;6084;-442,9;81,4000000000001;204;255255000
vpja18;17;6146;6387;-188,8;-186,7;241;2,55e+08
vpja18;17;6456;6683;-473,7;76,8000000000001;227;255255000
vpja18;17;6710;7115;-421,5;94,8000000000001;405;255255000
vpja18;17;7134;7292;-441,3;64,4000000000001;158;255255000
vpja18;17;7313;7656;-397,3;66,5;343;255255000
vpja18;17;7695;7984;-466;138,6;289;255255000
vpja18;17;8016;8215;-414,7;-22,9;199;0
vpja18;17;8238;8451;-473,1;-15,8;213;0
vpja18;17;8503;8637;-472,5;228,8;134;0
vpja18;17;8678;8820;-408,4;89,5;142;255255000
vpja18;17;8890;9138;-24,8;55,5;248;255
vpja18;17;9189;9402;-205,9;-172;213;2,55e+08
vpja18;17;9421;9918;-206,9;-212,1;497;255000
vpja18;17;9954;10000;-206,2;-93,4;46;2,55e+08
vpja18;18;212;416;-78,3000000000001;-179,4;204;255000
vpja18;18;433;573;-76,8000000000001;-192,9;140;255000
vpja18;18;596;878;-95,2;-122,2;282;255000
vpja18;18;905;1170;-71;-197,5;265;255000
vpja18;18;1225;1320;232,1;187,9;95;0
vpja18;18;1350;1769;256,1;267,2;419;0
vpja18;18;1789;1867;289,6;259;78;0
vpja18;18;1913;2076;-67,5;262,7;163;2,55e+08
vpja18;18;2095;2262;-48,1;241,9;167;2,55e+08
vpja18;18;2307;2489;-157,3;320,6;182;255255000
vpja18;18;2510;2682;-170,6;343,4;172;0
vpja18;18;2702;2852;-139;350,7;150;255255000
vpja18;18;2909;3204;245,9;252,6;295;0
vpja18;18;3270;3477;-162,5;327,7;207;255255000
vpja18;18;3559;3753;243,5;249,3;194;0
vpja18;18;3827;3963;-89,2;-180,1;136;255000
vpja18;18;3989;4195;-48,2;-208,2;206;255000
vpja18;18;4233;4432;-112;-54,5999999999999;199;2,55e+08
vpja18;18;4461;4595;-167,8;-3,29999999999995;134;2,55e+08
vpja18;18;4639;4944;-56,8000000000001;-179,5;305;255000
vpja18;18;5010;5186;-74,5;235,1;176;2,55e+08
vpja18;18;5209;5354;-28,4000000000001;223,5;145;2,55e+08
vpja18;18;5395;5612;-167,6;-15,4;217;2,55e+08
vpja18;18;5654;5851;-115,7;226,7;197;2,55e+08
vpja18;18;5906;6093;-188,4;-20;187;2,55e+08
vpja18;18;6138;6350;-61,3000000000001;-184,7;212;255000
vpja18;18;6384;6571;-202,3;-212,7;187;255000
vpja18;18;6593;6736;-187,3;-184,7;143;255000
vpja18;18;6798;7108;-531,2;-40,3;310;0
vpja18;18;7166;7354;-409,4;196,6;188;2,55e+08
vpja18;18;7428;7799;121,2;188,9;371;0
vpja18;18;7848;8114;-127,9;296,3;266;255255000
vpja18;18;8139;8307;-53,9000000000001;243,3;168;2,55e+08
vpja18;18;8328;8553;-28,8000000000001;225,4;225;2,55e+08
vpja18;18;8582;8885;-119,3;248,2;303;2,55e+08
vpja18;18;8937;9099;-81,2;-147,2;162;255000
vpja18;18;9123;9273;-43,8000000000001;-173,4;150;255000
vpja18;18;9340;9466;274;207,6;126;0
vpja18;18;9491;9703;261,8;235,4;212;255
vpja18;18;9725;9949;295;246,3;224;0
vpja18;19;230;466;-101,250126452954;-144,559282258026;236;255000
vpja18;19;474;905;-99,5501264529536;-147,159282258026;431;255000
vpja18;19;918;1057;-86,9501264529536;-147,759282258026;139;255000
vpja18;19;1105;1365;124,149873547046;-335,259282258026;260;0
vpja18;19;1393;1608;69,6498735470465;-368,059282258026;215;0
vpja18;19;1642;1867;-34,0501264529536;-404,059282258026;225;0
vpja18;19;1945;2077;48,4498735470464;199,440717741974;132;255
vpja18;19;2101;2161;-25,3501264529535;154,740717741974;60;255
vpja18;19;2226;2395;-297,450126452954;189,640717741974;169;0
vpja18;19;2419;2558;-256,050126452954;181,040717741974;139;0
vpja18;19;2582;2726;-278,750126452954;197,340717741974;144;0
vpja18;19;2749;2893;-250,150126452953;175,340717741974;144;0
vpja18;19;2948;3117;-91,0501264529536;-124,859282258026;169;255000
vpja18;19;3134;3475;-90,9501264529536;-151,259282258026;341;255000
vpja18;19;3505;3693;-67,4501264529536;-119,759282258026;188;2,55e+08
vpja18;19;3748;3905;-1,05012645295358;117,840717741974;157;255
vpja18;19;3964;4175;-95,7501264529535;-157,059282258026;211;255000
vpja18;19;4190;4478;-81,6501264529535;-149,459282258026;288;255000
vpja18;19;4489;4758;-88,9501264529536;-155,759282258026;269;255000
vpja18;19;4778;4948;-75,3501264529535;-153,359282258026;170;255000
vpja18;19;4993;5209;102,549873547047;-330,959282258026;216;0
vpja18;19;5245;5557;-9,75012645295351;-394,159282258026;312;0
vpja18;19;5601;5822;88,3498735470465;-325,159282258026;221;0
vpja18;19;5882;6084;-48,2501264529535;-55,7592822580264;202;2,55e+08
vpja18;19;6137;6295;20,0498735470464;156,240717741974;158;255
vpja18;19;6362;6561;-269,050126452954;188,140717741974;199;0
vpja18;19;6585;6880;-229,750126452954;167,840717741974;295;0
vpja18;19;6931;7164;-403,850126452954;45,8407177419737;233;0
vpja18;19;7184;7319;-426,050126452954;19,3407177419737;135;0
vpja18;19;7365;7569;-399,650126452953;-152,659282258026;204;0
vpja18;19;7620;7865;-369,150126452953;-2,45928225802641;245;0
vpja18;19;7892;8006;-427,950126452954;22,0407177419736;114;0
vpja18;19;8044;8176;-117,650126452953;-123,859282258026;132;2,55e+08
vpja18;19;8200;8491;-78,9501264529536;-160,559282258026;291;255000
vpja18;19;8564;8994;-452,950126452954;-108,259282258026;430;0
vpja18;19;9016;9187;-456,550126452954;-145,659282258026;171;0
vpja18;19;9212;9511;-413,650126452953;-215,159282258026;299;0
vpja18;19;9548;9736;-425,050126452954;-47,5592822580263;188;0
vpja18;19;9833;10000;330,949873547046;23,9407177419737;167;0
vpja18;20;206;481;-312,7;-200,7;275;255000
vpja18;20;502;746;-320,5;-210;244;255000
vpja18;20;760;948;-304,2;-211,1;188;255000
vpja18;20;1022;1228;173,5;210,8;206;255
vpja18;20;1295;1595;-350,2;426,1;300;255255000
vpja18;20;1627;1742;-390,7;381,2;115;255255000
vpja18;20;1824;2008;-297,3;-185,2;184;255000
vpja18;20;2027;2330;-297,8;-220,7;303;255000
vpja18;20;2347;2815;-298,4;-204,7;468;255000
vpja18;20;2878;3067;-277,8;98,6999999999999;189;2,55e+08
vpja18;20;3132;3367;219,3;189,4;235;255
vpja18;20;3389;3675;175,4;199,8;286;255
vpja18;20;3765;4191;441,8;-173,6;426;0
vpja18;20;4258;4440;149,4;208,8;182;255
vpja18;20;4514;4661;-331,6;415,1;147;255255000
vpja18;20;4749;5043;-317,7;-196,2;294;255000
vpja18;20;5065;5336;-282,6;-221,2;271;255000
vpja18;20;5412;5643;183,6;218,5;231;255
vpja18;20;5666;5873;202,9;196,8;207;255
vpja18;20;5955;6186;-383,1;427,1;231;255255000
vpja18;20;6204;6816;-361,4;389,9;612;255255000
vpja18;20;6925;7097;432,3;-142;172;0
vpja18;20;7121;7447;441,3;-184,3;326;0
vpja18;20;7492;7687;273,3;-56,3;195;0
vpja18;20;7785;8197;-563,3;-110,2;412;2,55e+08
vpja18;20;8243;8376;-309,3;-218,1;133;255000
vpja18;20;8458;8760;276;-31,4;302;0
vpja18;20;8798;9155;317,7;-112,4;357;0
vpja18;20;9197;9429;284,4;5,39999999999998;232;0
vpja18;20;9446;9677;308,1;6,10000000000002;231;0
vpja18;20;9705;10000;295,8;71,6999999999999;295;0
vpja18;21;219;589;156,4;-202,2;370;255000
vpja18;21;603;868;132;-197,8;265;255000
vpja18;21;907;1088;119,5;-50,8;181;2,55e+08
vpja18;21;1129;1439;154,4;-218,7;310;255000
vpja18;21;1453;1645;145,4;-205,3;192;255000
vpja18;21;1716;1913;199,1;256,7;197;255
vpja18;21;1945;2080;241;179,7;135;255
vpja18;21;2149;2333;119;-196,1;184;255000
vpja18;21;2356;2746;158,4;-211;390;255000
vpja18;21;2814;2927;210,8;196,4;113;255
vpja18;21;3008;3151;-372,9;116,1;143;255255000
vpja18;21;3201;3541;148,2;-200;340;255000
vpja18;21;3560;3949;155,7;-220,7;389;255000
vpja18;21;3965;4029;133;-210,5;64;255000
vpja18;21;4112;4366;-395,4;95,5;254;255255000
vpja18;21;4391;4488;-440,2;138,7;97;255255000
vpja18;21;4559;4843;143,5;-231,8;284;255000
vpja18;21;4857;5060;146,2;-207,4;203;255000
vpja18;21;5128;5227;191,1;259,3;99;255
vpja18;21;5310;5545;-427,9;151,7;235;255255000
vpja18;21;5635;5888;135,2;-138,3;253;255000
vpja18;21;5916;6204;166,2;-206,7;288;255000
vpja18;21;6224;6417;131,8;-212,8;193;255000
vpja18;21;6480;6593;248,9;73,2;113;0
vpja18;21;6652;6981;160,8;-221,6;329;255000
vpja18;21;7064;7224;235,1;192,6;160;255
vpja18;21;7310;7532;-418,3;116,5;222;255255000
vpja18;21;7606;7773;144,7;-206;167;255000
vpja18;21;7852;8068;-461,4;198,9;216;255255000
vpja18;21;8145;8404;130,7;159,4;259;255
vpja18;21;8437;8581;255,6;151,2;144;255
vpja18;21;8642;8909;119,4;-210;267;255000
vpja18;21;8932;9392;151;-236,9;460;255000
vpja18;21;9448;9624;427,2;-374;176;0
vpja18;21;9696;9861;52,1;-398,3;165;0
vpja18;21;9907;10000;-125,8;-363,5;93;0
vpja18;22;88;183;-13,8575757575757;6,06666666666672;95;2,55e+08
vpja18;22;237;384;-7,85757575757566;-256,733333333333;147;255000
vpja18;22;402;875;-39,2575757575756;-272,333333333333;473;255000
vpja18;22;943;1227;463,742424242424;-47,5333333333333;284;0
vpja18;22;1237;1434;471,842424242424;-30,6333333333333;197;0
vpja18;22;1483;1665;167,442424242424;-11,2333333333333;182;0
vpja18;22;1724;1942;-241,857575757576;36,2666666666667;218;255
vpja18;22;1965;2088;-204,157575757576;-16,3333333333334;123;255
vpja18;22;2121;2392;-33,1575757575756;-55,4333333333333;271;255255000
vpja18;22;2445;2578;-16,2575757575756;-309,933333333333;133;255000
vpja18;22;2595;3132;-33,2575757575756;-294,133333333333;537;255000
vpja18;22;3194;3626;-225,257575757576;-34,9333333333333;432;255
vpja18;22;3681;3838;-460,957575757576;-21,4333333333333;157;0
vpja18;22;3870;4024;-573,157575757576;-34,1333333333333;154;0
vpja18;22;4050;4155;-533,657575757576;-146,833333333333;105;0
vpja18;22;4213;4430;-225,957575757576;-23,9333333333333;217;255
vpja18;22;4453;4670;-198,857575757576;-44,7333333333333;217;0
vpja18;22;4713;5070;-51,4575757575756;-70,4333333333333;357;255255000
vpja18;22;5096;5284;-30,8575757575757;-22,5333333333333;188;255255000
vpja18;22;5335;5569;-226,357575757576;-8,93333333333328;234;255
vpja18;22;5617;5746;-49,7575757575756;-73,9333333333333;129;255255000
vpja18;22;5795;6024;-241,957575757576;-21,6333333333333;229;255
vpja18;22;6069;6348;-81,0575757575756;-53,6333333333333;279;255255000
vpja18;22;6380;6662;-49,3575757575757;-83,1333333333333;282;255255000
vpja18;22;6713;7058;-229,257575757576;-28,8333333333334;345;255
vpja18;22;7154;7402;270,142424242424;-25,2333333333333;248;0
vpja18;22;7419;7595;286,742424242424;-47,1333333333333;176;0
vpja18;22;7635;7695;164,242424242424;-50,0333333333333;60;0
vpja18;22;7767;7947;-225,157575757576;-214,433333333333;180;0
vpja18;22;7983;8109;-108,557575757576;-251,033333333333;126;0
vpja18;22;8137;8315;-14,1575757575756;-291,433333333333;178;255000
vpja18;22;8327;8572;-32,9575757575756;-291,333333333333;245;255000
vpja18;22;8614;8695;-202,657575757576;-249,133333333333;81;0
vpja18;22;8762;8949;280,742424242424;-261,333333333333;187;0
vpja18;22;8999;9447;163,742424242424;-31,1333333333333;448;0
vpja18;22;9478;9701;297,342424242424;-27,1333333333333;223;0
vpja18;22;9737;9931;508,342424242424;-20,9333333333333;194;0
vpja18;22;9956;10000;433,742424242424;-15,5333333333333;44;0
vpja18;23;33;213;-456,9;79;180;0
vpja18;23;283;316;-59,9;-184,9;33;2,55e+08
vpja18;23;356;631;-48,4;-278;275;255000
vpja18;23;647;972;-26,8;-268,7;325;255000
vpja18;23;992;1248;-41;-231,1;256;255000
vpja18;23;1321;1486;448,3;224,7;165;255
vpja18;23;1507;1708;434,2;182,7;201;255
vpja18;23;1735;1877;436;260,9;142;255
vpja18;23;1959;2205;-418,8;247,9;246;255255000
vpja18;23;2229;2381;-384,7;265,1;152;255255000
vpja18;23;2453;2752;-19,5;-258;299;255000
vpja18;23;2808;2996;-76,9;22,6;188;2,55e+08
vpja18;23;3046;3360;-25,3;-293;314;255000
vpja18;23;3374;3608;-39,8;-282,9;234;255000
vpja18;23;3635;3734;0,600000000000023;-253,7;99;255000
vpja18;23;3808;3987;421,7;193,5;179;255
vpja18;23;4009;4202;448,7;164,7;193;255
vpja18;23;4226;4462;441;244,4;236;255
vpja18;23;4485;4695;448,2;288,1;210;255
vpja18;23;4725;5031;467,2;204,2;306;255
vpja18;23;5118;5304;-324;262,4;186;255255000
vpja18;23;5340;5504;-393;244,7;164;255255000
vpja18;23;5558;5754;-7,10000000000002;-233;196;255000
vpja18;23;5775;5986;-20,3;-272,9;211;255000
vpja18;23;6045;6259;-49,2;58,4;214;2,55e+08
vpja18;23;6329;6584;-379,7;243,3;255;255255000
vpja18;23;6682;6785;222,3;262,1;103;0
vpja18;23;6824;7018;416,1;229,3;194;255
vpja18;23;7048;7276;451,3;158;228;255
vpja18;23;7305;7613;431,4;266,3;308;255
vpja18;23;7630;8120;448,5;284;490;255
vpja18;23;8155;8372;446,4;174;217;255
vpja18;23;8413;8548;261;131,5;135;0
vpja18;23;8602;8968;-21,7;-269,8;366;255000
vpja18;23;9036;9215;413,7;191,2;179;255
vpja18;23;9239;9354;454,9;145,3;115;255
vpja18;23;9433;9604;-26,4;-293,5;171;255000
vpja18;23;9619;10000;-18,3;-269,7;381;255000
vpja18;24;113;201;-64,5501264529536;16,2407177419736;88;0
vpja18;24;259;433;172,749873547046;-236,459282258026;174;255000
vpja18;24;456;831;133,049873547047;-263,859282258026;375;255000
vpja18;24;852;978;174,449873547046;-266,259282258026;126;255000
vpja18;24;1052;1160;158,949873547046;315,040717741974;108;255
vpja18;24;1226;1487;-352,250126452954;363,240717741974;261;255255000
vpja18;24;1521;1635;-394,350126452954;342,540717741974;114;255255000
vpja18;24;1688;1950;-425,650126452953;-119,459282258026;262;0
vpja18;24;2005;2271;-162,650126452953;-213,159282258026;266;0
vpja18;24;2333;2522;-482,750126452954;-230,159282258026;189;0
vpja18;24;2580;2694;-228,150126452953;82,9407177419737;114;0
vpja18;24;2750;3137;-391,250126452954;336,940717741974;387;255255000
vpja18;24;3206;3420;106,049873547047;353,940717741974;214;0
vpja18;24;3446;3607;163,349873547047;326,140717741974;161;255
vpja18;24;3687;3972;136,649873547046;-261,659282258026;285;255000
vpja18;24;3996;4265;180,349873547047;-278,659282258026;269;255000
vpja18;24;4291;4711;143,749873547046;-249,059282258026;420;255000
vpja18;24;4732;4880;165,849873547047;-257,859282258026;148;255000
vpja18;24;4898;5345;189,449873547046;-275,559282258026;447;255000
vpja18;24;5373;5631;134,649873547046;-248,559282258026;258;255000
vpja18;24;5694;5967;-227,650126452953;-174,259282258026;273;0
vpja18;24;6013;6324;-362,750126452954;-9,35928225802638;311;0
vpja18;24;6375;6567;-395,450126452954;287,140717741974;192;255255000
vpja18;24;6639;6907;174,449873547046;321,140717741974;268;255
vpja18;24;6930;7209;131,749873547046;320,240717741974;279;255
vpja18;24;7277;7714;-354,950126452954;316,740717741974;437;255255000
vpja18;24;7798;8003;456,549873547047;254,040717741974;205;0
vpja18;24;8089;8819;-377,750126452954;333,140717741974;730;255255000
vpja18;24;8876;9788;-215,050126452954;-83,2592822580264;912;0
vpja18;24;9859;10000;180,949873547046;244,740717741974;141;255
vpja18;25;228;434;-67,2;-88,5;206;255000
vpja18;25;446;627;-78,4;-95,7;181;255000
vpja18;25;683;892;-104,4;290;209;255255000
vpja18;25;905;983;-106,2;310,7;78;255255000
vpja18;25;1035;1247;-64,1;-93,4;212;255000
vpja18;25;1258;1401;-78,4;-106,8;143;255000
vpja18;25;1471;1766;-550,7;185,8;295;255
vpja18;25;1867;2036;-73,9;312,9;169;255255000
vpja18;25;2100;2264;-40,8000000000001;-106,8;164;255000
vpja18;25;2290;2622;-70,3000000000001;-111,2;332;255000
vpja18;25;2685;3020;-10,8000000000001;201;335;2,55e+08
vpja18;25;3050;3233;31;89,9;183;2,55e+08
vpja18;25;3252;3361;21,4;109,2;109;2,55e+08
vpja18;25;3410;3544;-64,9;-106,3;134;255000
vpja18;25;3594;3823;10,6999999999999;91,4;229;2,55e+08
vpja18;25;3845;4128;19,6;109,5;283;2,55e+08
vpja18;25;4182;4309;-30,2;-160;127;255000
vpja18;25;4336;4505;-80,9;-127;169;0
vpja18;25;4551;4783;108,2;-248;232;255000
vpja18;25;4855;5108;-92,2;310,1;253;255255000
vpja18;25;5136;5417;-73,1;264,3;281;255255000
vpja18;25;5438;5580;-42,2;288;142;255255000
vpja18;25;5605;5920;-79,9;312,4;315;255255000
vpja18;25;6002;6230;-517,9;210,3;228;255
vpja18;25;6254;6625;-548,5;181,9;371;255
vpja18;25;6684;6954;-92,5;331,9;270;255255000
vpja18;25;6988;7170;-71,2;275,6;182;255255000
vpja18;25;7274;7622;-77,2;-122,2;348;0
vpja18;25;7636;8008;-53,7;-119,4;372;255000
vpja18;25;8205;8553;-62,4;-111,5;348;255000
vpja18;25;8622;8958;-92,8000000000001;320,8;336;255255000
vpja18;25;9000;9211;-12,8000000000001;171,8;211;2,55e+08
vpja18;25;9276;9562;-61,8000000000001;-117,3;286;255000
vpja18;25;9592;9866;-88,1;-130,7;274;0
vpja18;25;9954;10000;-550,1;200,2;46;255
vpja18;26;225;366;2,20000000000005;-235,2;141;255000
vpja18;26;389;873;-5,10000000000002;-260;484;255000
vpja18;26;909;1191;-118,4;-368,9;282;0
vpja18;26;1212;1442;-83;-343,4;230;0
vpja18;26;1467;1637;-73,9;-427,1;170;0
vpja18;26;1665;1856;-71,1999999999999;-357,3;191;0
vpja18;26;1935;2057;274,2;124,5;122;0
vpja18;26;2079;2242;256,2;151,2;163;255255000
vpja18;26;2325;2598;-336,3;155;273;255
vpja18;26;2665;2819;-6,29999999999995;-229,3;154;255000
vpja18;26;2842;3308;-9;-273,4;466;255000
vpja18;26;3326;3474;-20,6999999999999;-267,2;148;255000
vpja18;26;3549;3720;-319,6;127,2;171;255
vpja18;26;3789;3914;21,1;-201,5;125;255000
vpja18;26;3941;4336;-4,10000000000002;-271,3;395;255000
vpja18;26;4351;4518;22,5;-275;167;255000
vpja18;26;4596;4821;-324,2;150,1;225;255
vpja18;26;4879;5063;127,4;48,9;184;2,55e+08
vpja18;26;5109;5401;288,7;156,3;292;255255000
vpja18;26;5425;5605;242,6;159,2;180;255255000
vpja18;26;5675;5793;16,2;-124,5;118;2,55e+08
vpja18;26;5834;6807;-13,8;-290,5;973;255000
vpja18;26;6830;7217;23,5;-279,3;387;255000
vpja18;26;7241;7795;-5,10000000000002;-277,8;554;255000
vpja18;26;7809;8186;7,80000000000007;-289;377;255000
vpja18;26;8249;8458;-13,8;-108;209;2,55e+08
vpja18;26;8534;8873;-67,1;-399,6;339;0
vpja18;26;8892;8993;-59,9;-375,3;101;0
vpja18;26;9048;9259;243,5;-370,9;211;0
vpja18;26;9286;9447;303;-423,8;161;0
vpja18;26;9454;9609;297,9;-426;155;0
vpja18;26;9669;9889;-50,9;-375;220;0
vpja18;26;9933;10000;1,89999999999998;-261,4;67;255000
