vp;trial;timest;timeend;x;y;duration;roi
vpja71;1;213;250;-25,1267148014441;-180,597472924188;37;255000
vpja71;1;288;479;-49,2267148014441;-245,997472924188;191;255000
vpja71;1;504;875;-91,5267148014441;-249,797472924188;371;255000
vpja71;1;949;1141;-536,326714801444;-128,997472924188;192;0
vpja71;1;1177;1431;-443,926714801444;-120,897472924188;254;0
vpja71;1;1461;1730;-441,426714801444;-83,5974729241877;269;0
vpja71;1;1789;1826;-420,826714801444;-267,697472924188;37;0
vpja71;1;1882;2075;-395,626714801444;-394,297472924188;193;0
vpja71;1;2144;2209;-459,626714801444;67,2025270758123;65;0
vpja71;1;2253;2544;-507,326714801444;180,302527075812;291;255
vpja71;1;2591;2796;-630,626714801444;136,202527075812;205;0
vpja71;1;2867;3000;-594,026714801444;-94,3974729241877;133;0
vpja71;1;3049;3114;-599,226714801444;-185,397472924188;65;0
vpja71;1;3171;3408;-597,726714801444;-369,397472924188;237;0
vpja71;1;3466;3546;-284,526714801444;-351,997472924188;80;0
vpja71;1;3604;3958;-75,326714801444;-240,197472924188;354;255000
vpja71;1;3984;4165;-76,826714801444;-152,497472924188;181;0
vpja71;1;4198;4296;-92,5267148014441;-118,897472924188;98;2,55e+08
vpja71;1;4358;4592;323,273285198556;123,902527075812;234;255255000
vpja71;1;4615;4786;316,773285198556;163,302527075812;171;255255000
vpja71;1;4809;4905;294,173285198556;156,002527075812;96;255255000
vpja71;1;4946;5159;378,773285198556;223,202527075812;213;255255000
vpja71;1;5166;5272;377,573285198556;228,702527075812;106;255255000
vpja71;1;5338;5498;535,273285198556;-60,6974729241878;160;0
vpja71;1;5555;5685;541,473285198556;-216,697472924188;130;0
vpja71;1;5719;5982;498,973285198556;-216,297472924188;263;0
vpja71;1;6019;6093;553,973285198556;-178,597472924188;74;0
vpja71;1;6177;6282;-32,1267148014441;-211,497472924188;105;255000
vpja71;1;6315;6638;-71,6267148014441;-224,097472924188;323;255000
vpja71;1;6658;6830;-81,5267148014441;-245,297472924188;172;255000
vpja71;1;6854;7233;-64,826714801444;-251,097472924188;379;255000
vpja71;1;7256;7491;-83,326714801444;-220,797472924188;235;255000
vpja71;1;7514;7815;-82,326714801444;-266,897472924188;301;255000
vpja71;1;7881;8157;-476,926714801444;-361,497472924188;276;0
vpja71;1;8197;8411;-555,826714801444;-346,197472924188;214;0
vpja71;1;8459;8570;-588,226714801444;-235,197472924188;111;0
vpja71;1;8608;8765;-597,926714801444;-158,197472924188;157;0
vpja71;1;8788;9297;-631,126714801444;-198,497472924188;509;0
vpja71;1;9331;9439;-617,226714801444;-150,697472924188;108;0
vpja71;1;9485;9567;-558,326714801444;-36,1974729241878;82;0
vpja71;1;9596;10000;-551,426714801444;-6,3974729241877;404;0
vpja71;2;204;237;-47,6999999999999;-52,9;33;2,55e+08
vpja71;2;297;386;-178,8;-213,9;89;255000
vpja71;2;410;775;-225,5;-238,7;365;0
vpja71;2;784;1101;-232,1;-239,5;317;0
vpja71;2;1150;1189;-117;-295,2;39;255000
vpja71;2;1234;1357;33,7;-291,7;123;0
vpja71;2;1391;1873;-22,8;-289,1;482;0
vpja71;2;1910;2149;-85;-247,2;239;0
vpja71;2;2168;2350;-95,8;-255,1;182;0
vpja71;2;2437;2514;-94,1;237,9;77;2,55e+08
vpja71;2;2552;2838;-116,9;306,8;286;255255000
vpja71;2;2908;3065;-494;301,8;157;0
vpja71;2;3110;3234;-646,7;279,1;124;NA
vpja71;2;3316;3441;-563,9;-202,7;125;0
vpja71;2;3499;3722;-605,4;-333,1;223;0
vpja71;2;3819;3922;320,3;-156,2;103;0
vpja71;2;3978;4085;398,8;8,5;107;0
vpja71;2;4156;4253;539,9;500,8;97;NA
vpja71;2;4277;4495;528,6;476,9;218;0
vpja71;2;4576;4734;253,2;-178,8;158;0
vpja71;2;4802;4901;262,5;-382,3;99;0
vpja71;2;4934;5293;310,4;-375,5;359;0
vpja71;2;5361;5536;-35,3;-283,1;175;0
vpja71;2;5559;5707;-18,6999999999999;-291;148;0
vpja71;2;5724;6043;-13,5;-305,1;319;0
vpja71;2;6086;6232;-20,9;-211;146;0
vpja71;2;6253;6325;-40,1999999999999;-234,3;72;0
vpja71;2;6385;6490;-234,8;-257,6;105;0
vpja71;2;6512;6655;-233,1;-242,3;143;0
vpja71;2;6707;7025;-200,7;-323,7;318;0
vpja71;2;7050;7112;-213;-312,1;62;255000
vpja71;2;7166;7360;-413,1;-377,7;194;0
vpja71;2;7433;7690;-392,3;15,1999999999999;257;0
vpja71;2;7752;7947;-249,4;-72,2;195;2,55e+08
vpja71;2;7976;8169;-232,4;-85,1;193;2,55e+08
vpja71;2;8201;8458;-193;-159,6;257;2,55e+08
vpja71;2;8504;8686;-196,4;-254,6;182;255000
vpja71;2;8709;9032;-216,6;-244,1;323;255000
vpja71;2;9057;9265;-216,2;-209,9;208;0
vpja71;2;9331;9490;-239,4;187,6;159;2,55e+08
vpja71;2;9530;9938;-315;185;408;0
vpja71;3;209;236;-181,9;-124,7;27;0
vpja71;3;289;385;-342,5;-144,6;96;255000
vpja71;3;405;704;-391,7;-172;299;255000
vpja71;3;762;969;-164,5;-275,3;207;0
vpja71;3;1019;1191;-368,6;-182,4;172;255000
vpja71;3;1223;1384;-399,9;-173,2;161;0
vpja71;3;1406;1517;-382,1;-144,9;111;255000
vpja71;3;1573;1706;-458,4;-357,5;133;0
vpja71;3;1739;1835;-492,2;-352,7;96;0
vpja71;3;1885;1977;-411,9;-476,4;92;0
vpja71;3;2048;2334;32,8;-441,1;286;0
vpja71;3;2416;2624;504,1;-370,3;208;0
vpja71;3;2679;2807;482,8;-183,3;128;0
vpja71;3;2839;3040;457,6;-168,8;201;0
vpja71;3;3092;3257;592,6;-224,8;165;0
vpja71;3;3324;3458;591,6;234,9;134;0
vpja71;3;3585;3776;-579,6;443,5;191;0
vpja71;3;3849;3947;-340,5;177,1;98;255
vpja71;3;3979;4189;-339,6;90,1;210;255
vpja71;3;4240;4392;-199,7;-9;152;2,55e+08
vpja71;3;4431;4585;-284,6;-49,2;154;2,55e+08
vpja71;3;4632;4909;-385,1;-175,3;277;255000
vpja71;3;4931;5186;-376,6;-133,7;255;255000
vpja71;3;5205;5368;-370,4;-168,7;163;255000
vpja71;3;5387;5615;-350,9;-172,8;228;255000
vpja71;3;5677;5853;-160,2;-257,6;176;0
vpja71;3;5873;6070;-185,5;-292,2;197;0
vpja71;3;6124;6250;-40,2;-387,3;126;0
vpja71;3;6274;6612;13,6;-426,6;338;0
vpja71;3;6634;6802;14,1999999999999;-402,1;168;0
vpja71;3;6866;7078;-228,9;-460,5;212;0
vpja71;3;7145;7271;-480,4;-262;126;0
vpja71;3;7330;7431;-640,2;-180,3;101;NA
vpja71;3;7461;7805;-672,3;-177,4;344;NA
vpja71;3;7867;7992;-403,8;-191,9;125;0
vpja71;3;8021;8290;-385,8;-175,1;269;255000
vpja71;3;8322;8709;-367,3;-149,8;387;255000
vpja71;3;8734;8927;-360;-172,2;193;255000
vpja71;3;8938;9220;-362,1;-188,2;282;255000
vpja71;3;9252;9473;-394,8;-182,1;221;0
vpja71;3;9528;9732;-350,5;63,9;204;2,55e+08
vpja71;3;9775;9985;-439,6;106,2;210;2,55e+08
vpja71;4;278;383;8,23886792452834;-353,224905660377;105;255000
vpja71;4;402;1032;-0,46113207547171;-368,424905660377;630;255000
vpja71;4;1105;1264;-410,461132075472;-314,824905660377;159;0
vpja71;4;1303;1524;-474,561132075472;-302,524905660377;221;0
vpja71;4;1551;1776;-386,561132075472;-352,624905660377;225;0
vpja71;4;1811;1886;-347,861132075472;-362,924905660377;75;0
vpja71;4;1954;2045;73,5388679245284;-403,224905660377;91;0
vpja71;4;2083;2292;11,9388679245283;-378,924905660377;209;255000
vpja71;4;2354;2439;32,8388679245284;-30,0249056603773;85;2,55e+08
vpja71;4;2485;2566;18,4388679245283;94,3750943396227;81;2,55e+08
vpja71;4;2599;2705;10,5388679245283;128,875094339623;106;2,55e+08
vpja71;4;2782;2874;11,5388679245283;-325,924905660377;92;255000
vpja71;4;2910;3204;-1,56113207547173;-366,024905660377;294;255000
vpja71;4;3227;3508;-2,76113207547166;-348,624905660377;281;0
vpja71;4;3528;3695;-2,06113207547173;-376,224905660377;167;255000
vpja71;4;3761;3957;466,338867924528;-270,724905660377;196;0
vpja71;4;3998;4182;488,338867924528;-185,424905660377;184;0
vpja71;4;4252;4355;120,938867924528;-304,724905660377;103;0
vpja71;4;4391;4529;32,9388679245283;-339,524905660377;138;255000
vpja71;4;4552;4988;16,8388679245284;-382,524905660377;436;255000
vpja71;4;5009;5120;10,8388679245284;-370,924905660377;111;255000
vpja71;4;5193;5335;-379,861132075472;-363,824905660377;142;0
vpja71;4;5375;5638;-458,761132075472;-415,224905660377;263;0
vpja71;4;5659;5928;-467,961132075472;-450,224905660377;269;0
vpja71;4;5957;6111;-447,461132075472;-457,624905660377;154;0
vpja71;4;6159;6459;-473,461132075472;-308,924905660377;300;0
vpja71;4;6503;6640;-588,461132075472;-348,924905660377;137;0
vpja71;4;6684;6785;-464,361132075472;-278,724905660377;101;0
vpja71;4;6870;7156;201,238867924528;-131,324905660377;286;0
vpja71;4;7223;7385;326,238867924528;245,975094339623;162;255255000
vpja71;4;7423;7628;374,738867924528;306,675094339623;205;255255000
vpja71;4;7698;8020;26,7388679245283;137,575094339623;322;2,55e+08
vpja71;4;8051;8151;-5,26113207547166;150,275094339623;100;2,55e+08
vpja71;4;8222;8426;47,2388679245282;-118,824905660377;204;2,55e+08
vpja71;4;8475;8665;-6,66113207547164;-187,724905660377;190;2,55e+08
vpja71;4;8690;8879;17,9388679245283;-263,224905660377;189;2,55e+08
vpja71;4;8952;9201;483,038867924528;-198,424905660377;249;0
vpja71;4;9252;9535;519,938867924528;-311,824905660377;283;0
vpja71;4;9559;9714;544,838867924528;-379,024905660377;155;0
vpja71;4;9762;10000;576,038867924528;-198,224905660377;238;0
vpja71;5;265;317;-351,3;-30,6;52;255000
vpja71;5;348;741;-418,9;-68,1;393;255000
vpja71;5;804;979;-376,6;289,4;175;0
vpja71;5;1048;1209;-416,6;-64,9;161;255000
vpja71;5;1232;1439;-400,2;-77;207;255000
vpja71;5;1469;1569;-407,3;-34,6;100;0
vpja71;5;1635;1726;-456,8;-262,8;91;0
vpja71;5;1761;1911;-596,8;-270,2;150;0
vpja71;5;1961;2163;-633,9;-409;202;0
vpja71;5;2177;2332;-622,9;-391,2;155;0
vpja71;5;2446;2625;487,4;-26,8;179;0
vpja71;5;2675;3009;510,2;-141,3;334;0
vpja71;5;3033;3321;514,4;-116,1;288;0
vpja71;5;3344;3510;514,2;-170,9;166;0
vpja71;5;3571;3722;447;47,3000000000001;151;0
vpja71;5;3785;4042;220,6;-18,6999999999999;257;0
vpja71;5;4088;4279;211,5;167,1;191;255255000
vpja71;5;4346;4479;63,6000000000001;-52,1;133;0
vpja71;5;4540;4803;-145,2;-75,3;263;0
vpja71;5;4829;5095;-258,5;-108,2;266;0
vpja71;5;5135;5382;-322,9;-213,5;247;0
vpja71;5;5443;5796;-373,1;325,3;353;0
vpja71;5;5849;5963;-506,6;203,1;114;0
vpja71;5;6016;6179;-669;154,9;163;NA
vpja71;5;6200;6616;-663,8;138,5;416;NA
vpja71;5;6680;6878;-626,7;-46,5;198;0
vpja71;5;6911;7064;-588,1;-10,8;153;0
vpja71;5;7126;7511;-391,7;-85,4;385;255000
vpja71;5;7541;7659;-418,7;-74,8;118;255000
vpja71;5;7692;8035;-398,1;-42,1999999999999;343;0
vpja71;5;8057;8237;-394,4;-80,6;180;255000
vpja71;5;8262;8525;-429,5;-81,6;263;0
vpja71;5;8562;8717;-489,6;-134;155;0
vpja71;5;8739;8899;-472,7;-140,1;160;0
vpja71;5;8945;9068;-593,8;-275,5;123;0
vpja71;5;9117;9356;-630,9;-404,4;239;0
vpja71;5;9378;9401;-613,8;-396;23;0
vpja71;5;9451;9656;-401,5;-397,1;205;0
vpja71;5;9719;9954;44,4000000000001;-351,3;235;0
vpja71;6;93;166;10,5;-3,70000000000005;73;0
vpja71;6;217;318;-62,4;-140,7;101;255000
vpja71;6;342;451;-69,8;-174,1;109;255000
vpja71;6;468;810;-75,3;-183;342;255000
vpja71;6;870;1048;16,3000000000001;-368,7;178;0
vpja71;6;1096;1381;104,5;-411,7;285;0
vpja71;6;1426;1558;-28,9;-373,6;132;0
vpja71;6;1616;1795;-60,4;-177;179;255000
vpja71;6;1868;2045;-426,6;-201,1;177;0
vpja71;6;2084;2287;-468,3;-142,4;203;0
vpja71;6;2330;2452;-460,2;-35,5;122;0
vpja71;6;2485;2811;-446,1;4,79999999999995;326;0
vpja71;6;2839;2995;-382,9;-25;156;0
vpja71;6;3019;3176;-348,8;-45,5;157;0
vpja71;6;3223;3459;-304,3;108,6;236;255255000
vpja71;6;3522;3843;-492,7;257,1;321;0
vpja71;6;3877;4005;-531,3;305,9;128;0
vpja71;6;4029;4435;-497,3;267,1;406;0
vpja71;6;4505;4635;-50;212,3;130;0
vpja71;6;4669;4883;-15,8;201,6;214;0
vpja71;6;4909;5095;58,4000000000001;189,4;186;0
vpja71;6;5168;5269;-81,5999999999999;-143,8;101;2,55e+08
vpja71;6;5300;5428;-76,5999999999999;-164,6;128;255000
vpja71;6;5448;5824;-70;-174,2;376;255000
vpja71;6;5848;6114;-68,3;-152,8;266;255000
vpja71;6;6137;6457;-69,5999999999999;-175,1;320;255000
vpja71;6;6481;6659;-56,9;-172,9;178;255000
vpja71;6;6727;6819;-245;244,2;92;0
vpja71;6;6864;7016;-217,7;380;152;0
vpja71;6;7045;7287;-241,9;397,4;242;0
vpja71;6;7311;7424;-233,2;384,3;113;0
vpja71;6;7451;7614;-151,9;337,5;163;0
vpja71;6;7636;8006;-135,6;317,2;370;0
vpja71;6;8047;8342;-46,0999999999999;333,9;295;0
vpja71;6;8366;8548;-58,3;341,9;182;0
vpja71;6;8614;8855;-338,2;384,5;241;0
vpja71;6;8894;9015;-271,8;424,1;121;0
vpja71;6;9048;9422;-224,5;385,9;374;0
vpja71;6;9542;9711;503,7;184,4;169;0
vpja71;6;9768;9920;576,7;39,1;152;0
vpja71;6;9964;10000;611,3;-26,8;36;0
vpja71;7;203;291;-11,1999999999999;-257,2;88;255000
vpja71;7;322;684;-27,4;-277,7;362;255000
vpja71;7;710;941;-18,8;-224,8;231;255000
vpja71;7;1002;1140;16,4000000000001;-407,1;138;0
vpja71;7;1190;1543;218,1;-387,9;353;0
vpja71;7;1592;1845;384,5;-371,5;253;0
vpja71;7;1886;1980;287,9;-357,9;94;0
vpja71;7;2049;2261;459;10,8;212;0
vpja71;7;2325;2515;152,6;43,9;190;0
vpja71;7;2597;2755;-415,5;113;158;0
vpja71;7;2779;2898;-428;136,8;119;255255000
vpja71;7;2963;3121;-141,8;41,5;158;2,55e+08
vpja71;7;3148;3368;-54,3;-51,4;220;2,55e+08
vpja71;7;3391;3498;-33,0999999999999;-106,1;107;2,55e+08
vpja71;7;3518;3842;-40,9;-126,9;324;2,55e+08
vpja71;7;3872;4060;4,5;-115,6;188;2,55e+08
vpja71;7;4085;4405;-39,9;-129,6;320;2,55e+08
vpja71;7;4455;4840;-24,3;-285,3;385;255000
vpja71;7;4872;5146;-4,89999999999998;-241,7;274;255000
vpja71;7;5217;5402;361,7;232,6;185;255
vpja71;7;5426;5878;346,2;182,1;452;255
vpja71;7;5919;6150;346,2;290,6;231;255
vpja71;7;6174;6540;355,8;268,3;366;255
vpja71;7;6643;6881;-484,4;220,1;238;255255000
vpja71;7;6914;7067;-461,1;204,6;153;255255000
vpja71;7;7090;7243;-465,3;145,5;153;255255000
vpja71;7;7283;7420;-392,1;205;137;255255000
vpja71;7;7459;7793;-444,9;275,5;334;255255000
vpja71;7;7872;7916;-553,4;-81,9;44;0
vpja71;7;7968;8140;-555,2;-218,9;172;0
vpja71;7;8194;8390;-500,4;41,9;196;0
vpja71;7;8437;8617;-424,1;196,6;180;255255000
vpja71;7;8654;8838;-365,4;208,1;184;255255000
vpja71;7;8934;9008;-65;-213,4;74;255000
vpja71;7;9051;9303;-39,1999999999999;-276,3;252;255000
vpja71;7;9312;9729;-43,1999999999999;-290;417;255000
vpja71;7;9755;9925;-22,8;-242,8;170;255000
vpja71;7;9932;10000;-24,5;-235,4;68;255000
vpja71;8;188;213;2,70000000000005;-169,1;25;2,55e+08
vpja71;8;267;448;-4,20000000000005;-298,5;181;255000
vpja71;8;470;710;-25;-293,5;240;255000
vpja71;8;775;930;-248,8;-119,6;155;0
vpja71;8;949;1107;-258,3;-110,9;158;0
vpja71;8;1165;1334;-255,5;125,7;169;255
vpja71;8;1368;1479;-225,3;123,3;111;255
vpja71;8;1545;1852;-261,6;-98,5;307;0
vpja71;8;1914;2141;-464,1;-259,9;227;0
vpja71;8;2177;2323;-510,2;-329;146;0
vpja71;8;2396;2634;-61,2;-383,2;238;0
vpja71;8;2668;2721;-101,2;-381,8;53;0
vpja71;8;2764;3132;-35,1;-299,9;368;255000
vpja71;8;3160;3268;-19,6;-302,4;108;255000
vpja71;8;3320;3421;-33;-393,7;101;0
vpja71;8;3466;3610;-29,7;-278,5;144;255000
vpja71;8;3633;3750;-23,2;-289,7;117;255000
vpja71;8;3771;4034;-8,60000000000002;-298,7;263;255000
vpja71;8;4068;4464;-17,3;-254,6;396;255000
vpja71;8;4483;4667;-18,7;-280,2;184;255000
vpja71;8;4688;4955;-27,9;-295,8;267;255000
vpja71;8;4986;5376;8,20000000000005;-295,3;390;255000
vpja71;8;5413;5669;-9,79999999999995;-241,8;256;255000
vpja71;8;5740;5943;313,5;135,5;203;255255000
vpja71;8;5990;6068;166,8;182,4;78;0
vpja71;8;6137;6238;324,6;-76,6;101;0
vpja71;8;6261;6712;293,3;-87,8;451;0
vpja71;8;6819;7012;423,6;192,6;193;255255000
vpja71;8;7035;7246;448,1;160,1;211;255255000
vpja71;8;7304;7395;550,4;12,6;91;0
vpja71;8;7489;7744;-217,3;111,9;255;255
vpja71;8;7775;7969;-242,6;134,4;194;255
vpja71;8;8044;8324;-658,9;196,9;280;NA
vpja71;8;8387;8574;-424;-14,6;187;0
vpja71;8;8623;8724;-299,7;-66;101;0
vpja71;8;8758;8953;-258,4;-83,3;195;0
vpja71;8;9024;9385;-15,8;-301;361;255000
vpja71;8;9436;10000;-23,7;-393,3;564;0
vpja71;9;205;239;18,8000000000001;-257,7;34;255000
vpja71;9;278;417;-33,9;-311,8;139;255000
vpja71;9;439;556;-64,6999999999999;-319,9;117;255000
vpja71;9;569;790;-84,3;-324,6;221;0
vpja71;9;818;989;-18,5999999999999;-328;171;255000
vpja71;9;1015;1238;-61;-277;223;255000
vpja71;9;1313;1523;368,6;186,4;210;0
vpja71;9;1573;1731;264,1;369,5;158;255255000
vpja71;9;1769;1918;177;339,5;149;255255000
vpja71;9;2005;2093;-444;279,3;88;0
vpja71;9;2139;2311;-562,3;244,9;172;255
vpja71;9;2330;2382;-554,7;220,6;52;255
vpja71;9;2431;2727;-375,5;140,1;296;0
vpja71;9;2811;2987;-388;-214,7;176;0
vpja71;9;3034;3171;-338,4;-277,1;137;0
vpja71;9;3218;3433;-242,9;-336,8;215;0
vpja71;9;3451;3699;-235,9;-359,3;248;0
vpja71;9;3757;4027;-12,0999999999999;-327,7;270;255000
vpja71;9;4053;4226;-65;-344,5;173;255000
vpja71;9;4248;5129;-79,5999999999999;-346,3;881;255000
vpja71;9;5207;5287;197,8;142,9;80;2,55e+08
vpja71;9;5329;5455;211,2;234,8;126;2,55e+08
vpja71;9;5491;5704;203,8;287,9;213;255255000
vpja71;9;5746;6123;308;364,4;377;0
vpja71;9;6157;6304;258,9;348,3;147;255255000
vpja71;9;6329;6612;200,6;299;283;255255000
vpja71;9;6656;6875;307;367,4;219;0
vpja71;9;6918;7097;257,6;476,1;179;255255000
vpja71;9;7171;7333;492,1;216,3;162;0
vpja71;9;7376;7509;445,9;176,1;133;0
vpja71;9;7659;7779;-514,5;241,3;120;255
vpja71;9;7815;8136;-571,1;221,3;321;0
vpja71;9;8155;8368;-557;215,5;213;255
vpja71;9;8407;8716;-485,3;253,8;309;255
vpja71;9;8768;8896;-518,9;123,6;128;255
vpja71;9;8944;9220;-351,6;121,9;276;0
vpja71;9;9284;9456;-348,9;-39,3;172;0
vpja71;9;9505;9745;-198,3;86;240;0
vpja71;9;9770;10000;-211,5;106,3;230;0
vpja71;10;208;274;43,8;-231,2;66;0
vpja71;10;312;415;102,7;-264,7;103;255000
vpja71;10;435;777;95,2;-285,7;342;255000
vpja71;10;856;1049;-398,5;14,5;193;255
vpja71;10;1123;1193;-344,5;-211,2;70;0
vpja71;10;1256;1382;-150,3;-276,5;126;0
vpja71;10;1437;1578;-141,4;-430,5;141;0
vpja71;10;1611;1776;-102,3;-432,4;165;0
vpja71;10;1810;1862;-77,5999999999999;-434,7;52;0
vpja71;10;1932;2153;417,4;-415,5;221;0
vpja71;10;2191;2404;375,3;-364,1;213;0
vpja71;10;2458;2575;236,4;-189,1;117;2,55e+08
vpja71;10;2617;2852;145,5;-114,2;235;2,55e+08
vpja71;10;2915;3240;81,8;-287,7;325;255000
vpja71;10;3313;3533;147,4;224,2;220;255255000
vpja71;10;3583;3784;225,1;150;201;255255000
vpja71;10;3842;4129;133,5;-59,9;287;2,55e+08
vpja71;10;4194;4313;83,9000000000001;-272,7;119;255000
vpja71;10;4334;4558;90,6000000000001;-287,6;224;255000
vpja71;10;4589;4869;76,2;-258,2;280;255000
vpja71;10;4896;5069;111,2;-294,7;173;255000
vpja71;10;5127;5221;-82,9;-397,6;94;0
vpja71;10;5244;5460;-123,1;-417,2;216;0
vpja71;10;5501;5743;-191,9;-358,2;242;0
vpja71;10;5812;5944;-469,5;-267;132;0
vpja71;10;6009;6142;-453,5;-3,70000000000005;133;0
vpja71;10;6185;6282;-445,2;89,6999999999999;97;255
vpja71;10;6345;6572;-329,8;299,8;227;0
vpja71;10;6632;6781;-466,8;92,4;149;255
vpja71;10;6804;6991;-454,1;81,8;187;255
vpja71;10;7065;7210;-366,5;-205,9;145;0
vpja71;10;7268;7402;-177,3;-185,8;134;0
vpja71;10;7443;7567;-78,5;-172,9;124;0
vpja71;10;7594;7767;-84,9;-255,8;173;0
vpja71;10;7795;8244;-117,9;-266,8;449;0
vpja71;10;8286;8462;-198,4;-264,1;176;0
vpja71;10;8494;8637;-229,5;-257,5;143;0
vpja71;10;8690;8872;-424,5;-342,4;182;0
vpja71;10;8935;9031;-212,5;-390,9;96;0
vpja71;10;9068;9228;-150;-417;160;0
vpja71;10;9254;9417;-98,8;-419,5;163;0
vpja71;10;9459;9624;-190,7;-402,7;165;0
vpja71;10;9674;9826;-28,4;-329,8;152;0
vpja71;10;9851;10000;-6,59999999999991;-339,4;149;0
vpja71;11;205;257;109,2;-123;52;255000
vpja71;11;293;415;120,6;-161,9;122;255000
vpja71;11;437;762;126,8;-165,7;325;255000
vpja71;11;782;1017;131,1;-146,5;235;255000
vpja71;11;1081;1283;-233,5;-285,1;202;0
vpja71;11;1307;1504;-222,6;-318,7;197;0
vpja71;11;1542;1671;-204,5;-395,1;129;0
vpja71;11;1714;1839;-291;-416,5;125;0
vpja71;11;1906;2063;-458,6;-95,7;157;0
vpja71;11;2097;2277;-489,7;-45,8000000000001;180;0
vpja71;11;2346;2532;-151,8;251,8;186;255255000
vpja71;11;2571;2688;-220,4;272,3;117;255255000
vpja71;11;2711;2970;-241;273,2;259;255255000
vpja71;11;3020;3127;-160,7;280,5;107;255255000
vpja71;11;3178;3327;-159;280,2;149;255255000
vpja71;11;3351;3552;-171,5;291,8;201;255255000
vpja71;11;3580;3860;-237,2;269,8;280;255255000
vpja71;11;3931;4062;383,3;142,4;131;0
vpja71;11;4094;4221;414,6;138,6;127;0
vpja71;11;4298;4595;-137,8;255,2;297;255255000
vpja71;11;4619;4831;-123,5;232,5;212;255255000
vpja71;11;4884;5068;-232,1;270,1;184;255255000
vpja71;11;5138;5260;142,7;-143,2;122;255000
vpja71;11;5285;5606;131,5;-167,4;321;255000
vpja71;11;5669;5794;345,6;319,2;125;255
vpja71;11;5834;5988;271,7;392,4;154;255
vpja71;11;6013;6306;240,1;394,6;293;255
vpja71;11;6362;6654;431,5;295;292;255
vpja71;11;6663;7125;433,8;305,6;462;255
vpja71;11;7174;7387;266,9;421,9;213;255
vpja71;11;7412;7757;228,6;394,4;345;255
vpja71;11;7782;8381;214,7;418,4;599;0
vpja71;11;8453;8576;394,5;153,1;123;0
vpja71;11;8608;8780;422,2;141,5;172;0
vpja71;11;8798;8995;428,8;126;197;0
vpja71;11;9053;9376;591,6;430,9;323;0
vpja71;11;9445;9571;447,7;162,6;126;255
vpja71;11;9596;9852;432,5;137,2;256;0
vpja71;11;9874;9959;419,4;133,1;85;0
vpja71;12;201;242;26,2;-223;41;255000
vpja71;12;273;344;11,8;-240,5;71;255000
vpja71;12;365;581;-11,1;-252,7;216;255000
vpja71;12;599;765;-36,5;-251,5;166;255000
vpja71;12;827;859;-362,4;153,8;32;255255255
vpja71;12;895;944;-357,4;160,7;49;255255255
vpja71;12;1133;1380;-43,6;-266,7;247;255000
vpja71;12;1412;1577;-15,8;-242,7;165;255000
vpja71;12;1586;1732;-20,9;-232,9;146;255000
vpja71;12;1755;1986;-17,1;-213,2;231;255000
vpja71;12;2050;2414;318,3;149,1;364;255255000
vpja71;12;2436;2482;317,1;162,5;46;255255000
vpja71;12;3051;3134;-326,7;181;83;255
vpja71;12;3319;3608;320,2;155,8;289;255255000
vpja71;12;3685;3891;453,4;-204,4;206;255255255
vpja71;12;3932;4150;548,9;-130,4;218;255255255
vpja71;12;4217;4414;124,5;-282,2;197;255255255
vpja71;12;4462;4838;-33,4;-275,1;376;255000
vpja71;12;4872;5046;0;-267,7;174;255000
vpja71;12;5092;5168;-34;-347,7;76;255255255
vpja71;12;5219;5674;-240,1;-371,3;455;255255255
vpja71;12;5721;5866;-164,9;-264,2;145;255255255
vpja71;12;5941;6178;447,7;-257,3;237;255255255
vpja71;12;6218;6482;364,6;-248;264;255255255
vpja71;12;6518;6723;296,7;-228,9;205;255255255
vpja71;12;6771;6864;238,6;-321;93;255255255
vpja71;12;6924;7227;7,79999999999995;-261,8;303;255000
vpja71;12;7283;7469;-198,7;-78,9;186;255255255
vpja71;12;7534;7657;-11,8;-239,6;123;255000
vpja71;12;7680;7873;-13,6;-256,7;193;255000
vpja71;12;7897;8064;4,60000000000002;-268,4;167;255000
vpja71;12;8130;8349;-513,4;-246,9;219;255255255
vpja71;12;8396;8557;-610,2;-101,2;161;255255255
vpja71;12;8598;8722;-634,8;4,60000000000002;124;255255255
vpja71;12;8775;8974;-560,8;235,4;199;255255255
vpja71;12;9034;9169;-343,1;211,4;135;255
vpja71;12;9203;9622;-296,9;179,4;419;255
vpja71;12;9659;9768;-215,3;154,9;109;255
vpja71;12;9811;9967;-99,4;115,3;156;2,55e+08
vpja71;13;251;275;114,7;-228,4;24;2,55e+08
vpja71;13;318;420;127,6;-304,9;102;255000
vpja71;13;442;706;142,4;-301,1;264;255000
vpja71;13;731;934;137,8;-271;203;255000
vpja71;13;956;1339;144,6;-297,5;383;255000
vpja71;13;1399;1609;-92,6999999999999;29,8000000000001;210;255255000
vpja71;13;1641;1865;-109,6;71,5;224;255255000
vpja71;13;1936;2191;345,2;107;255;255
vpja71;13;2246;2488;421,1;28;242;255
vpja71;13;2515;2764;460,4;-1,29999999999995;249;0
vpja71;13;2792;3109;516,1;3,70000000000005;317;0
vpja71;13;3191;3337;-73,1999999999999;70,2;146;255255000
vpja71;13;3402;3532;-343,8;111,8;130;0
vpja71;13;3568;3794;-392,4;122,1;226;0
vpja71;13;3839;3933;-496;107,1;94;0
vpja71;13;3997;4170;-288,2;-29,5;173;0
vpja71;13;4190;4250;-302;-20,0999999999999;60;0
vpja71;13;4316;4445;-9,19999999999993;-110,4;129;2,55e+08
vpja71;13;4489;4627;76,7;-152,8;138;2,55e+08
vpja71;13;4679;4892;130,1;-257,5;213;255000
vpja71;13;4908;5081;135,6;-272,3;173;255000
vpja71;13;5098;5205;145,1;-283;107;255000
vpja71;13;5223;5540;140,9;-294,7;317;255000
vpja71;13;5563;5897;146,5;-270,9;334;255000
vpja71;13;5966;6147;-97,8;27,9000000000001;181;255255000
vpja71;13;6185;6440;-140,8;82,4000000000001;255;255255000
vpja71;13;6471;6605;-169,5;91,7;134;0
vpja71;13;6676;6879;-601,3;-26,5999999999999;203;0
vpja71;13;6932;7118;-637;-137,2;186;0
vpja71;13;7159;7317;-629,4;-44,0999999999999;158;0
vpja71;13;7403;7674;-407,9;42,7;271;0
vpja71;13;7721;8256;-305,6;-30,5999999999999;535;0
vpja71;13;8308;8724;-152,3;77,9000000000001;416;255255000
vpja71;13;8751;9241;-72,9;21,9000000000001;490;255255000
vpja71;13;9308;9454;66,6000000000001;-142,1;146;2,55e+08
vpja71;13;9506;9696;125,1;-292,2;190;255000
vpja71;13;9720;9961;141,7;-288,6;241;255000
vpja71;14;200;462;128;-190,3;262;255000
vpja71;14;485;637;125,5;-152,4;152;255000
vpja71;14;710;894;-407,3;88;184;255255000
vpja71;14;918;1071;-436,3;80,1999999999999;153;0
vpja71;14;1145;1292;47,9;261;147;255
vpja71;14;1308;1396;46,4999999999999;244,6;88;255
vpja71;14;1413;1559;46,1999999999999;241,8;146;255
vpja71;14;1614;1811;161,4;125,5;197;2,55e+08
vpja71;14;1834;1913;147,6;141,7;79;2,55e+08
vpja71;14;1977;2115;199,7;454,3;138;2,55e+08
vpja71;14;2151;2368;254,7;461,5;217;2,55e+08
vpja71;14;2430;2659;485,9;257,1;229;0
vpja71;14;2732;2876;92,4999999999999;13,1;144;2,55e+08
vpja71;14;2952;3145;-417,4;80,4;193;0
vpja71;14;3165;3610;-428,4;53,4;445;0
vpja71;14;3712;3829;-13,6;-222,2;117;0
vpja71;14;3871;4024;90,4;-224,8;153;255000
vpja71;14;4055;4288;115,7;-200,9;233;255000
vpja71;14;4313;4536;129,3;-151,6;223;255000
vpja71;14;4587;4768;51,1999999999999;69,6999999999999;181;2,55e+08
vpja71;14;4808;4950;111,5;133,3;142;2,55e+08
vpja71;14;4972;5646;135,2;138,3;674;2,55e+08
vpja71;14;5689;6010;39,8000000000001;121,2;321;2,55e+08
vpja71;14;6077;6294;157,7;-59,3000000000001;217;2,55e+08
vpja71;14;6349;6597;129,4;-184,5;248;255000
vpja71;14;6629;6772;131,9;-157,2;143;255000
vpja71;14;6838;7136;189,6;-322,2;298;255000
vpja71;14;7172;7424;185,2;-266,2;252;255000
vpja71;14;7461;7651;226,7;-224;190;255000
vpja71;14;7687;7847;165,4;-213;160;255000
vpja71;14;7903;8050;208;37;147;2,55e+08
vpja71;14;8074;8181;157;26,8;107;2,55e+08
vpja71;14;8250;8386;220,1;452,8;136;2,55e+08
vpja71;14;8421;8693;253,6;467,7;272;2,55e+08
vpja71;14;8747;8942;39,8000000000001;241,2;195;255
vpja71;14;8961;9114;37,9;234,6;153;255
vpja71;14;9194;9385;-457,1;64,6;191;0
vpja71;14;9427;9495;-601,1;-22;68;0
vpja71;14;9548;9772;-625,5;-113,1;224;0
vpja71;14;9795;10000;-636,2;-193,5;205;0
vpja71;15;183;566;71,4000000000001;-69,4;383;255000
vpja71;15;583;649;78,3;-73,9;66;255000
vpja71;15;1092;1243;338,1;134,2;151;255255000
vpja71;15;1269;1400;348,3;109,4;131;255255000
vpja71;15;1427;1476;333,8;91,1999999999999;49;255255000
vpja71;15;1548;1736;414,4;-213;188;0
vpja71;15;1775;1929;330,3;-197,3;154;0
vpja71;15;1992;2259;71;-68,1;267;255000
vpja71;15;2280;2492;53,7;-64,6;212;255000
vpja71;15;2549;2665;-35,5999999999999;-221,8;116;0
vpja71;15;2728;2837;311,6;-163,6;109;0
vpja71;15;2862;3090;336,2;-162,8;228;0
vpja71;15;3182;3275;-489,9;-93;93;0
vpja71;15;3322;3425;-601,3;48,6;103;0
vpja71;15;3468;3769;-592;175,9;301;0
vpja71;15;3790;3949;-582,5;158,3;159;0
vpja71;15;4034;4197;-16,1999999999999;-174,8;163;0
vpja71;15;4229;4406;-3,39999999999998;-205,6;177;0
vpja71;15;4414;4659;-15,4;-210,9;245;0
vpja71;15;4701;4798;92,7;-149,5;97;0
vpja71;15;4834;4928;70,6000000000001;-91,2;94;255000
vpja71;15;4956;5319;67,5;-64,9;363;255000
vpja71;15;5341;5575;64,1000000000001;-39,4;234;255000
vpja71;15;5620;5730;57,7;127,2;110;2,55e+08
vpja71;15;5768;6028;48,9000000000001;190,3;260;255
vpja71;15;6066;6219;-23,0999999999999;204;153;0
vpja71;15;6257;6414;-93,5999999999999;210,3;157;0
vpja71;15;6442;6645;-110,2;215,7;203;0
vpja71;15;6691;6896;38,5;201,3;205;255
vpja71;15;6937;7422;151,2;196,3;485;0
vpja71;15;7483;7667;337,4;103;184;255255000
vpja71;15;7693;7925;331;71,9;232;0
vpja71;15;7997;8194;227,6;492,6;197;NA
vpja71;15;8236;8357;137,3;492,4;121;NA
vpja71;15;8392;8557;59,3;474,2;165;0
vpja71;15;8632;8798;50,5;151,2;166;2,55e+08
vpja71;15;8827;9048;56,1000000000001;73,9;221;2,55e+08
vpja71;15;9071;9396;74,6000000000001;74,5;325;2,55e+08
vpja71;15;9474;9512;-87,8;-239,7;38;0
vpja71;15;9552;9677;-125,5;-285,5;125;0
vpja71;15;9728;9962;-175,5;-401,5;234;0
vpja71;16;204;241;-77,1;-157,1;37;255000
vpja71;16;277;440;-113,4;-200,2;163;255000
vpja71;16;449;687;-135,3;-200,7;238;255000
vpja71;16;710;848;-112,3;-207,5;138;255000
vpja71;16;902;1058;67,9000000000001;34;156;0
vpja71;16;1088;1150;98,3;64;62;255255000
vpja71;16;1210;1415;366;-88,6;205;0
vpja71;16;1434;1545;348;-89,6;111;0
vpja71;16;1603;1945;585,6;-223,7;342;0
vpja71;16;2006;2226;333,8;-77,4000000000001;220;0
vpja71;16;2287;2528;584;-219,9;241;0
vpja71;16;2548;2716;588,6;-236,8;168;0
vpja71;16;2765;2997;582,3;-89,3000000000001;232;0
vpja71;16;3054;3167;590,8;-236,1;113;0
vpja71;16;3191;3727;589,2;-268,6;536;0
vpja71;16;3806;4034;102,7;-341,4;228;0
vpja71;16;4084;4144;-7,10000000000002;-316,8;60;0
vpja71;16;4197;4363;-130,5;-217,7;166;255000
vpja71;16;4387;4515;-124,4;-197,7;128;255000
vpja71;16;4558;4582;-122,7;-121,1;24;2,55e+08
vpja71;16;4628;4665;-262,3;72,3;37;0
vpja71;16;4704;4782;-267,2;76,4;78;0
vpja71;16;4833;5024;-290,4;53,1999999999999;191;0
vpja71;16;5369;5519;-396,8;96,5;150;0
vpja71;16;5586;5775;40,0999999999999;72,5;189;0
vpja71;16;5804;5971;69,0999999999999;83,5;167;255255000
vpja71;16;5995;6082;35,3;80,6999999999999;87;0
vpja71;16;6150;6328;-51,4;447,4;178;0
vpja71;16;6393;6587;-374,9;496,8;194;NA
vpja71;16;6624;6733;-426,1;492,8;109;NA
vpja71;16;6808;7029;-260,3;62,9;221;0
vpja71;16;7092;7276;-138,7;-138,4;184;2,55e+08
vpja71;16;7309;7627;-117,9;-109,2;318;2,55e+08
vpja71;16;7664;7802;-156,6;-54,2;138;2,55e+08
vpja71;16;7828;8183;-119,8;-105,3;355;2,55e+08
vpja71;16;8231;8368;-125,2;-198,9;137;255000
vpja71;16;8386;8655;-131,8;-205,5;269;255000
vpja71;16;8672;8831;-126,8;-209,9;159;255000
vpja71;16;8903;9160;-473,3;-290,7;257;0
vpja71;16;9226;9387;-128,4;-217,3;161;255000
vpja71;16;9460;9707;353,5;-63,9000000000001;247;0
vpja71;16;9728;9795;335,7;-62,1;67;0
vpja71;16;9856;9999;576,6;-184,8;143;0
vpja71;17;188;237;-60,6999999999999;-58,4;49;2,55e+08
vpja71;17;273;874;-84;-121,6;601;255000
vpja71;17;937;1131;-61,8;-375,4;194;0
vpja71;17;1146;1245;-53,1;-371,9;99;0
vpja71;17;1308;1413;309;-75,5;105;0
vpja71;17;1454;1592;375,4;4,29999999999995;138;0
vpja71;17;1638;1794;237,8;101,4;156;0
vpja71;17;1819;2083;216,8;128,1;264;255
vpja71;17;2108;2404;212,5;118;296;255
vpja71;17;2486;2735;-394,7;132,7;249;255255000
vpja71;17;2777;3050;-506,2;137,4;273;255255000
vpja71;17;3120;3285;-53,6;314,7;165;0
vpja71;17;3357;3549;227,7;92,1999999999999;192;0
vpja71;17;3582;3827;201,8;116,5;245;255
vpja71;17;3873;4127;179,1;23,1;254;0
vpja71;17;4190;4255;-68,1999999999999;-51,2;65;2,55e+08
vpja71;17;4283;4529;-70,6999999999999;-110,1;246;255000
vpja71;17;4540;4962;-74,6999999999999;-122,6;422;255000
vpja71;17;5011;5246;-123,6;40,6;235;2,55e+08
vpja71;17;5298;5403;-96,3;235,8;105;0
vpja71;17;5444;5591;-100,7;313,7;147;2,55e+08
vpja71;17;5653;5848;74,1;232;195;2,55e+08
vpja71;17;5923;6074;-296,8;51,6;151;0
vpja71;17;6128;6285;-447,2;-96,6;157;0
vpja71;17;6307;6531;-440,3;-113,9;224;0
vpja71;17;6550;6710;-445,7;-148,2;160;0
vpja71;17;6766;7018;-662,3;-118,9;252;NA
vpja71;17;7042;7118;-625,4;-167,3;76;0
vpja71;17;7185;7420;-409,6;-400,6;235;0
vpja71;17;7484;7608;-112,6;-374,9;124;0
vpja71;17;7646;7938;-44;-375,3;292;0
vpja71;17;7999;8148;-85,6999999999999;-130,5;149;255000
vpja71;17;8170;8533;-75,5;-124,9;363;255000
vpja71;17;8557;8714;-69,4;-104,7;157;255000
vpja71;17;8783;8915;363;16,4;132;0
vpja71;17;8945;9101;386,5;10;156;0
vpja71;17;9142;9325;467,7;95,6;183;0
vpja71;17;9382;9574;614,4;-23,5;192;0
vpja71;17;9628;9749;596,3;-174,5;121;0
vpja71;17;9785;9926;558,1;-89,4;141;0
vpja71;18;268;376;-21;-314,2;108;255000
vpja71;18;396;658;-17,7;-301,4;262;255000
vpja71;18;721;855;276,1;27,6;134;0
vpja71;18;934;1015;-346,3;94,8000000000001;81;0
vpja71;18;1051;1255;-405,8;103,9;204;0
vpja71;18;1271;1351;-399,8;99,8000000000001;80;0
vpja71;18;1417;1589;-633,1;54,1;172;0
vpja71;18;1598;1769;-641,3;46,9;171;NA
vpja71;18;1794;2156;-583,2;20,5;362;0
vpja71;18;2176;2300;-585;35,2;124;0
vpja71;18;2339;2852;-640,3;46,8000000000001;513;NA
vpja71;18;2874;2922;-621,7;16,7;48;0
vpja71;18;3002;3100;-161,6;-297,1;98;0
vpja71;18;3154;3360;-8,10000000000002;-294,3;206;255000
vpja71;18;3432;3598;563,3;-107,4;166;0
vpja71;18;3629;3730;558,4;-59,5;101;0
vpja71;18;3770;4093;622;25,3000000000001;323;0
vpja71;18;4168;4464;532,9;-296,6;296;0
vpja71;18;4488;4697;496,1;-282;209;0
vpja71;18;4732;4835;456,3;-271,5;103;0
vpja71;18;4909;5041;0,599999999999909;-288,1;132;255000
vpja71;18;5071;5292;8,09999999999991;-297,1;221;255000
vpja71;18;5358;5545;-15,4000000000001;24,9;187;2,55e+08
vpja71;18;5569;5734;2,69999999999993;5,60000000000002;165;2,55e+08
vpja71;18;5756;5876;-3,70000000000005;-27;120;2,55e+08
vpja71;18;5941;6142;313,5;64;201;0
vpja71;18;6206;6524;135,9;487,3;318;NA
vpja71;18;6589;6807;-132,2;461,5;218;0
vpja71;18;6864;6948;-317,7;219,6;84;0
vpja71;18;6993;7313;-354,1;130,1;320;255255000
vpja71;18;7326;7499;-375,5;119,8;173;0
vpja71;18;7563;7712;-596,2;40,3000000000001;149;0
vpja71;18;7744;8015;-634,3;46,5;271;0
vpja71;18;8049;8308;-576,5;23,8000000000001;259;0
vpja71;18;8339;8652;-580,4;48,4;313;0
vpja71;18;8663;9400;-578,6;42,6;737;0
vpja71;18;9423;9624;-573,1;69;201;0
vpja71;18;9646;9848;-568,6;63,7;202;0
vpja71;18;9859;10000;-568,4;50,1;141;0
vpja71;19;267;450;-22,4;-375,9;183;255000
vpja71;19;469;656;-26,8;-378,1;187;255000
vpja71;19;664;849;-19,3;-377,8;185;255000
vpja71;19;872;1017;-34,3;-332,2;145;255000
vpja71;19;1077;1285;-368,4;-330,6;208;0
vpja71;19;1351;1506;-34,5;-403,4;155;255000
vpja71;19;1537;1682;-5,60000000000002;-399,2;145;255000
vpja71;19;1777;1957;-371,8;296,9;180;255
vpja71;19;2003;2101;-267,1;237,6;98;255
vpja71;19;2185;2321;405,5;386,4;136;0
vpja71;19;2358;2613;447,6;431,6;255;255255000
vpja71;19;2687;2748;543,3;-59;61;0
vpja71;19;2788;2835;536,8;-142,4;47;0
vpja71;19;2887;3037;446,9;-261;150;0
vpja71;19;3095;3218;251,7;-241,8;123;0
vpja71;19;3284;3382;-64,1;-325,7;98;0
vpja71;19;3420;3575;-21,1;-362,2;155;255000
vpja71;19;3598;3851;-9,5;-392,5;253;255000
vpja71;19;3890;4176;-38,6999999999999;-322,6;286;255000
vpja71;19;4197;4356;-30,5;-330,4;159;255000
vpja71;19;4383;4535;-43;-397,3;152;255000
vpja71;19;4568;4816;-13,3;-402,3;248;255000
vpja71;19;4881;5172;-306;-314,6;291;0
vpja71;19;5206;5367;-347,9;-290,7;161;0
vpja71;19;5394;5690;-318,2;-381,5;296;0
vpja71;19;5746;5957;-525,5;-425,4;211;0
vpja71;19;6000;6280;-555,1;-339;280;0
vpja71;19;6306;6671;-546,5;-313,4;365;0
vpja71;19;6732;6878;-355,2;-61,8;146;0
vpja71;19;6938;7155;-530,6;-299,7;217;0
vpja71;19;7176;7358;-552,2;-298,8;182;0
vpja71;19;7433;7715;14,5000000000001;-378,6;282;255000
vpja71;19;7773;7872;-5,69999999999993;-86,3;99;2,55e+08
vpja71;19;7916;8037;-27;41,9;121;2,55e+08
vpja71;19;8069;8137;-27,6999999999999;80,1;68;2,55e+08
vpja71;19;8192;8419;53,4;-136,6;227;2,55e+08
vpja71;19;8445;8615;109;-117,2;170;2,55e+08
vpja71;19;8673;8860;-124,6;-98,5;187;2,55e+08
vpja71;19;8879;9435;-132,9;-89,1;556;2,55e+08
vpja71;19;9488;9818;97,0000000000001;-133,1;330;2,55e+08
vpja71;19;9845;9999;131,8;-103,9;154;2,55e+08
vpja71;20;38;149;9,20000000000005;7,70000000000005;111;2,55e+08
vpja71;20;215;276;-73,8;-177,1;61;255000
vpja71;20;309;430;-70;-198,7;121;255000
vpja71;20;450;727;-61,8;-207,7;277;255000
vpja71;20;764;819;-81;-149,8;55;255000
vpja71;20;885;1208;266,7;224,4;323;255
vpja71;20;1493;1792;-60,3;-209,6;299;255000
vpja71;20;1829;2112;-62,5;-153,5;283;255000
vpja71;20;2181;2414;-359,2;-290;233;0
vpja71;20;2467;2794;-536;-337,1;327;0
vpja71;20;2844;2973;-353,1;-305,4;129;0
vpja71;20;3033;3138;-110,9;-240,4;105;255000
vpja71;20;3173;3324;-74;-215,7;151;255000
vpja71;20;4221;4348;245,9;223,2;127;255
vpja71;20;4382;4566;293,9;245,6;184;0
vpja71;20;4587;5018;312,6;253,8;431;0
vpja71;20;5045;5169;224,5;230,2;124;255
vpja71;20;5671;5839;-175,6;-13,3;168;2,55e+08
vpja71;20;5880;5997;-266,9;30,3000000000001;117;2,55e+08
vpja71;20;6017;6218;-288,8;15,4;201;2,55e+08
vpja71;20;6250;6662;-273,9;-78,9;412;2,55e+08
vpja71;20;6707;6866;-337,6;-111,4;159;0
vpja71;20;6885;7102;-333,2;-111;217;2,55e+08
vpja71;20;7135;7675;-373,8;-81,4;540;0
vpja71;20;7922;7980;-169,6;-19,1;58;2,55e+08
vpja71;20;7999;8110;-168,4;-34,4;111;2,55e+08
vpja71;20;9518;9782;-63,1;-207,4;264;255000
vpja71;20;9816;10000;-64,3;-165;184;255000
vpja71;21;190;233;-56,3000000000001;-158,3;43;255000
vpja71;21;267;355;-100,7;-189,8;88;255000
vpja71;21;379;547;-122,4;-212;168;255000
vpja71;21;555;705;-136;-214,8;150;255000
vpja71;21;777;1073;-15;-370,5;296;0
vpja71;21;1112;1164;2,39999999999998;-439,2;52;0
vpja71;21;1187;1649;21,9;-465,8;462;0
vpja71;21;1672;2116;59,5999999999999;-459,4;444;0
vpja71;21;2136;2264;47,2;-446,6;128;0
vpja71;21;2325;2732;421,5;-448,1;407;0
vpja71;21;2794;2981;356,1;-53,6;187;0
vpja71;21;3011;3100;339,3;50;89;0
vpja71;21;3163;3319;440,6;349,3;156;255255000
vpja71;21;3358;3503;363;385;145;0
vpja71;21;3541;3634;413,5;411,9;93;0
vpja71;21;3689;3899;459,3;298,9;210;255255000
vpja71;21;3939;4063;469,3;379,3;124;255255000
vpja71;21;4098;4330;449,7;420,4;232;0
vpja71;21;4410;4591;-102,7;305,9;181;0
vpja71;21;4615;4699;-140,1;238,9;84;2,55e+08
vpja71;21;4751;4893;-102,6;101,5;142;2,55e+08
vpja71;21;4917;5211;-102;64,6;294;2,55e+08
vpja71;21;5233;5356;-137,3;45,8;123;2,55e+08
vpja71;21;5381;5527;-125,9;14,3;146;2,55e+08
vpja71;21;5815;6004;-236,5;119,2;189;2,55e+08
vpja71;21;6067;6167;-214,1;-30,4;100;0
vpja71;21;6220;6473;-119,2;-107,8;253;2,55e+08
vpja71;21;6522;6820;-118,7;-214,6;298;255000
vpja71;21;6875;7071;-66,3000000000001;52,4;196;2,55e+08
vpja71;21;7096;7192;-78,2;31,3;96;2,55e+08
vpja71;21;7212;7618;-78,9000000000001;3,10000000000002;406;2,55e+08
vpja71;21;7655;7968;-133,1;40,8;313;2,55e+08
vpja71;21;8025;8197;-451,7;0,299999999999955;172;255
vpja71;21;8241;8331;-503;128,5;90;255
vpja71;21;8372;8505;-515,9;218,6;133;0
vpja71;21;8541;8799;-468;254,6;258;0
vpja71;21;8859;8997;-408,1;130,6;138;0
vpja71;21;9021;9205;-413,5;95,6;184;0
vpja71;21;9225;9401;-420,6;65,1999999999999;176;0
vpja71;21;9463;9653;-542;256,8;190;0
vpja71;21;9687;9883;-579,6;285,4;196;0
vpja71;21;9925;10000;-489,9;282,4;75;0
vpja71;22;196;217;-247,767142857143;-150,543571428571;21;2,55e+08
vpja71;22;260;370;-328,367142857143;-231,843571428571;110;255000
vpja71;22;394;663;-331,967142857143;-264,943571428571;269;255000
vpja71;22;747;901;198,432857142857;152,156428571429;154;255
vpja71;22;931;1027;217,832857142857;179,356428571429;96;255
vpja71;22;1105;1247;-387,567142857143;392,556428571429;142;255255000
vpja71;22;1278;1543;-424,267142857143;369,656428571429;265;255255000
vpja71;22;1580;1672;-465,567142857143;378,856428571429;92;255255000
vpja71;22;1752;1795;-517,767142857143;-73,8435714285714;43;2,55e+08
vpja71;22;1852;2134;-583,667142857143;-199,343571428571;282;0
vpja71;22;2168;2280;-619,267142857143;-205,343571428571;112;0
vpja71;22;2344;2460;-340,867142857143;-263,743571428571;116;255000
vpja71;22;2493;2858;-308,067142857143;-272,443571428571;365;255000
vpja71;22;2935;3172;186,532857142857;214,356428571429;237;255
vpja71;22;3227;3347;41,5328571428571;323,956428571429;120;0
vpja71;22;3384;3603;-33,8671428571429;326,156428571429;219;0
vpja71;22;3682;3795;376,332857142857;-16,7435714285714;113;0
vpja71;22;3863;4044;423,732857142857;-218,843571428571;181;0
vpja71;22;4069;4219;433,832857142857;-258,143571428571;150;0
vpja71;22;4280;4642;288,832857142857;-69,1435714285715;362;0
vpja71;22;4727;4977;-315,567142857143;-272,143571428571;250;255000
vpja71;22;4998;5273;-303,567142857143;-276,343571428571;275;255000
vpja71;22;5338;5521;-562,567142857143;-218,043571428571;183;0
vpja71;22;5559;5820;-618,967142857143;-226,643571428571;261;0
vpja71;22;5845;5953;-625,067142857143;-200,043571428571;108;0
vpja71;22;6020;6245;-332,967142857143;-252,143571428571;225;255000
vpja71;22;6273;6640;-300,567142857143;-263,743571428571;367;255000
vpja71;22;6693;7120;-326,567142857143;-57,4435714285714;427;2,55e+08
vpja71;22;7189;7288;12,3328571428572;149,856428571429;99;0
vpja71;22;7342;7565;168,532857142857;187,756428571429;223;255
vpja71;22;7609;7725;135,132857142857;310,956428571429;116;0
vpja71;22;7783;7989;-75,5671428571428;346,556428571429;206;0
vpja71;22;8058;8198;-423,367142857143;394,256428571429;140;255255000
vpja71;22;8219;8382;-431,767142857143;382,656428571429;163;255255000
vpja71;22;8407;8649;-457,967142857143;408,656428571429;242;255255000
vpja71;22;8701;8985;-563,567142857143;254,656428571429;284;2,55e+08
vpja71;22;9018;9455;-589,367142857143;266,156428571429;437;0
vpja71;22;9527;9745;-214,067142857143;132,556428571429;218;2,55e+08
vpja71;22;9804;9952;-317,367142857143;-23,6435714285715;148;2,55e+08
vpja71;23;261;341;5,89999999999998;-283,8;80;255000
vpja71;23;373;517;-16,9;-309,5;144;255000
vpja71;23;536;808;-34,4;-301,3;272;255000
vpja71;23;1033;1303;28,3;495,9;270;NA
vpja71;23;1326;1523;12,1999999999999;478,4;197;0
vpja71;23;1606;1705;375,7;6,30000000000007;99;0
vpja71;23;1749;1861;397,6;-50,3;112;0
vpja71;23;1918;2047;322,7;-204;129;0
vpja71;23;2070;2246;288,3;-227,9;176;0
vpja71;23;2312;2490;-65,7;-50,0999999999999;178;255
vpja71;23;2510;2625;-56,5;-74,4;115;255
vpja71;23;2678;2872;-205,1;0,600000000000023;194;255255000
vpja71;23;2898;3050;-256,9;-25,4;152;0
vpja71;23;3120;3319;-210,7;-258,2;199;0
vpja71;23;3352;3541;-241,2;-222,6;189;0
vpja71;23;3571;3680;-232,6;-197,5;109;0
vpja71;23;3751;3968;-575,8;-183,8;217;0
vpja71;23;4046;4134;-51,2;-292,3;88;0
vpja71;23;4171;4377;-16,6;-311,7;206;255000
vpja71;23;4432;4601;-10,5;13,5;169;2,55e+08
vpja71;23;4673;4753;-1,5;-289,4;80;255000
vpja71;23;4777;5083;-17,7;-325,8;306;255000
vpja71;23;5154;5362;372,9;-92,0999999999999;208;0
vpja71;23;5402;5860;459,5;-38,5999999999999;458;0
vpja71;23;5884;6127;438,4;-22,4;243;0
vpja71;23;6147;6324;431,7;-11,5999999999999;177;0
vpja71;23;6370;6656;520,3;-80,6999999999999;286;0
vpja71;23;6676;6837;525,4;-91,1999999999999;161;0
vpja71;23;6863;7161;576,2;-64,5999999999999;298;0
vpja71;23;7201;7428;511;-12;227;0
vpja71;23;7446;7878;525,7;-11,3;432;0
vpja71;23;7948;8236;313,7;-302,5;288;0
vpja71;23;8283;8402;457,9;-227,4;119;0
vpja71;23;8453;8505;379,3;-313,8;52;0
vpja71;23;8545;8607;296,3;-406,8;62;0
vpja71;23;8632;8842;258,5;-462,8;210;0
vpja71;23;8872;9043;237,6;-402,7;171;0
vpja71;23;9095;9350;291,9;-183,3;255;0
vpja71;23;9398;9746;190,2;-81,8;348;0
vpja71;23;9779;9941;193,7;-48,0999999999999;162;0
vpja71;24;182;210;-26,5;-159,2;28;2,55e+08
vpja71;24;253;325;-60,3;-262,9;72;255000
vpja71;24;348;604;-97,3;-321,6;256;255000
vpja71;24;622;848;-115,5;-330,8;226;255000
vpja71;24;872;939;-79,8;-336,2;67;255000
vpja71;24;1002;1470;-327,9;-265,1;468;0
vpja71;24;1490;1560;-330,3;-274,8;70;0
vpja71;24;1644;1816;315,4;-103,2;172;0
vpja71;24;1890;2078;389,9;331,6;188;255255000
vpja71;24;2100;2336;414,1;366,9;236;255255000
vpja71;24;2430;2566;-479,8;353,2;136;0
vpja71;24;2602;2826;-532,7;358;224;0
vpja71;24;2913;3160;-64,5;-209,6;247;255000
vpja71;24;3199;3356;-44,1;-119,1;157;2,55e+08
vpja71;24;3386;3990;-10,9;-94,7;604;2,55e+08
vpja71;24;4011;4141;7,30000000000007;-89,3000000000001;130;2,55e+08
vpja71;24;4212;4341;-98,4;-327,8;129;255000
vpja71;24;4364;4479;-92,1999999999999;-345;115;255000
vpja71;24;4512;4672;-58,8;-345,8;160;255000
vpja71;24;4713;4966;-75,4;-270,3;253;255000
vpja71;24;4987;5096;-94,1999999999999;-250;109;255000
vpja71;24;5143;5261;-91,4;-351,9;118;255000
vpja71;24;5293;5421;-61,1999999999999;-348,3;128;255000
vpja71;24;5489;5633;329,8;-142,7;144;0
vpja71;24;5672;5806;351,7;-80,8000000000001;134;0
vpja71;24;5829;6285;344,2;-46,7;456;0
vpja71;24;6315;6548;444,6;43,0999999999999;233;0
vpja71;24;6586;6731;514,1;72,6999999999999;145;0
vpja71;24;6779;7046;610,1;7,5;267;0
vpja71;24;7071;7199;622,2;-15,3000000000001;128;0
vpja71;24;7245;7471;519,1;84;226;0
vpja71;24;7495;7784;505,8;93,8;289;0
vpja71;24;7809;8066;466,3;97,6999999999999;257;0
vpja71;24;8111;8272;446,3;14,1999999999999;161;0
vpja71;24;8353;8670;553,9;-362,3;317;0
vpja71;24;8701;8849;544,8;-394,4;148;0
vpja71;24;8872;9062;560,2;-358,1;190;0
vpja71;24;9096;9303;503,1;-323,7;207;0
vpja71;24;9365;9687;486,5;-454,3;322;0
vpja71;24;9735;9874;333,7;-460,6;139;0
vpja71;24;9929;10000;348,8;-205,9;71;0
vpja71;25;197;218;37,6;-234,3;21;255000
vpja71;25;267;360;28,5;-302;93;255000
vpja71;25;373;736;18;-318,1;363;255000
vpja71;25;787;1031;-68,9;-435,4;244;0
vpja71;25;1108;1203;313,4;96,1999999999999;95;0
vpja71;25;1242;1464;335,1;171,7;222;0
vpja71;25;1485;1619;331,9;186,6;134;0
vpja71;25;1704;1857;-321,4;123;153;255255000
vpja71;25;1888;2117;-351;114,9;229;255255000
vpja71;25;2139;2340;-335,1;105,2;201;255255000
vpja71;25;2413;2527;29,6999999999999;-260,6;114;255000
vpja71;25;2554;2880;33;-312,4;326;255000
vpja71;25;2890;3205;46,9;-319,7;315;255000
vpja71;25;3275;3551;-72,3000000000001;-416,8;276;0
vpja71;25;3584;3924;-33,7;-445,7;340;0
vpja71;25;3948;4085;-13,9;-445,9;137;0
vpja71;25;4148;4284;256,2;-230,6;136;0
vpja71;25;4320;4489;204,5;-239,7;169;0
vpja71;25;4537;4684;56,6999999999999;-288,2;147;255000
vpja71;25;4707;4846;41,3000000000001;-296,7;139;255000
vpja71;25;4884;5230;-25,4;-280,5;346;255000
vpja71;25;5283;5439;35,6999999999999;-85,7;156;2,55e+08
vpja71;25;5505;5608;-17,3000000000001;-266,8;103;255000
vpja71;25;5638;6308;-14,5;-284,4;670;255000
vpja71;25;6350;6690;65,4999999999999;-316,5;340;255000
vpja71;25;6729;7053;55,1999999999999;-93,5;324;2,55e+08
vpja71;25;7080;7144;35,3;-44,6;64;2,55e+08
vpja71;25;7211;7595;338,1;192,1;384;0
vpja71;25;7659;7916;588,2;349,6;257;0
vpja71;25;7991;8066;581,8;50;75;0
vpja71;25;8156;8267;405,7;-361,6;111;0
vpja71;25;8312;8496;314,2;-392,3;184;0
vpja71;25;8571;9036;-115,2;-412,7;465;0
vpja71;25;9074;9202;-109,8;-345,2;128;0
vpja71;25;9264;9440;144,6;-289,4;176;0
vpja71;25;9491;9688;103,2;-407,3;197;0
vpja71;25;9711;9895;123,5;-405,4;184;0
vpja71;25;9949;10000;49,8000000000001;-318,7;51;255000
vpja71;26;194;217;-60,2;-180,3;23;2,55e+08
vpja71;26;257;345;-89,4;-241,9;88;255000
vpja71;26;369;819;-122,3;-237,1;450;0
vpja71;26;889;1012;371,3;-250,4;123;0
vpja71;26;1061;1184;554;-147,8;123;0
vpja71;26;1207;1400;585,9;-163,1;193;0
vpja71;26;1462;1683;446,3;-377,7;221;0
vpja71;26;1755;1817;15,3;-319,5;62;0
vpja71;26;1858;1950;-71;-259,7;92;255000
vpja71;26;1985;2186;-117,4;-250,6;201;255000
vpja71;26;2249;2452;-193,9;-21,6;203;0
vpja71;26;2498;2752;-49;-0,800000000000068;254;2,55e+08
vpja71;26;2777;3362;-37,7;17;585;255255000
vpja71;26;3388;3611;-36,1;59,9;223;255255000
vpja71;26;3633;3714;-31,1;27,9;81;255255000
vpja71;26;3738;3844;-27,1;12,3;106;2,55e+08
vpja71;26;3919;4104;-496;-16,4;185;255
vpja71;26;4144;4365;-508,1;74,5;221;0
vpja71;26;4422;4609;-318,2;207;187;0
vpja71;26;4668;4869;-35,1;80,6999999999999;201;255255000
vpja71;26;4890;5126;-24,8000000000001;68;236;255255000
vpja71;26;5169;5362;64,4;46,6;193;255255000
vpja71;26;5401;5597;69,3000000000001;137;196;0
vpja71;26;5618;5979;61,6;152,9;361;0
vpja71;26;6061;6307;-480,3;157,1;246;0
vpja71;26;6354;6495;-573,2;91,1999999999999;141;0
vpja71;26;6515;6772;-587,7;68,3;257;0
vpja71;26;6840;7110;12,4;137,1;270;255255000
vpja71;26;7146;7324;53,8000000000001;151,3;178;0
vpja71;26;7360;7695;108,3;170,5;335;0
vpja71;26;7732;7787;44,8000000000001;171,6;55;0
vpja71;26;7834;8028;-35,5;91,6999999999999;194;255255000
vpja71;26;8052;8453;-48,7;75,3;401;255255000
vpja71;26;8501;8758;49,6;178,4;257;0
vpja71;26;8804;8941;-87,3000000000001;168,4;137;0
vpja71;26;8964;9061;-86,9;152;97;0
vpja71;26;9127;9210;-92,3000000000001;-191,4;83;255000
vpja71;26;9250;9476;-110,3;-241,6;226;255000
vpja71;26;9492;9878;-124,9;-242,6;386;0
