vp;trial;timest;timeend;x;y;duration;roi
vpja26;1;280;474;-7;-219;194;255000
vpja26;1;851;1046;-36;-239,3;195;255255255
vpja26;1;1065;1279;-19,2;-215,8;214;255000
vpja26;1;1291;1447;-25,4000000000001;-215,9;156;255000
vpja26;1;1470;1709;-14,2;-252,4;239;255000
vpja26;1;1731;2038;2,39999999999998;-249,2;307;255000
vpja26;1;2068;2221;-27,2;-199,9;153;255000
vpja26;1;3211;3604;222,2;138,4;393;255255255
vpja26;1;3689;4472;-27,2;-218,9;783;255000
vpja26;1;4631;4838;16,3;-247,2;207;255000
vpja26;1;4869;6080;-2,90000000000009;-231,5;1211;255000
vpja26;1;6159;6282;-250,4;63,3;123;255255255
vpja26;1;6307;6562;-278,5;118,3;255;255255255
vpja26;1;6630;6799;-30,7;-233;169;255000
vpja26;1;6822;7214;-11,7;-203,8;392;255000
vpja26;1;7285;8216;-302,9;121;931;255255255
vpja26;1;8295;8467;240,3;169,9;172;255255255
vpja26;1;8503;8869;288;171,4;366;255255000
vpja26;1;8913;9075;430,8;50,1;162;255255255
vpja26;1;9145;9697;63,3;-198,9;552;2,55e+08
vpja26;1;9737;10000;189,2;-260,3;263;255255255
vpja26;2;213;469;-33;-142,9;256;255000
vpja26;2;489;630;-56,5;-174,8;141;255000
vpja26;2;1685;2034;-272,9;201,4;349;255
vpja26;2;2125;2392;331,8;241,2;267;255255000
vpja26;2;2403;2999;333,4;262,6;596;255255000
vpja26;2;3018;3534;355;247,6;516;255255000
vpja26;2;3575;3721;269,5;213,1;146;0
vpja26;2;3822;4072;-373,6;9;250;0
vpja26;2;4104;4359;-404,6;13,5;255;0
vpja26;2;4392;4686;-370,8;13,8;294;0
vpja26;2;4718;4907;-484,5;78;189;0
vpja26;2;5126;5296;-37,9;-122,3;170;2,55e+08
vpja26;2;5309;5776;-43,5999999999999;-143,3;467;255000
vpja26;2;6447;7757;-335,9;108,4;1310;255
vpja26;2;7941;8225;-302,3;151,1;284;255
vpja26;2;8955;9088;-457,4;183,7;133;255
vpja26;2;9110;9574;-469,3;209,6;464;255
vpja26;2;9605;9791;-436,5;220,3;186;255
vpja26;2;9856;10000;-523,5;-134,6;144;0
vpja26;3;225;361;-2,1036764705882;-191,81875;136;2,55e+08
vpja26;3;384;709;-19,3036764705882;-235,41875;325;255000
vpja26;3;1855;2105;-369,103676470588;116,68125;250;255
vpja26;3;2126;2198;-366,703676470588;119,38125;72;255
vpja26;3;2493;2676;-598,003676470588;69,18125;183;0
vpja26;3;2704;2847;-613,603676470588;60,58125;143;0
vpja26;3;2879;3430;-579,503676470588;48,58125;551;0
vpja26;3;3548;3644;189,396323529412;128,68125;96;0
vpja26;3;3671;3956;255,596323529412;121,08125;285;255255000
vpja26;3;4015;4248;540,696323529412;-49,81875;233;0
vpja26;3;4290;4498;508,296323529412;-202,31875;208;0
vpja26;3;4539;4798;522,796323529412;-282,11875;259;0
vpja26;3;4823;4993;552,296323529412;-331,71875;170;0
vpja26;3;5043;5470;616,196323529412;-54,31875;427;0
vpja26;3;5515;5653;613,196323529412;104,18125;138;0
vpja26;3;5728;6060;575,196323529412;469,38125;332;0
vpja26;3;6081;6337;586,996323529412;435,08125;256;0
vpja26;3;6404;6634;581,196323529412;-70,0187500000001;230;0
vpja26;3;6729;6849;-47,7036764705882;-259,61875;120;0
vpja26;3;6882;7077;-15,8036764705882;-249,81875;195;255000
vpja26;3;7097;7316;-20,7036764705882;-287,61875;219;255000
vpja26;3;7330;8131;-6,6036764705882;-274,81875;801;255000
vpja26;3;8227;8480;-523,903676470588;-312,51875;253;0
vpja26;3;8538;8803;-540,603676470588;-39,5187500000001;265;0
vpja26;3;8849;9017;-619,203676470588;77,9812499999999;168;0
vpja26;3;9066;9220;-337,603676470588;138,48125;154;255
vpja26;3;9304;10000;268,796323529412;123,08125;696;255255000
vpja26;4;184;302;-4,60000000000002;-215,6;118;2,55e+08
vpja26;4;335;662;14,8;-248;327;255000
vpja26;4;744;1107;294;203,7;363;255
vpja26;4;1650;1860;39,6999999999999;-255,4;210;255000
vpja26;4;1880;2144;30,0999999999999;-294;264;255000
vpja26;4;2234;2381;276,8;162,1;147;0
vpja26;4;2411;2544;295,2;189,4;133;255
vpja26;4;2744;2808;-339,6;140,2;64;0
vpja26;4;2842;2895;-318,6;113,6;53;255255000
vpja26;4;2916;2938;-318,6;113,8;22;255255000
vpja26;4;3102;3310;-362,6;-171,1;208;0
vpja26;4;3374;3720;16,8;-251,4;346;255000
vpja26;4;3759;3918;-18,9000000000001;-117,7;159;2,55e+08
vpja26;4;3976;5396;-344,4;90,6;1420;0
vpja26;4;5436;5758;-283;3,20000000000005;322;0
vpja26;4;5829;6028;-314,4;-389,5;199;0
vpja26;4;6082;6386;-84,3000000000001;-384,4;304;0
vpja26;4;6398;6652;-89,6;-402,3;254;0
vpja26;4;6718;7232;-522,8;-454,2;514;0
vpja26;4;7405;7642;-327,6;-318,2;237;0
vpja26;4;7688;7865;-72,8000000000001;-403,8;177;0
vpja26;4;7894;8039;53,8999999999999;-415;145;255000
vpja26;4;8078;8262;230,7;-395;184;0
vpja26;4;8303;8526;234,5;-190,3;223;0
vpja26;4;8574;8754;431,6;-37,5;180;0
vpja26;4;8795;8980;500,2;56,4;185;0
vpja26;4;9038;9150;544,4;266,5;112;0
vpja26;4;9176;9300;563,6;322,4;124;0
vpja26;4;9355;9512;198,8;109,7;157;0
vpja26;4;9556;10000;292,3;196,5;444;255
vpja26;5;208;322;72,8000000000001;-157,3;114;2,55e+08
vpja26;5;345;491;115,4;-146,9;146;255000
vpja26;5;511;834;138;-143,4;323;255000
vpja26;5;887;1082;160,3;111,9;195;255
vpja26;5;1107;1317;203,9;178,5;210;255
vpja26;5;1407;1702;-378,2;125,3;295;255255000
vpja26;5;1759;1924;-363,7;-71,8000000000001;165;0
vpja26;5;1967;2303;-113,1;-113,9;336;0
vpja26;5;2379;2574;166,2;123,8;195;255
vpja26;5;2640;2774;119,4;-218,6;134;255000
vpja26;5;2799;2958;139;-170,4;159;255000
vpja26;5;2980;3143;160,5;-137,8;163;2,55e+08
vpja26;5;3210;3483;233,1;239,6;273;255
vpja26;5;3552;3694;144,1;-102,7;142;2,55e+08
vpja26;5;3713;3921;149,5;-134,8;208;255000
vpja26;5;3943;4159;136,7;-187,5;216;255000
vpja26;5;4208;4587;-101,9;-318,2;379;0
vpja26;5;4646;4849;-107;-110,8;203;0
vpja26;5;4926;5172;364,2;-333,3;246;0
vpja26;5;5202;5387;330,8;-311,2;185;0
vpja26;5;5455;5659;-130;-331,6;204;0
vpja26;5;5685;5853;-103,2;-323,6;168;0
vpja26;5;5924;6117;-461,8;-84,7;193;0
vpja26;5;6166;6358;-228;-77,2;192;0
vpja26;5;6399;6640;-104,1;-92,3;241;0
vpja26;5;6693;6943;36,3000000000001;-274,1;250;0
vpja26;5;7050;7270;-479,4;88,1;220;255255000
vpja26;5;7387;7537;324,2;-259,2;150;0
vpja26;5;7593;7744;-49,9;-307;151;0
vpja26;5;7768;7968;-101,3;-332,5;200;0
vpja26;5;7998;8125;-205,2;-327,3;127;0
vpja26;5;8180;8297;96,6999999999999;-171,1;117;255000
vpja26;5;8333;8614;153,3;-145,6;281;255000
vpja26;5;8699;8907;-410,3;-146,1;208;0
vpja26;5;8938;9298;-396,5;-67,7;360;0
vpja26;5;9367;9495;-550,6;308,8;128;0
vpja26;5;9537;9732;-558,1;429,6;195;0
vpja26;5;9761;10000;-538,4;337,4;239;0
vpja26;6;234;327;88,5999999999999;-216,7;93;2,55e+08
vpja26;6;352;892;129,4;-262,6;540;255000
vpja26;6;908;1046;133,6;-286;138;255000
vpja26;6;1121;1342;294,9;133,4;221;255
vpja26;6;1369;1634;353,2;68,9;265;255
vpja26;6;1656;1679;374,1;41,5999999999999;23;255
vpja26;6;1698;2350;406,6;34,8;652;255
vpja26;6;2434;2942;-90,6;35,1999999999999;508;255255000
vpja26;6;3015;3209;350,1;89,6999999999999;194;255
vpja26;6;3234;3657;400,6;31,9;423;255
vpja26;6;3691;4388;304,2;85,8;697;255
vpja26;6;4446;4909;-61,3000000000001;43,5999999999999;463;255255000
vpja26;6;4940;5356;-172,5;86,5;416;0
vpja26;6;5380;5570;-202,2;145,3;190;0
vpja26;6;5619;5969;-74,2;178;350;0
vpja26;6;5994;6142;-64,1;248,8;148;0
vpja26;6;6167;6367;2,79999999999995;303,6;200;0
vpja26;6;6426;6612;199,8;344,1;186;0
vpja26;6;6644;6870;338,6;377,1;226;0
vpja26;6;6912;7036;430,4;386,1;124;0
vpja26;6;7164;7333;-536;184,5;169;0
vpja26;6;7373;7555;-556,2;41,9;182;0
vpja26;6;7594;7811;-588,3;-51;217;0
vpja26;6;7854;8007;-408;-124,3;153;0
vpja26;6;8062;8139;-200,8;-126,8;77;0
vpja26;6;8193;8331;105;-268,9;138;2,55e+08
vpja26;6;8362;8763;134,1;-262,5;401;255000
vpja26;6;8917;9255;122;-286,9;338;255000
vpja26;6;9276;9605;139,2;-269;329;255000
vpja26;6;9627;9892;125,4;-259;265;255000
vpja26;6;9899;10000;130,9;-251,3;101;255000
vpja26;7;211;339;-376,5;-121,4;128;255000
vpja26;7;355;1546;-385,7;-97,1999999999999;1191;255000
vpja26;7;1799;1953;-377,3;-100,6;154;255000
vpja26;7;2097;2287;-109,1;-251,6;190;0
vpja26;7;2298;2606;-118,2;-236,9;308;0
vpja26;7;2706;3521;-281,1;49,8000000000001;815;255
vpja26;7;3576;3679;28,7;57,7;103;255255000
vpja26;7;3828;4024;505,8;-252,8;196;0
vpja26;7;4075;4210;406,1;-121,1;135;0
vpja26;7;4241;4665;436,5;-106,5;424;0
vpja26;7;4772;4896;-323,7;-139,3;124;255000
vpja26;7;4933;5251;-378,3;-107,3;318;255000
vpja26;7;5263;5447;-380,1;-126,6;184;255000
vpja26;7;5470;5617;-346,6;-131,9;147;255000
vpja26;7;5662;5887;-192,1;-215,2;225;0
vpja26;7;5908;6326;-174,3;-229,3;418;0
vpja26;7;6396;6495;-8,5;16,8000000000001;99;0
vpja26;7;6519;6979;7;60,6;460;255255000
vpja26;7;7043;7221;-74,1999999999999;-212,5;178;0
vpja26;7;7267;7607;56;-366,4;340;0
vpja26;7;7680;7791;-327,3;-208,8;111;255000
vpja26;7;7819;8023;-371,6;-119,7;204;255000
vpja26;7;8068;8436;-212,7;-196;368;0
vpja26;7;8464;8693;-122;-196,5;229;0
vpja26;7;8739;9864;-389,7;-95,4999999999999;1125;0
vpja26;7;9898;10000;-359,6;-107,4;102;255000
vpja26;8;237;398;-274,5;-134,7;161;255000
vpja26;8;422;729;-267,5;-141,6;307;255000
vpja26;8;795;1422;205,1;23,1;627;0
vpja26;8;1489;1741;-144,6;322,8;252;255255000
vpja26;8;1766;2067;-109,9;340,2;301;255255000
vpja26;8;2131;2282;203,5;33;151;0
vpja26;8;2317;2577;245;17,7;260;255
vpja26;8;2618;2907;235;-98,1999999999999;289;0
vpja26;8;2963;3117;-109,9;-209,4;154;0
vpja26;8;3158;3302;-320,4;-253,2;144;255000
vpja26;8;3337;3559;-462,7;-222,2;222;0
vpja26;8;3577;3844;-448,6;-221,4;267;0
vpja26;8;3897;4142;-614,3;-235,8;245;0
vpja26;8;4157;4428;-618,7;-258;271;0
vpja26;8;4456;4649;-546,8;-324,3;193;0
vpja26;8;4679;4915;-529,5;-339,2;236;0
vpja26;8;4941;5198;-584;-328,3;257;0
vpja26;8;5231;5343;-526,3;-337;112;0
vpja26;8;5391;5537;-422,2;-225,1;146;0
vpja26;8;5566;5729;-443,9;-220,4;163;0
vpja26;8;5764;6002;-615,8;-237,8;238;0
vpja26;8;6022;6313;-616,2;-254,8;291;0
vpja26;8;6363;6540;-432,4;-209,6;177;0
vpja26;8;6677;6880;-446;-220,6;203;0
vpja26;8;6903;7366;-442,2;-216;463;0
vpja26;8;7408;7621;-622,6;-248;213;0
vpja26;8;7650;8068;-617,3;-253,6;418;0
vpja26;8;8120;8246;-308,1;-199,2;126;255000
vpja26;8;8285;8748;-243,8;-159,6;463;255000
vpja26;8;8824;8966;-647,1;-231,8;142;NA
vpja26;8;8997;9214;-622,6;-241;217;0
vpja26;8;9398;9538;-616,9;-77;140;0
vpja26;8;9584;9785;-603;-239,2;201;0
vpja26;8;9811;10000;-549,4;-321,4;189;0
vpja26;9;207;345;-40,5;-199,3;138;255000
vpja26;9;369;646;-23,4000000000001;-209,8;277;255000
vpja26;9;668;815;-29,7;-236,3;147;255000
vpja26;9;883;1091;284,4;197,1;208;255
vpja26;9;1114;1233;304,6;190,4;119;255
vpja26;9;1735;2005;-43,5;-241,9;270;255000
vpja26;9;2038;2208;-13,6;-234,8;170;255000
vpja26;9;2229;2622;-24;-205,9;393;255000
vpja26;9;2707;3366;332,2;212,6;659;255
vpja26;9;3439;3548;104,8;-111,6;109;0
vpja26;9;3588;3847;-31,7;-245,5;259;255000
vpja26;9;3873;4081;77,5999999999999;-274,5;208;0
vpja26;9;4111;4349;-16,4000000000001;-224,5;238;255000
vpja26;9;4373;4692;-22,7;-195,3;319;255000
vpja26;9;4907;4973;-433,7;170;66;255255000
vpja26;9;5256;5510;-497,6;97,4;254;0
vpja26;9;5537;5689;-427,9;125,9;152;255255000
vpja26;9;5750;5913;-498,1;-212,6;163;0
vpja26;9;5939;6064;-527,7;-190;125;0
vpja26;9;6216;6430;74,5;-376,9;214;0
vpja26;9;6466;6612;177,2;-297,7;146;0
vpja26;9;6638;6796;206,7;-229,6;158;0
vpja26;9;6883;7027;350,4;269,5;144;255
vpja26;9;7056;7356;316,7;195,4;300;255
vpja26;9;7399;7713;360,9;47;314;0
vpja26;9;7758;8305;147,7;16,6;547;0
vpja26;9;8337;9953;-27,2;29,3000000000001;1616;2,55e+08
vpja26;10;199;343;-102,138129496403;-151,871223021583;144;255000
vpja26;10;368;791;-131,438129496403;-159,071223021583;423;255000
vpja26;10;1153;1235;-269,038129496403;81,3287769784173;82;0
vpja26;10;1313;1555;-144,838129496403;-289,471223021583;242;0
vpja26;10;1618;1943;-472,538129496403;-139,471223021583;325;0
vpja26;10;2011;2157;-383,138129496403;143,028776978417;146;0
vpja26;10;2192;2405;-321,538129496403;167,128776978417;213;0
vpja26;10;2431;2580;-285,238129496403;161,528776978417;149;0
vpja26;10;2599;2730;-274,138129496403;156,528776978417;131;0
vpja26;10;2784;2955;-144,438129496403;-160,371223021583;171;255000
vpja26;10;2975;3323;-133,338129496403;-154,171223021583;348;255000
vpja26;10;3359;3692;23,4618705035971;34,6287769784172;333;2,55e+08
vpja26;10;3729;3960;2,56187050359699;148,728776978417;231;255255000
vpja26;10;4001;4169;-158,438129496403;68,4287769784173;168;2,55e+08
vpja26;10;4183;4351;-144,738129496403;73,4287769784173;168;2,55e+08
vpja26;10;4410;4619;-193,538129496403;313,328776978417;209;0
vpja26;10;4643;4829;-238,038129496403;349,228776978417;186;0
vpja26;10;4883;5189;-471,038129496403;206,428776978417;306;0
vpja26;10;5221;5424;-322,138129496403;159,428776978417;203;0
vpja26;10;5489;5822;-114,338129496403;-158,571223021583;333;255000
vpja26;10;5866;6132;102,561870503597;-315,471223021583;266;0
vpja26;10;6321;6496;102,061870503597;-224,371223021583;175;0
vpja26;10;6561;6787;-17,6381294964029;148,228776978417;226;255255000
vpja26;10;6824;7242;-140,438129496403;317,528776978417;418;0
vpja26;10;7265;7665;-118,538129496403;285,328776978417;400;0
vpja26;10;7711;7948;-278,638129496403;129,928776978417;237;0
vpja26;10;7973;10000;-228,838129496403;142,128776978417;2027;0
vpja26;11;179;288;-45,2;-155,9;109;2,55e+08
vpja26;11;312;558;-86,6;-232,2;246;255000
vpja26;11;654;694;-522;310,9;40;0
vpja26;11;1139;1259;-505,1;298,9;120;0
vpja26;11;1351;1473;-158,1;-269,7;122;255000
vpja26;11;1508;1668;-107,4;-248,4;160;255000
vpja26;11;1692;2044;-92,6;-307,7;352;255000
vpja26;11;2073;2469;-97,6;-230,9;396;255000
vpja26;11;2526;2958;-324,5;-223,9;432;0
vpja26;11;2997;3302;-459,5;-234,8;305;0
vpja26;11;3401;3605;274,2;-38,4;204;0
vpja26;11;3631;3814;312,4;-7;183;0
vpja26;11;3879;4048;483;-365,4;169;0
vpja26;11;4072;4350;526,4;-341,4;278;0
vpja26;11;4422;4656;553,5;71,7;234;0
vpja26;11;4686;5051;423,1;97;365;0
vpja26;11;5109;5260;319,4;286,3;151;255255000
vpja26;11;5367;5505;-486,1;335;138;255
vpja26;11;5600;5730;350,3;355,5;130;255255000
vpja26;11;5762;5884;398,9;376,2;122;0
vpja26;11;5903;6302;385;374,7;399;0
vpja26;11;6428;6517;-397,6;314,7;89;0
vpja26;11;6577;6850;-522,7;351,1;273;0
vpja26;11;6881;7004;-544,5;351,9;123;0
vpja26;11;7064;7331;-148;142,3;267;2,55e+08
vpja26;11;7370;7585;-22,8000000000001;134,3;215;2,55e+08
vpja26;11;7649;7899;-30,2;-67,5;250;2,55e+08
vpja26;11;7942;8109;-118,9;-276,7;167;255000
vpja26;11;8135;8540;-89,7;-319,4;405;255000
vpja26;11;8657;8873;344,2;300,4;216;255255000
vpja26;11;8901;9094;392,2;366,5;193;255255000
vpja26;11;9105;10000;385,5;368,1;895;255255000
vpja26;12;196;373;-12,4;-205,6;177;255000
vpja26;12;404;605;-58,9;-226,5;201;255000
vpja26;12;632;842;-51,7;-294,8;210;255000
vpja26;12;864;1100;-30;-296,1;236;255000
vpja26;12;1134;1258;-66,1;-221,7;124;255000
vpja26;12;1347;1575;-555;313,9;228;255
vpja26;12;1781;2060;-470,1;111,2;279;0
vpja26;12;2307;2563;-232,4;347,8;256;0
vpja26;12;2600;2732;-152,1;261,2;132;2,55e+08
vpja26;12;2781;2941;44,1;278,5;160;255255000
vpja26;12;2964;3203;3,89999999999998;302,3;239;255255000
vpja26;12;3252;3425;272,2;338,9;173;0
vpja26;12;3468;3603;403,3;249,9;135;0
vpja26;12;3644;3948;475,8;162,2;304;0
vpja26;12;4012;4162;363,3;311,1;150;0
vpja26;12;4206;4452;396,8;381,1;246;0
vpja26;12;4516;4725;31,9;428,1;209;255255000
vpja26;12;4820;4993;-554;334,3;173;255
vpja26;12;5024;5177;-554,5;267,4;153;255
vpja26;12;5242;5416;-545,9;-110;174;0
vpja26;12;5478;5717;-595,5;334,5;239;255
vpja26;12;5743;5937;-526,2;309;194;255
vpja26;12;6019;6333;-518,9;-236,1;314;0
vpja26;12;6360;6573;-566,2;-315,7;213;0
vpja26;12;6599;6825;-628,7;-319;226;0
vpja26;12;6857;7220;-633,7;-446,5;363;0
vpja26;12;7259;7571;-476,9;-255,3;312;0
vpja26;12;7631;7717;-542;-115,3;86;0
vpja26;12;7790;8074;-576,6;314,6;284;255
vpja26;12;8146;8270;-465;316,3;124;255
vpja26;12;8554;8963;-500,7;109,6;409;0
vpja26;12;9019;9092;-510,2;317,5;73;255
vpja26;12;9290;10000;-493,2;329,4;710;255
vpja26;13;191;268;-64,3000000000001;-224,8;77;2,55e+08
vpja26;13;293;421;-95,7;-294;128;2,55e+08
vpja26;13;445;1169;-88,8000000000001;-326,3;724;255000
vpja26;13;1248;1388;-453,8;-314,4;140;0
vpja26;13;1469;1606;-498,3;134,8;137;0
vpja26;13;1814;2127;251,7;139,6;313;255
vpja26;13;2154;2394;160,2;157,8;240;255
vpja26;13;2436;2966;246,3;300;530;0
vpja26;13;2989;3112;279,1;289,3;123;0
vpja26;13;3153;3322;202,3;161,8;169;255
vpja26;13;3427;3477;-126,8;109,4;50;2,55e+08
vpja26;13;4057;4722;-505,8;287,2;665;0
vpja26;13;4780;5004;-457,9;73,1;224;0
vpja26;13;5058;5217;-433,7;-72,8000000000001;159;0
vpja26;13;5270;5491;-512,4;-253,4;221;0
vpja26;13;5524;6017;-511,6;-391,9;493;0
vpja26;13;6083;6222;-64,8000000000001;-349,7;139;255000
vpja26;13;6251;6624;-85,3000000000001;-334,2;373;255000
vpja26;13;6664;6936;-111,5;-211,9;272;2,55e+08
vpja26;13;6968;7101;-100,9;-324,1;133;2,55e+08
vpja26;13;7123;7676;-84,7;-318,8;553;2,55e+08
vpja26;13;7728;7973;-96;-103,5;245;2,55e+08
vpja26;13;8004;8132;-75,2;-133,5;128;2,55e+08
vpja26;13;8207;8416;371,6;-186,6;209;0
vpja26;13;8447;8638;414,9;-153,6;191;0
vpja26;13;8695;9033;86,1999999999999;-297,2;338;0
vpja26;13;9187;9327;44,6999999999999;-259,7;140;0
vpja26;13;9487;10000;-86,9;-328;513;255000
vpja26;14;217;371;-355,724841636351;-212,189610103235;154;255000
vpja26;14;404;609;-407,424841636351;-220,989610103235;205;255000
vpja26;14;687;1029;-513,024841636351;304,210389896765;342;255
vpja26;14;1113;1323;-409,124841636351;-231,289610103235;210;255000
vpja26;14;1352;1624;-390,924841636351;-225,189610103235;272;255000
vpja26;14;1655;1996;-364,624841636351;-254,589610103235;341;255000
vpja26;14;2083;2340;-602,824841636351;-234,889610103235;257;0
vpja26;14;2365;2517;-578,124841636351;-255,589610103235;152;0
vpja26;14;2611;2737;-513,524841636351;202,110389896765;126;2,55e+08
vpja26;14;2765;3044;-511,624841636351;286,110389896765;279;255
vpja26;14;3101;3222;-253,924841636351;153,610389896765;121;0
vpja26;14;3288;3410;138,075158363649;100,510389896765;122;0
vpja26;14;3447;3590;249,075158363649;12,7103898967647;143;0
vpja26;14;3633;3849;376,075158363649;-131,589610103235;216;0
vpja26;14;3918;4137;67,4751583636488;172,410389896765;219;255255000
vpja26;14;4172;4406;115,375158363649;188,310389896765;234;255255000
vpja26;14;4442;4611;63,2751583636488;216,310389896765;169;255255000
vpja26;14;4635;4736;35,1751583636487;208,810389896765;101;255255000
vpja26;14;4818;5006;-519,224841636351;340,410389896765;188;255
vpja26;14;5029;5579;-534,324841636351;302,010389896765;550;255
vpja26;14;5639;5784;-173,824841636351;313,210389896765;145;0
vpja26;14;5816;6144;-133,624841636351;303,310389896765;328;0
vpja26;14;6191;6377;87,3751583636487;182,110389896765;186;255255000
vpja26;14;6450;6575;393,675158363649;-126,189610103235;125;0
vpja26;14;6603;6809;403,375158363649;-193,989610103235;206;0
vpja26;14;6847;7060;393,175158363649;-234,589610103235;213;0
vpja26;14;7104;7267;260,775158363649;-82,5896101032354;163;0
vpja26;14;7368;7550;-555,024841636351;345,310389896765;182;255
vpja26;14;7582;7784;-539,424841636351;304,810389896765;202;255
vpja26;14;7969;8213;-403,224841636351;-217,889610103235;244;255000
vpja26;14;8239;8732;-375,624841636351;-254,589610103235;493;255000
vpja26;14;8755;9111;-394,524841636351;-213,589610103235;356;255000
vpja26;14;9200;9496;82,4751583636488;159,910389896765;296;255255000
vpja26;14;9532;9796;100,675158363649;220,210389896765;264;255255000
vpja26;14;9818;9955;91,3751583636487;258,610389896765;137;255255000
vpja26;15;84;177;26,2;-1;93;2,55e+08
vpja26;15;226;371;-17,5;-283,2;145;2,55e+08
vpja26;15;394;786;-49,4;-325,4;392;255000
vpja26;15;851;1127;-372,3;-306,4;276;0
vpja26;15;1177;1433;-549,7;-280,2;256;0
vpja26;15;1473;1618;-468,7;-174,5;145;0
vpja26;15;1655;1781;-383,8;-124,7;126;0
vpja26;15;1803;2157;-407,7;-109,8;354;0
vpja26;15;2228;2480;-490;-385;252;0
vpja26;15;2528;2734;-316,3;-379,7;206;0
vpja26;15;2772;2942;-234;-381,2;170;0
vpja26;15;3030;3217;282,1;-212,7;187;0
vpja26;15;3245;3452;370,3;-242,6;207;0
vpja26;15;3478;3557;375,1;-290,2;79;0
vpja26;15;3647;3792;372,8;333,3;145;255255000
vpja26;15;3897;4100;-495,9;353,2;203;255
vpja26;15;4128;4345;-541,2;436,1;217;255
vpja26;15;4424;4629;-376,3;-114,4;205;0
vpja26;15;4655;4869;-417;-120,8;214;0
vpja26;15;5053;5248;-452,3;-385,3;195;0
vpja26;15;5280;5557;-302,4;-394,3;277;0
vpja26;15;5613;5855;-522,7;-423,9;242;0
vpja26;15;5914;6299;-204,7;-348,8;385;0
vpja26;15;6323;6607;-170;-359,3;284;0
vpja26;15;6653;6896;-17,8;-319,7;243;255000
vpja26;15;6911;7088;-24,4;-348,4;177;255000
vpja26;15;7110;7625;-17;-364,6;515;255000
vpja26;15;7646;7792;-43,9;-328,9;146;255000
vpja26;15;7816;8001;-33,5999999999999;-386,2;185;255000
vpja26;15;8021;8206;-18,5;-379,2;185;255000
vpja26;15;8260;8560;65,5;-143,3;300;2,55e+08
vpja26;15;8619;8925;30,7;52;306;2,55e+08
vpja26;15;9004;9150;326,9;-208,7;146;0
vpja26;15;9178;9369;369,2;-294,9;191;0
vpja26;15;9387;9656;375,3;-324;269;0
vpja26;15;9701;10000;561,5;-299,2;299;0
vpja26;16;216;327;-186,3;-171,3;111;2,55e+08
vpja26;16;352;706;-199,5;-217,2;354;2,55e+08
vpja26;16;751;922;-216,3;-54,6999999999999;171;2,55e+08
vpja26;16;944;1177;-195,8;-15,3;233;2,55e+08
vpja26;16;1222;1377;-200;-211,4;155;2,55e+08
vpja26;16;1398;1802;-198,4;-226,6;404;255000
vpja26;16;1867;2070;-468,4;4,10000000000002;203;255255000
vpja26;16;2102;2293;-536,3;84,4000000000001;191;0
vpja26;16;2362;2671;-41,3;71,8000000000001;309;255
vpja26;16;2692;2950;-20,6999999999999;53,6;258;255
vpja26;16;2995;3223;-39,6;187,7;228;0
vpja26;16;3255;3487;-114,1;271,5;232;0
vpja26;16;3507;3679;-99,1999999999999;271,1;172;0
vpja26;16;3751;3885;-194,8;-186,8;134;2,55e+08
vpja26;16;3905;4490;-203,2;-219,9;585;2,55e+08
vpja26;16;4566;4822;311,4;-389,8;256;0
vpja26;16;4910;5026;-238;-233,6;116;0
vpja26;16;5061;5424;-196,2;-229,4;363;255000
vpja26;16;5492;5768;278,9;-103,7;276;0
vpja26;16;5823;6032;590;-152,2;209;0
vpja26;16;6053;6238;580,4;-187;185;0
vpja26;16;6291;6491;485,8;-412,5;200;0
vpja26;16;6516;6718;417,5;-395,9;202;0
vpja26;16;6792;7024;362,9;-3,89999999999998;232;0
vpja26;16;7065;7195;304,9;106,1;130;0
vpja26;16;7244;7549;295,8;278,6;305;0
vpja26;16;7672;7835;-538,3;167,2;163;0
vpja26;16;7868;8033;-528,1;77,7;165;255255000
vpja26;16;8227;8646;-553,4;-83,1;419;255255000
vpja26;16;8679;9095;-621;66,1;416;0
vpja26;16;9699;9840;-122,3;240,1;141;2,55e+08
vpja26;16;9865;10000;-94,6;270;135;0
vpja26;17;180;577;44,8;-39,4000000000001;397;255000
vpja26;17;626;841;33;170,3;215;255
vpja26;17;860;1050;64,4000000000001;182,6;190;255
vpja26;17;1099;1332;288,4;126,6;233;255255000
vpja26;17;1367;1491;284,5;63,4;124;255255000
vpja26;17;1547;1683;42;-47;136;255000
vpja26;17;1706;1843;56;-46,3000000000001;137;255000
vpja26;17;1895;2302;305,3;-152;407;0
vpja26;17;2358;2545;-24;-186,8;187;0
vpja26;17;2626;2774;-565;38,5999999999999;148;0
vpja26;17;2814;3098;-599,3;158,4;284;0
vpja26;17;3167;3323;-467,6;-189,9;156;0
vpja26;17;3349;3579;-428,2;-291,9;230;0
vpja26;17;3664;3974;-607,1;153,4;310;0
vpja26;17;4062;4204;53;-61,8000000000001;142;255000
vpja26;17;4220;4769;47,7;-37,6;549;255000
vpja26;17;4827;5028;306,6;105,6;201;255255000
vpja26;17;5052;5203;271,5;97,3;151;255255000
vpja26;17;5254;5496;340,6;-145,7;242;0
vpja26;17;5519;5953;312,5;-158,8;434;0
vpja26;17;5962;6473;304,8;-157,1;511;0
vpja26;17;6490;6697;321,1;-125,8;207;0
vpja26;17;6748;7380;298,4;103,4;632;255255000
vpja26;17;7433;7779;40,7;186,9;346;255
vpja26;17;7990;8093;97,7;175;103;255
vpja26;17;8150;8807;57,8;-43,7;657;255000
vpja26;17;8862;9013;39,4;-198,1;151;0
vpja26;17;9038;9249;88;-259,9;211;0
vpja26;17;9275;9443;41,4;-263,1;168;0
vpja26;17;9479;10000;-16,1;-196;521;0
vpja26;18;194;473;-102;-165,5;279;255000
vpja26;18;1311;1746;86,2;92,9000000000001;435;255255000
vpja26;18;1805;1989;-121,8;-183,8;184;255000
vpja26;18;2001;2245;-117,7;-172,7;244;255000
vpja26;18;2262;2518;-122,2;-196,8;256;255000
vpja26;18;2541;2921;-97,6;-194,6;380;255000
vpja26;18;2946;3130;-117,7;-172,7;184;255000
vpja26;18;3137;3708;-111,1;-160,9;571;255000
vpja26;18;3728;3968;-115,4;-188,4;240;255000
vpja26;18;3993;4784;-91,4;-186,7;791;255000
vpja26;18;4810;5277;-112,4;-163,7;467;255000
vpja26;18;5296;5515;-110;-196,4;219;255000
vpja26;18;5577;5782;284,3;-50,0999999999999;205;0
vpja26;18;5807;5952;312,7;-62,4;145;0
vpja26;18;6007;6337;580,1;-193,3;330;0
vpja26;18;6358;6595;563,5;-235,8;237;0
vpja26;18;6693;6814;-71,5;27,4000000000001;121;2,55e+08
vpja26;18;8432;10000;45,8;69,8000000000001;1568;0
vpja26;19;184;340;-82,9;-75;156;255000
vpja26;19;364;818;-86,1;-96,7;454;255000
vpja26;19;876;1329;177,2;121,2;453;255
vpja26;19;1381;1505;-57,2;-62,1999999999999;124;2,55e+08
vpja26;19;1527;1836;-85,8000000000001;-97,9;309;255000
vpja26;19;1895;2764;189,1;127,4;869;255
vpja26;19;3147;3371;-503,6;134,8;224;255255000
vpja26;19;3562;3674;-466,2;-27,6999999999999;112;0
vpja26;19;3700;4005;-443,3;-101,7;305;0
vpja26;19;4027;4161;-462,9;-110,1;134;0
vpja26;19;4201;4451;-623,3;-138,1;250;0
vpja26;19;4524;4699;-93,1;-336,5;175;0
vpja26;19;4750;4867;-133,7;-95,8;117;0
vpja26;19;4892;5157;-91,7;-95,9;265;255000
vpja26;19;5177;5592;-81,7;-97;415;255000
vpja26;19;5654;5852;301,2;9,39999999999998;198;0
vpja26;19;5875;6058;345,7;17,4;183;0
vpja26;19;6147;6317;28,1999999999999;-379,6;170;0
vpja26;19;6344;6534;-51,6;-375,3;190;0
vpja26;19;6604;6856;-440,9;-373,4;252;0
vpja26;19;6911;7121;-598,1;-132,9;210;0
vpja26;19;7151;7338;-463,9;-107,4;187;0
vpja26;19;7357;7644;-448,9;-110,9;287;0
vpja26;19;7929;8082;-176,9;331,5;153;0
vpja26;19;8116;8245;-93,5;323,4;129;2,55e+08
vpja26;19;8284;8413;-50,7;191,8;129;2,55e+08
vpja26;19;8441;8658;-31,8000000000001;109,5;217;2,55e+08
vpja26;19;8708;8900;-81,9;-89,6999999999999;192;255000
vpja26;19;8908;9249;-74,8000000000001;-94,4;341;255000
vpja26;19;9299;9474;150;68,6;175;0
vpja26;19;9499;9791;182,4;120,4;292;255
vpja26;19;9817;10000;137,6;153,7;183;0
vpja26;20;89;217;-2,30000000000007;-9,60000000000002;128;0
vpja26;20;254;759;148,6;-116,6;505;255000
vpja26;20;1632;1770;132;-156,8;138;255000
vpja26;20;1793;1964;151,4;-123,3;171;255000
vpja26;20;1973;2544;145,2;-113,3;571;255000
vpja26;20;2584;2699;37,3;-215;115;0
vpja26;20;2773;3063;-370,3;-154;290;0
vpja26;20;5188;5339;-80,8000000000001;234,5;151;255
vpja26;20;5405;5563;333,3;349,9;158;255255000
vpja26;20;5591;5780;248,7;366,5;189;255255000
vpja26;20;5803;5913;288;392,1;110;255255000
vpja26;20;5986;6158;174,3;-98,3000000000001;172;255000
vpja26;20;6179;6749;148,2;-111,3;570;255000
vpja26;20;6771;6944;160;-126,3;173;255000
vpja26;20;6952;7223;156,4;-138,8;271;255000
vpja26;20;7414;7544;451,2;129,1;130;0
vpja26;20;7566;7793;405,2;135,2;227;0
vpja26;20;7853;8139;114,3;-15,5;286;2,55e+08
vpja26;20;8189;8409;5,79999999999995;181,5;220;0
vpja26;20;8441;8813;107,4;204,4;372;0
vpja26;20;8889;9216;-171,6;-75,5;327;0
vpja26;20;9258;9542;-382,7;-113,7;284;0
vpja26;20;9571;9694;-299,4;-180,7;123;0
vpja26;20;9740;9960;-73,3000000000001;-197,8;220;0
vpja26;21;197;307;-79,2;-189,5;110;255000
vpja26;21;341;579;-47,1;-213;238;255000
vpja26;21;648;1013;168,8;163,9;365;255
vpja26;21;1592;1781;154,3;155,8;189;255
vpja26;21;1807;2925;180,7;156,7;1118;255
vpja26;21;2942;3526;173;148,3;584;255
vpja26;21;3548;4417;185,9;157,5;869;255
vpja26;21;5007;5242;-477,1;0,200000000000045;235;0
vpja26;21;5304;6055;-473,2;-287,1;751;0
vpja26;21;6103;6370;-484,1;-468,5;267;0
vpja26;21;6523;7437;-475,3;-323,7;914;0
vpja26;21;7467;7722;-398,6;-242,8;255;0
vpja26;21;7778;7936;-177,7;-157,8;158;2,55e+08
vpja26;21;7966;8228;-66,8;-222,7;262;255000
vpja26;21;8245;8807;-60,8;-198,1;562;255000
vpja26;21;8828;8952;-93,2;-192,4;124;255000
vpja26;21;8971;9227;-65;-187,6;256;255000
vpja26;21;9251;9486;-47,4;-230,1;235;255000
vpja26;21;9533;9723;-140;-43,9;190;2,55e+08
vpja26;21;9749;9946;-136,3;-101,9;197;2,55e+08
vpja26;22;209;342;-151;-181,1;133;2,55e+08
vpja26;22;360;582;-172,7;-212;222;255000
vpja26;22;628;926;-410,1;-224,7;298;0
vpja26;22;1019;1047;-507,4;288,4;28;255
vpja26;22;1250;1274;-501,8;291,3;24;255
vpja26;22;1746;1988;313,2;273;242;0
vpja26;22;2019;2230;289,6;260,5;211;0
vpja26;22;2265;2411;278,5;367,6;146;0
vpja26;22;2430;2637;282,7;389,9;207;0
vpja26;22;2668;2839;286,4;282,5;171;0
vpja26;22;2865;2989;294,4;213,9;124;0
vpja26;22;3034;3301;295,6;-28,7;267;255255000
vpja26;22;3326;3497;337,8;-73;171;255255000
vpja26;22;3546;3717;362,8;177,6;171;0
vpja26;22;4056;4317;-487,5;311,7;261;255
vpja26;22;4382;4709;-482,8;51,6;327;0
vpja26;22;4760;4870;-201,4;-136,6;110;2,55e+08
vpja26;22;4896;5061;-172,3;-199,5;165;255000
vpja26;22;5081;5219;-164,2;-210,3;138;255000
vpja26;22;5262;5542;-404,4;-246,5;280;0
vpja26;22;5605;5813;-174,5;-64,8;208;2,55e+08
vpja26;22;5840;5984;-85,9000000000001;-115,7;144;2,55e+08
vpja26;22;6041;6228;-23,2;-359,2;187;0
vpja26;22;6293;6508;-399,7;-273,7;215;0
vpja26;22;6531;6776;-411,7;-226,4;245;0
vpja26;22;6832;7199;-481;41,6;367;0
vpja26;22;7234;7360;-514,3;126;126;0
vpja26;22;7388;7556;-463,9;31,3;168;0
vpja26;22;7582;7857;-443,9;11,3;275;0
vpja26;22;8031;8144;-405,6;-5,20000000000005;113;0
vpja26;22;8165;8688;-418,4;19;523;0
vpja26;22;8720;9036;-522,7;41,2;316;0
vpja26;22;9071;9317;-465,2;15,6;246;0
vpja26;22;9343;9624;-449,5;-43,3;281;0
vpja26;22;9655;9857;-548,5;37;202;0
vpja26;22;9872;10000;-545,9;60,3;128;0
vpja26;23;266;454;-49,5248416363513;-97,7896101032354;188;255000
vpja26;23;472;737;-63,2248416363512;-127,989610103235;265;255000
vpja26;23;816;922;-530,024841636351;121,810389896765;106;0
vpja26;23;948;1153;-582,324841636351;173,710389896765;205;0
vpja26;23;1231;1436;-117,224841636351;289,810389896765;205;255255000
vpja26;23;1466;1590;-91,9248416363513;242,510389896765;124;255255000
vpja26;23;1638;1848;-42,7248416363512;-135,789610103235;210;255000
vpja26;23;1873;2079;-64,1248416363513;-90,6896101032353;206;255000
vpja26;23;2092;2472;-51,8248416363513;-77,2896101032353;380;255000
vpja26;23;2545;2579;-401,124841636351;61,5103898967647;34;0
vpja26;23;2831;3026;-586,724841636351;192,410389896765;195;0
vpja26;23;3064;3242;-533,124841636351;83,6103898967647;178;0
vpja26;23;3327;3540;-92,6248416363513;302,210389896765;213;255255000
vpja26;23;3566;3731;-65,6248416363513;249,810389896765;165;255255000
vpja26;23;3757;3898;1,77515836364876;193,710389896765;141;2,55e+08
vpja26;23;3956;4139;-14,7248416363512;-150,389610103235;183;255000
vpja26;23;4166;4440;-47,5248416363513;-124,489610103235;274;255000
vpja26;23;4460;4663;-35,5248416363513;-131,889610103235;203;255000
vpja26;23;4706;4953;43,6751583636487;-244,389610103235;247;255000
vpja26;23;5018;5422;36,1751583636487;105,510389896765;404;2,55e+08
vpja26;23;5452;6220;31,9751583636487;197,010389896765;768;2,55e+08
vpja26;23;6267;6470;35,0751583636487;-69,7896101032353;203;255000
vpja26;23;6496;6796;-36,9248416363513;-98,3896101032353;300;255000
vpja26;23;6856;7437;-93,1248416363513;255,010389896765;581;255255000
vpja26;23;7645;8071;58,4751583636488;-233,289610103235;426;255000
vpja26;23;8115;8291;-60,6248416363513;-108,489610103235;176;255000
vpja26;23;8309;8628;-56,0248416363513;-80,9896101032353;319;255000
vpja26;23;8652;9011;-47,8248416363513;-127,589610103235;359;255000
vpja26;23;9105;9238;-510,524841636351;96,0103898967647;133;0
vpja26;23;9278;9374;-571,724841636351;151,710389896765;96;0
vpja26;23;9455;9708;-66,8248416363513;-146,389610103235;253;255000
vpja26;23;9763;10000;26,7751583636488;77,2103898967647;237;2,55e+08
vpja26;24;199;257;-26,1;-128,1;58;2,55e+08
vpja26;24;291;423;-42,6;-251,7;132;0
vpja26;24;449;708;-26,6;-268;259;255000
vpja26;24;751;966;-55,9;-91,2;215;255
vpja26;24;1013;1196;-24,1;-257,9;183;255000
vpja26;24;1214;2453;-17,7;-263;1239;255000
vpja26;24;2506;4747;-50,3;-15,5;2241;255
vpja26;24;4774;5612;-38,2;-101,3;838;255
vpja26;24;5785;6168;-213,8;-12,9;383;255255000
vpja26;24;6210;7142;-23,7;-76,1999999999999;932;255
vpja26;24;7173;7565;-50,7;23;392;255
vpja26;24;7624;7835;-289,2;279,3;211;0
vpja26;24;7873;8171;-346,6;446;298;0
vpja26;24;8238;8349;-275,5;202,6;111;0
vpja26;24;8394;8692;-237,2;36,6;298;255255000
vpja26;24;8748;8832;-396,5;-28,4;84;0
vpja26;24;8888;9055;-584,4;3;167;0
vpja26;24;9106;9412;-579,6;-186,6;306;0
vpja26;24;9461;9615;-445,5;-157,3;154;0
vpja26;24;9646;9804;-298;-176,5;158;0
vpja26;24;9831;10000;-196,8;-221,2;169;0
vpja26;25;215;319;23,9;-178,5;104;2,55e+08
vpja26;25;345;684;39,6;-238,9;339;255000
vpja26;25;700;976;34,2;-282,2;276;255000
vpja26;25;1053;1444;297,4;184,7;391;0
vpja26;25;1466;1801;300,8;225,9;335;255
vpja26;25;2267;2480;325,4;186,1;213;0
vpja26;25;2505;3538;385,8;183,5;1033;255
vpja26;25;3569;3871;341,7;216;302;255
vpja26;25;3902;4487;299,2;241,3;585;255
vpja26;25;4817;4979;-351,2;-110,1;162;0
vpja26;25;5015;5443;-292;-110,4;428;0
vpja26;25;5522;5660;225,7;-99,8;138;0
vpja26;25;5685;5976;263,7;-90,5;291;0
vpja26;25;6166;6400;-231,6;-90,4;234;0
vpja26;25;6438;6563;-302,1;-98,2;125;0
vpja26;25;6617;6971;-432,6;-369,2;354;0
vpja26;25;7028;7420;-61;-390,5;392;0
vpja26;25;7520;7667;-315,2;71,7;147;0
vpja26;25;7700;7866;-295,4;137,6;166;255255000
vpja26;25;7892;8186;-329;146,3;294;255255000
vpja26;25;8258;8482;-2,10000000000002;110,9;224;0
vpja26;25;8513;8725;107,2;212,3;212;0
vpja26;25;8770;8914;322,1;195,8;144;255
vpja26;25;8987;9729;54,8;-252,8;742;255000
vpja26;25;9772;9900;170,1;-130;128;0
vpja26;25;9930;10000;260,6;-100,5;70;0
vpja26;26;6;169;12,9456066945608;1,23933054393319;163;0
vpja26;26;220;515;-199,454393305439;-225,960669456067;295;255000
vpja26;26;907;1025;-451,954393305439;297,539330543933;118;255255000
vpja26;26;1046;1175;-451,254393305439;298,939330543933;129;255255000
vpja26;26;1241;1367;-352,854393305439;-12,2606694560668;126;2,55e+08
vpja26;26;1397;1534;-233,154393305439;-46,6606694560668;137;2,55e+08
vpja26;26;1579;1738;-217,754393305439;-244,960669456067;159;255000
vpja26;26;1760;2142;-203,754393305439;-238,460669456067;382;255000
vpja26;26;2160;2420;-206,554393305439;-226,660669456067;260;255000
vpja26;26;2477;2700;123,945606694561;-241,260669456067;223;0
vpja26;26;2738;2901;-0,954393305439226;-254,160669456067;163;0
vpja26;26;2918;3116;14,7456066945608;-265,360669456067;198;0
vpja26;26;3144;3450;-60,4543933054392;-255,660669456067;306;0
vpja26;26;3472;3693;-42,4543933054392;-211,060669456067;221;0
vpja26;26;3740;3926;-192,954393305439;-223,160669456067;186;255000
vpja26;26;3947;4087;-203,554393305439;-237,160669456067;140;255000
vpja26;26;4104;4403;-199,054393305439;-264,160669456067;299;255000
vpja26;26;4435;5045;-54,4543933054392;-235,660669456067;610;0
vpja26;26;5054;5382;-55,4543933054392;-245,560669456067;328;0
vpja26;26;7257;7508;-106,254393305439;189,039330543933;251;2,55e+08
vpja26;26;7529;7904;-90,7543933054392;203,039330543933;375;0
vpja26;26;8499;8718;-191,954393305439;-239,860669456067;219;255000
vpja26;26;8744;9038;-210,354393305439;-233,160669456067;294;255000
vpja26;26;9097;9315;146,645606694561;-269,260669456067;218;0
vpja26;26;9358;9610;323,845606694561;-340,160669456067;252;0
vpja26;26;9655;10000;291,345606694561;-178,660669456067;345;0
