vp;trial;timest;timeend;x;y;duration;roi
vpja82;1;345;508;-31,1999999999999;-121,9;163;255000
vpja82;1;524;897;-64;-136,7;373;255000
vpja82;1;906;1195;-50,4;-138,2;289;255000
vpja82;1;1206;1354;-61,4;-143,6;148;255000
vpja82;1;1415;1820;-544,8;144,8;405;255
vpja82;1;1828;2266;-558,4;151,4;438;255
vpja82;1;2322;2529;-73,5;274,1;207;255255000
vpja82;1;2549;2837;-80,6999999999999;229;288;0
vpja82;1;2848;3347;-92,5;237,4;499;255255000
vpja82;1;3383;3560;9,20000000000005;155,1;177;2,55e+08
vpja82;1;3581;3979;36,2;103;398;2,55e+08
vpja82;1;4023;4304;271,7;224,9;281;2,55e+08
vpja82;1;4358;4796;-94,8;307,8;438;255255000
vpja82;1;4855;5026;-521,2;186,8;171;255
vpja82;1;5046;6137;-551,5;158,7;1091;255
vpja82;1;6149;6319;-563;156,7;170;255
vpja82;1;6330;6593;-551,3;158,4;263;255
vpja82;1;6601;7008;-561,1;157,3;407;255
vpja82;1;7029;7249;-568,3;154,2;220;0
vpja82;1;7307;7937;-81,1999999999999;232,9;630;255255000
vpja82;1;7955;8503;-98;252,3;548;255255000
vpja82;1;8520;8759;-81,1999999999999;247;239;255255000
vpja82;1;8773;9390;-88,6999999999999;236,4;617;255255000
vpja82;1;9451;9888;-57,4;-121,3;437;255000
vpja82;1;9949;10000;275,9;-94,7;51;0
vpja82;2;286;416;-87,3;-201,1;130;2,55e+08
vpja82;2;457;589;-112,9;-325;132;2,55e+08
vpja82;2;605;1288;-85,8;-360,4;683;255000
vpja82;2;1356;1590;324,7;69,3000000000001;234;255
vpja82;2;1675;1889;-415,3;192,1;214;255255000
vpja82;2;1919;2115;-486,9;263,9;196;255255000
vpja82;2;2180;2371;-268,4;-188,4;191;0
vpja82;2;2390;2599;-250,2;-155;209;0
vpja82;2;2612;2847;-249,1;-132,7;235;0
vpja82;2;2893;3188;-460,6;-257,6;295;0
vpja82;2;3207;3538;-497,1;-278,2;331;0
vpja82;2;3574;3825;-399,3;-326;251;0
vpja82;2;3861;4022;-232,2;-355,5;161;0
vpja82;2;4071;4407;86,9;-359,5;336;0
vpja82;2;4450;4577;112,5;-219,7;127;0
vpja82;2;4631;4957;456,4;-123,1;326;0
vpja82;2;4982;5152;527,8;-104,4;170;0
vpja82;2;5200;5417;223,8;-130,2;217;0
vpja82;2;5440;5638;299,1;-113,5;198;0
vpja82;2;5649;6135;316,2;-115,7;486;0
vpja82;2;6219;6422;-222,7;-184,6;203;0
vpja82;2;6465;6699;-464,5;-213,8;234;0
vpja82;2;6721;7301;-507,7;-240,2;580;0
vpja82;2;7339;7588;-560,3;-324,5;249;0
vpja82;2;7702;7862;-239,8;192,4;160;0
vpja82;2;7912;8169;-450,4;212,1;257;255255000
vpja82;2;8194;8376;-485,8;263,9;182;255255000
vpja82;2;8439;8758;188,3;169,5;319;255
vpja82;2;8790;9022;285,2;169,7;232;255
vpja82;2;9085;9258;-116,3;-33,5;173;2,55e+08
vpja82;2;9300;9535;-239,8;-150,6;235;0
vpja82;2;9553;9843;-251,9;-125,3;290;0
vpja82;2;9900;10000;-89;-302,1;100;2,55e+08
vpja82;3;254;474;-117,656183745583;-161,436042402827;220;255000
vpja82;3;520;718;-205,856183745583;93,7639575971733;198;0
vpja82;3;745;1301;-308,856183745583;107,063957597173;556;0
vpja82;3;1316;1547;-279,656183745583;112,163957597173;231;255255000
vpja82;3;1602;1844;95,6438162544169;84,2639575971733;242;255
vpja82;3;1900;2089;332,043816254417;-47,2360424028267;189;0
vpja82;3;2106;2486;325,143816254417;-72,0360424028268;380;0
vpja82;3;2535;2847;562,343816254417;-160,636042402827;312;0
vpja82;3;2873;3054;591,143816254417;-225,836042402827;181;0
vpja82;3;3066;3260;586,143816254417;-250,836042402827;194;0
vpja82;3;3308;3555;314,843816254417;-39,7360424028267;247;0
vpja82;3;3596;3850;85,4438162544169;77,1639575971733;254;255
vpja82;3;3905;4557;-275,456183745583;96,9639575971732;652;255255000
vpja82;3;4604;4773;24,9438162544169;87,3639575971732;169;0
vpja82;3;4795;5103;81,4438162544169;85,1639575971733;308;255
vpja82;3;5148;5431;-282,756183745583;85,5639575971733;283;0
vpja82;3;5455;6211;-367,256183745583;96,0639575971733;756;0
vpja82;3;6243;6542;-268,456183745583;107,363957597173;299;255255000
vpja82;3;6560;7107;-304,256183745583;111,763957597173;547;0
vpja82;3;7162;7350;113,243816254417;99,1639575971733;188;255
vpja82;3;7368;7823;68,2438162544169;87,3639575971732;455;0
vpja82;3;7883;8208;-340,756183745583;100,663957597173;325;255255000
vpja82;3;8233;8390;-270,156183745583;104,463957597173;157;0
vpja82;3;8440;8688;101,143816254417;79,2639575971733;248;255
vpja82;3;8707;9012;63,2438162544169;79,9639575971732;305;255
vpja82;3;9060;9898;-270,756183745583;104,763957597173;838;0
vpja82;3;9917;10000;-307,156183745583;108,463957597173;83;0
vpja82;4;364;590;-295,5;275,1;226;0
vpja82;4;604;759;-314,2;292,5;155;255255000
vpja82;4;809;1011;112,4;268,8;202;2,55e+08
vpja82;4;1033;1400;162,5;297,9;367;255
vpja82;4;1412;1939;135,7;298,8;527;255
vpja82;4;1998;2423;-391,4;288,1;425;255255000
vpja82;4;2456;2943;-410,9;234,1;487;255255000
vpja82;4;2959;3260;-444;249,5;301;255255000
vpja82;4;3291;3624;-336,7;204,6;333;0
vpja82;4;3723;3932;145,8;-284,1;209;255000
vpja82;4;3952;4315;103;-300,9;363;255000
vpja82;4;4335;4522;133,3;-296;187;255000
vpja82;4;4603;4765;150;262;162;255
vpja82;4;4788;4993;166,6;303,7;205;255
vpja82;4;5048;5098;-352,2;284;50;255255000
vpja82;4;5111;5639;-372,2;299,9;528;255255000
vpja82;4;5665;5971;-322,5;268,4;306;0
vpja82;4;6028;6190;89,4000000000001;284;162;2,55e+08
vpja82;4;6216;6592;163,4;295;376;255
vpja82;4;6608;6933;129,9;296;325;255
vpja82;4;6978;7274;-57,6999999999999;261,6;296;2,55e+08
vpja82;4;7319;7600;141,8;276,8;281;255
vpja82;4;7612;7879;136,5;296,6;267;255
vpja82;4;7947;8395;-158,1;420,4;448;0
vpja82;4;8438;8641;-361,2;334,3;203;255255000
vpja82;4;8667;8896;-458,4;306,7;229;255255000
vpja82;4;8920;9128;-466,5;249,6;208;255255000
vpja82;4;9198;9655;-497,9;-147,3;457;0
vpja82;4;9712;10000;-306,4;193,6;288;0
vpja82;5;12;243;7,60000000000002;2,10000000000002;231;2,55e+08
vpja82;5;288;490;-18,5;-255,6;202;0
vpja82;5;537;1094;-177,8;-36,9;557;0
vpja82;5;1132;1537;-71,9;-41,8;405;255255000
vpja82;5;1590;1725;-34,7;-265,2;135;0
vpja82;5;1744;2448;-24,6;-301,8;704;255000
vpja82;5;2456;2640;-8,60000000000002;-293,6;184;255000
vpja82;5;2686;2984;-22;-65,4;298;255255000
vpja82;5;3030;3215;33,8;89,9;185;0
vpja82;5;3253;3463;49,6;253,2;210;2,55e+08
vpja82;5;3517;3759;358,6;30,3000000000001;242;0
vpja82;5;3793;4270;434,8;-31,4;477;0
vpja82;5;4315;4597;455,7;-128,3;282;0
vpja82;5;4638;4860;494,9;5;222;0
vpja82;5;4891;5190;379;49,4;299;0
vpja82;5;5210;5618;330,5;38,4;408;0
vpja82;5;5649;5866;436,4;-26,1;217;0
vpja82;5;5922;6106;39;157,7;184;2,55e+08
vpja82;5;6142;6326;40,2;307,1;184;2,55e+08
vpja82;5;6359;6680;26,4;410,1;321;0
vpja82;5;6708;6831;89,7;376;123;2,55e+08
vpja82;5;6899;7121;-134,5;-44,6999999999999;222;0
vpja82;5;7156;7515;-221,5;-24;359;255
vpja82;5;7529;7703;-233,6;-38,6;174;255
vpja82;5;7785;7964;-222,1;-42,6999999999999;179;255
vpja82;5;7996;8424;-86,8;-41;428;255255000
vpja82;5;8443;8666;-122,7;-40,5;223;0
vpja82;5;8702;9084;-253;-20,5;382;255
vpja82;5;9108;9277;-188,3;-17,6999999999999;169;0
vpja82;5;9307;9924;-57,4;-51;617;255255000
vpja82;5;9968;10000;-269,6;108;32;0
vpja82;6;251;464;-78,9;-158,6;213;255000
vpja82;6;521;697;7,89999999999998;154,4;176;255
vpja82;6;716;969;-11,2;171,8;253;255
vpja82;6;977;1216;-23,3;179,6;239;255
vpja82;6;1262;1636;-320,1;118,5;374;255255000
vpja82;6;1681;1895;-199,6;23,7;214;0
vpja82;6;1940;2464;-83,1;-162,2;524;255000
vpja82;6;2476;2608;-57,3;-160,3;132;255000
vpja82;6;2670;2891;-402,1;-7,20000000000005;221;0
vpja82;6;2912;3139;-425,6;7,70000000000005;227;0
vpja82;6;3173;3385;-285,8;87,3;212;255255000
vpja82;6;3432;3647;8,5;151,6;215;0
vpja82;6;3657;3885;-9,89999999999998;166,2;228;0
vpja82;6;3912;4166;70;161,6;254;255
vpja82;6;4241;4513;157,6;-268,1;272;0
vpja82;6;4549;4825;78,0999999999999;-330,3;276;0
vpja82;6;4851;4874;102,1;-391,5;23;0
vpja82;6;4971;5335;81;-424,1;364;0
vpja82;6;5357;5509;115,6;-400,9;152;0
vpja82;6;5593;5723;-411,7;12,7;130;0
vpja82;6;5754;6041;-290,8;88;287;255255000
vpja82;6;6075;6612;-429,7;10,7;537;0
vpja82;6;6655;6876;-276,5;122,6;221;255255000
vpja82;6;6924;7125;-142,9;366,3;201;0
vpja82;6;7145;7318;-186,9;340,2;173;0
vpja82;6;7343;7509;-118,4;323,3;166;0
vpja82;6;7534;7876;-194,8;334,1;342;0
vpja82;6;7926;8291;-303,3;98,3;365;255255000
vpja82;6;8335;8543;9,39999999999998;150,1;208;0
vpja82;6;8557;8723;-8,29999999999995;165;166;0
vpja82;6;8769;8991;-368;3;222;0
vpja82;6;9014;9221;-417,6;13,2;207;0
vpja82;6;9273;9532;-181;-98,5;259;0
vpja82;6;9587;9721;-347,6;-169,3;134;0
vpja82;6;9775;10000;47,7;-295,8;225;0
vpja82;7;44;223;3,29999999999995;-10,6999999999999;179;2,55e+08
vpja82;7;278;745;-267,3;120;467;255255000
vpja82;7;765;1049;-245,4;162,4;284;255255000
vpja82;7;1109;1251;116,2;23,5;142;2,55e+08
vpja82;7;1295;1507;303,5;142,5;212;255
vpja82;7;1547;1697;426,2;121,6;150;0
vpja82;7;1770;1984;-266,7;140,7;214;255255000
vpja82;7;2050;2189;11,8;-213,2;139;255000
vpja82;7;2213;2647;3,19999999999993;-278,7;434;255000
vpja82;7;2704;2888;-205,6;3,30000000000007;184;0
vpja82;7;2924;3405;-264,6;90,9;481;255255000
vpja82;7;3478;3624;-21,8000000000001;-268,1;146;255000
vpja82;7;3644;4271;-0,600000000000023;-275,3;627;255000
vpja82;7;4291;4519;-3,20000000000005;-231,9;228;255000
vpja82;7;4577;4797;275,6;75,4;220;0
vpja82;7;4936;5172;-302,3;85,5;236;0
vpja82;7;5228;5389;81,5;120,7;161;0
vpja82;7;5427;5732;282,6;166;305;255
vpja82;7;5759;5955;357,2;141,1;196;255
vpja82;7;5981;6146;347,2;92,6;165;255
vpja82;7;6191;6828;237,4;-79,1999999999999;637;0
vpja82;7;6875;7258;-67,9000000000001;-135,4;383;2,55e+08
vpja82;7;7281;7495;-84,7;-97,8;214;2,55e+08
vpja82;7;7544;7946;-308,4;122,3;402;255255000
vpja82;7;8009;8209;216,4;136;200;255
vpja82;7;8280;8489;22,6999999999999;-280;209;255000
vpja82;7;8506;8827;6;-291;321;255000
vpja82;7;8849;9187;13;-243,7;338;255000
vpja82;7;9358;9507;247,2;-105,8;149;0
vpja82;7;9523;9694;242,5;-76,6999999999999;171;0
vpja82;7;9742;9986;371,3;146,2;244;255
vpja82;8;256;710;249,97461928934;130,736040609137;454;255255000
vpja82;8;776;943;-313,42538071066;133,536040609137;167;255
vpja82;8;965;1987;-354,52538071066;125,336040609137;1022;0
vpja82;8;2058;2208;18,8746192893401;-263,163959390863;150;255000
vpja82;8;2231;2398;-14,4253807106599;-305,763959390863;167;255000
vpja82;8;2418;2650;16,6746192893402;-304,863959390863;232;255000
vpja82;8;2673;2909;7,97461928934013;-247,863959390863;236;255000
vpja82;8;2919;3109;-2,22538071065981;-237,863959390863;190;255000
vpja82;8;3131;3286;-9,42538071065985;-299,363959390863;155;255000
vpja82;8;3299;3466;9,47461928934013;-303,263959390863;167;255000
vpja82;8;3475;3665;20,7746192893402;-304,363959390863;190;255000
vpja82;8;3689;4754;95,6746192893401;-271,363959390863;1065;255000
vpja82;8;4816;4955;326,57461928934;39,4360406091371;139;0
vpja82;8;4987;5499;257,17461928934;137,436040609137;512;255255000
vpja82;8;5560;5781;4,8746192893401;-24,363959390863;221;2,55e+08
vpja82;8;5829;6128;278,87461928934;117,136040609137;299;0
vpja82;8;6149;6332;244,67461928934;131,136040609137;183;255255000
vpja82;8;6410;6976;-338,92538071066;129,536040609137;566;255
vpja82;8;7085;7116;334,07461928934;201,036040609137;31;0
vpja82;8;7145;7429;217,17461928934;108,636040609137;284;0
vpja82;8;7451;7839;253,87461928934;122,736040609137;388;0
vpja82;8;7909;8141;12,9746192893401;-200,363959390863;232;255000
vpja82;8;8164;8361;-51,1253807106599;-183,863959390863;197;0
vpja82;8;8419;8786;-337,42538071066;105,536040609137;367;0
vpja82;8;8861;9050;16,6746192893402;-282,363959390863;189;255000
vpja82;8;9068;9288;-11,6253807106599;-280,963959390863;220;255000
vpja82;8;9388;9602;-407,92538071066;-513,863959390863;214;NA
vpja82;8;9651;10000;-54,1253807106599;-431,763959390863;349;0
vpja82;9;331;476;-227,7;59,7;145;2,55e+08
vpja82;9;529;846;-213;-271,8;317;255000
vpja82;9;856;1014;-216,8;-264,2;158;255000
vpja82;9;1035;1728;-204,6;-222,2;693;255000
vpja82;9;1800;1980;-150;240,6;180;2,55e+08
vpja82;9;2001;2154;-169;200,4;153;2,55e+08
vpja82;9;2184;2392;-267,2;179,4;208;2,55e+08
vpja82;9;2434;2701;-406,1;272,5;267;255255000
vpja82;9;2748;3063;-117,3;278,2;315;255
vpja82;9;3119;3747;-440,5;261,3;628;255255000
vpja82;9;3764;4295;-473,7;255,6;531;255255000
vpja82;9;4314;4909;-435,9;259,3;595;255255000
vpja82;9;4958;5166;-245;203,4;208;2,55e+08
vpja82;9;5208;5574;-203,5;118,1;366;2,55e+08
vpja82;9;5600;5791;-248,1;110;191;2,55e+08
vpja82;9;5820;6357;-226,8;54,5;537;2,55e+08
vpja82;9;6430;6757;-162,1;-106;327;2,55e+08
vpja82;9;6783;7079;-208,1;-150;296;2,55e+08
vpja82;9;7097;7277;-240,6;-146,3;180;2,55e+08
vpja82;9;7312;7693;-202,5;-288,6;381;255000
vpja82;9;7710;7876;-203,4;-249;166;255000
vpja82;9;7934;8137;230,4;-320,6;203;0
vpja82;9;8176;8237;348,7;-364,4;61;0
vpja82;9;8293;8528;-4,69999999999993;-287,5;235;0
vpja82;9;8554;8759;-69,1999999999999;-255,6;205;0
vpja82;9;8817;9128;-223,9;70,8000000000001;311;2,55e+08
vpja82;9;9390;9931;-397,8;272,9;541;255255000
vpja82;10;231;336;-114,5;-60,8;105;2,55e+08
vpja82;10;391;639;-382;152,3;248;255
vpja82;10;659;772;-329;160,6;113;255
vpja82;10;830;1195;-61,4;-195,9;365;255000
vpja82;10;1216;1394;-21,3;-193,9;178;255000
vpja82;10;1417;1644;-41;-155,5;227;255000
vpja82;10;1689;1912;45,7;9,40000000000009;223;2,55e+08
vpja82;10;1933;1997;24,8;49,3000000000001;64;2,55e+08
vpja82;10;2049;2511;363,5;217,5;462;255255000
vpja82;10;2527;2721;332,7;244,9;194;255255000
vpja82;10;2808;2961;-370,7;77;153;255
vpja82;10;2996;3247;-412,3;-24,4;251;0
vpja82;10;3279;3755;-330,6;90,2;476;255
vpja82;10;3788;4066;-269;181,2;278;255
vpja82;10;4074;4436;-283,4;184,9;362;255
vpja82;10;4448;4657;-287;206,2;209;255
vpja82;10;4714;4949;-451,6;6,40000000000009;235;0
vpja82;10;4980;5134;-518,4;29,7;154;0
vpja82;10;5163;5851;-404,4;-21;688;0
vpja82;10;5869;6190;-375,3;-28,5;321;0
vpja82;10;6208;6778;-405,9;-27,8;570;0
vpja82;10;6786;7232;-405,9;-11,5999999999999;446;0
vpja82;10;7266;7404;-325,7;-43,4;138;0
vpja82;10;7457;7821;-380,3;-210,7;364;0
vpja82;10;7862;7995;-535,5;-174;133;0
vpja82;10;8037;8326;-344,6;-24,5999999999999;289;0
vpja82;10;8340;8664;-328,7;-4;324;0
vpja82;10;8678;8988;-312,8;5,70000000000005;310;0
vpja82;10;9007;9234;-351,1;5;227;0
vpja82;10;9285;9453;-48,6;-204,9;168;255000
vpja82;10;9461;9769;-63,5;-209,8;308;255000
vpja82;10;9842;10000;358,9;231,1;158;255255000
vpja82;11;33;191;-2,42508960573468;-8,21003584229391;158;0
vpja82;11;233;324;145,274910394265;-138,210035842294;91;255000
vpja82;11;383;582;-165,125089605735;300,789964157706;199;255
vpja82;11;602;821;-191,525089605735;258,089964157706;219;255
vpja82;11;841;1086;-223,925089605735;262,589964157706;245;255
vpja82;11;1110;1449;-144,725089605735;274,389964157706;339;255
vpja82;11;1463;1629;-168,625089605735;271,789964157706;166;255
vpja82;11;1682;1905;281,474910394265;326,389964157706;223;255255000
vpja82;11;1927;2092;263,874910394265;375,189964157706;165;255255000
vpja82;11;2107;2573;232,374910394265;371,389964157706;466;255255000
vpja82;11;2583;2877;215,774910394265;380,489964157706;294;255255000
vpja82;11;2897;3184;238,474910394265;369,689964157706;287;255255000
vpja82;11;3221;3373;333,374910394265;350,589964157706;152;255255000
vpja82;11;3404;3655;444,574910394265;285,289964157706;251;255255000
vpja82;11;3667;3925;427,274910394265;289,889964157706;258;255255000
vpja82;11;4002;4146;282,574910394265;72,2899641577061;144;2,55e+08
vpja82;11;4196;4427;144,374910394265;-161,910035842294;231;255000
vpja82;11;4482;4757;-189,125089605735;-254,810035842294;275;0
vpja82;11;4811;5184;-448,225089605735;-187,810035842294;373;0
vpja82;11;5209;5377;-498,925089605735;-223,910035842294;168;0
vpja82;11;5435;5674;-200,425089605735;-291,110035842294;239;0
vpja82;11;5708;5859;-252,125089605735;-297,910035842294;151;0
vpja82;11;5898;6053;-133,525089605735;-320,910035842294;155;0
vpja82;11;6151;6610;8,67491039426534;-304,510035842294;459;0
vpja82;11;6652;7012;152,174910394265;-147,610035842294;360;255000
vpja82;11;7028;7509;125,074910394265;-156,410035842294;481;255000
vpja82;11;7565;7829;-161,125089605735;181,089964157706;264;0
vpja82;11;7857;8119;-191,125089605735;271,989964157706;262;255
vpja82;11;8141;8626;-226,125089605735;235,889964157706;485;0
vpja82;11;8688;9168;-162,725089605735;-21,1100358422939;480;0
vpja82;11;9316;9577;-393,825089605735;-80,3100358422939;261;0
vpja82;11;9605;9873;-432,225089605735;-171,010035842294;268;0
vpja82;11;9928;10000;-192,525089605735;58,3899641577061;72;0
vpja82;12;290;441;-222,775;-186,675;151;2,55e+08
vpja82;12;452;618;-242,975;-197,275;166;255000
vpja82;12;628;916;-234,275;-205,875;288;255000
vpja82;12;959;1212;-220,175;0,125000000000114;253;2,55e+08
vpja82;12;1260;1816;-218,075;-210,875;556;255000
vpja82;12;1831;2228;-217,475;-187,175;397;2,55e+08
vpja82;12;2249;2430;-213,475;-210,375;181;255000
vpja82;12;2437;2648;-217,675;-212,675;211;255000
vpja82;12;2735;3193;-210,275;-213,675;458;255000
vpja82;12;3205;3813;-194,175;-202,575;608;255000
vpja82;12;3835;4070;-218,275;-185,675;235;2,55e+08
vpja82;12;4125;4365;-426,475;88,825;240;255255000
vpja82;12;4399;4557;-552,775;85,5250000000001;158;255255000
vpja82;12;4612;4874;-79,775;273,925;262;2,55e+08
vpja82;12;4923;5220;-219,675;48,0250000000001;297;2,55e+08
vpja82;12;5247;5640;-304,175;50,6250000000001;393;0
vpja82;12;5670;6013;-199,575;38,5250000000001;343;2,55e+08
vpja82;12;6040;6327;-126,375;72,325;287;2,55e+08
vpja82;12;6361;6522;-31,775;199,725;161;2,55e+08
vpja82;12;6582;7039;-81,975;212,225;457;0
vpja82;12;7063;7290;-30,375;167,225;227;0
vpja82;12;7328;7473;-54,775;49,0250000000001;145;255
vpja82;12;7523;8518;-232,875;-205,675;995;255000
vpja82;12;8529;9163;-209,475;-205,975;634;255000
vpja82;12;9182;9619;-222,975;-188,875;437;2,55e+08
vpja82;12;9664;9961;-215,575;42,6250000000001;297;2,55e+08
vpja82;13;260;499;-357,985714285714;-168,033449477352;239;255000
vpja82;13;520;931;-400,285714285714;-175,933449477352;411;0
vpja82;13;951;1461;-371,085714285714;-136,233449477352;510;255000
vpja82;13;1479;1908;-383,585714285714;-179,433449477352;429;255000
vpja82;13;1931;2127;-330,185714285714;-180,433449477352;196;255000
vpja82;13;2178;2326;24,3142857142858;-50,2334494773519;148;255255000
vpja82;13;2385;2622;-318,285714285714;88,0665505226481;237;255
vpja82;13;2645;2917;-374,685714285714;76,1665505226481;272;255
vpja82;13;3130;3273;59,7142857142859;-167,433449477352;143;0
vpja82;13;3312;3563;-77,7857142857142;-251,833449477352;251;0
vpja82;13;3616;3753;120,414285714286;-414,433449477352;137;0
vpja82;13;3779;3919;45,9142857142857;-472,833449477352;140;0
vpja82;13;3975;4257;488,114285714286;-213,833449477352;282;0
vpja82;13;4320;4498;443,414285714286;-423,333449477352;178;0
vpja82;13;4628;4796;-404,285714285714;-133,833449477352;168;0
vpja82;13;4816;4996;-372,985714285714;-157,333449477352;180;255000
vpja82;13;5007;5555;-380,685714285714;-173,733449477352;548;255000
vpja82;13;5578;5811;-339,485714285714;-175,933449477352;233;255000
vpja82;13;5839;5987;-368,185714285714;-115,833449477352;148;255000
vpja82;13;6035;6509;-239,585714285714;35,2665505226481;474;2,55e+08
vpja82;13;6537;6996;-309,585714285714;85,8665505226481;459;255
vpja82;13;7046;7221;-388,585714285714;-148,733449477352;175;255000
vpja82;13;7237;7563;-383,985714285714;-175,733449477352;326;255000
vpja82;13;7602;7679;-256,585714285714;-89,1334494773519;77;0
vpja82;13;7720;7965;26,4142857142858;-56,9334494773519;245;255255000
vpja82;13;8020;8462;-154,885714285714;-248,433449477352;442;0
vpja82;13;8546;9019;87,5142857142858;-467,333449477352;473;0
vpja82;13;9109;9318;6,11428571428576;-9,03344947735195;209;255255000
vpja82;13;9389;9603;527,414285714286;-237,233449477352;214;0
vpja82;13;9698;9957;-252,885714285714;122,366550522648;259;255
vpja82;14;251;440;-12,3341637010675;-283,50640569395;189;255000
vpja82;14;520;740;-458,734163701068;280,69359430605;220;0
vpja82;14;778;874;-564,134163701068;374,99359430605;96;0
vpja82;14;950;1136;387,865836298933;324,59359430605;186;0
vpja82;14;1160;1375;437,765836298932;378,39359430605;215;255255000
vpja82;14;1479;1612;-60,9341637010675;-357,10640569395;133;255000
vpja82;14;1637;1824;-14,9341637010675;-393,30640569395;187;255000
vpja82;14;1839;2264;12,1658362989325;-400,00640569395;425;255000
vpja82;14;2294;2612;23,3658362989324;-327,30640569395;318;255000
vpja82;14;2635;2889;73,7658362989324;-326,10640569395;254;255000
vpja82;14;3027;3349;278,665836298933;-149,70640569395;322;0
vpja82;14;3426;4093;-327,834163701067;200,49359430605;667;0
vpja82;14;4156;4337;-494,734163701068;-18,9064056939502;181;0
vpja82;14;4363;4604;-509,434163701068;-87,6064056939501;241;0
vpja82;14;4638;4975;-336,634163701068;-74,3064056939502;337;0
vpja82;14;4994;5161;-365,434163701068;-69,5064056939502;167;0
vpja82;14;5213;5499;-476,334163701068;-267,30640569395;286;0
vpja82;14;5586;5614;433,065836298932;-247,70640569395;28;0
vpja82;14;5628;5908;373,265836298932;-236,80640569395;280;0
vpja82;14;5976;6391;411,265836298932;297,69359430605;415;255255000
vpja82;14;6421;6664;426,165836298933;401,39359430605;243;0
vpja82;14;6817;7101;-483,534163701068;334,19359430605;284;255
vpja82;14;7165;7399;-418,634163701068;-92,7064056939502;234;0
vpja82;14;7423;7721;-344,334163701067;-78,2064056939502;298;0
vpja82;14;7774;8123;-506,734163701068;-307,10640569395;349;0
vpja82;14;8180;8422;-22,3341637010675;-363,20640569395;242;255000
vpja82;14;8473;8611;163,165836298933;-85,2064056939502;138;2,55e+08
vpja82;14;8687;9170;461,365836298933;376,89359430605;483;0
vpja82;14;9212;9383;297,665836298933;380,09359430605;171;0
vpja82;14;9462;9728;-447,134163701068;280,89359430605;266;0
vpja82;14;9783;10000;-223,734163701068;116,69359430605;217;0
vpja82;15;340;583;268,333333333333;317,227777777778;243;0
vpja82;15;605;994;282,033333333333;296,527777777778;389;255
vpja82;15;1065;1307;-417,266666666667;286,927777777778;242;255255000
vpja82;15;1347;1531;-350,466666666667;208,227777777778;184;0
vpja82;15;1570;2229;-153,966666666667;101,727777777778;659;2,55e+08
vpja82;15;2295;2545;-434,966666666667;224,927777777778;250;0
vpja82;15;2572;2925;-480,766666666667;281,427777777778;353;255255000
vpja82;15;3021;3197;215,733333333333;331,227777777778;176;0
vpja82;15;3221;3689;257,533333333333;297,527777777778;468;0
vpja82;15;3747;4001;138,433333333334;81,5277777777778;254;2,55e+08
vpja82;15;4037;4323;6,23333333333346;96,6277777777779;286;2,55e+08
vpja82;15;4380;4701;238,433333333334;240,627777777778;321;0
vpja82;15;4723;5114;280,633333333333;285,627777777778;391;0
vpja82;15;5162;5303;174,233333333333;178,427777777778;141;0
vpja82;15;5379;5800;-16,9666666666666;-339,472222222222;421;255000
vpja82;15;5821;6112;34,5333333333334;-335,072222222222;291;255000
vpja82;15;6203;6420;308,433333333334;292,727777777778;217;0
vpja82;15;6446;6684;253,133333333333;267,627777777778;238;255
vpja82;15;6757;7591;-469,866666666667;310,827777777778;834;255255000
vpja82;15;7621;7821;-519,566666666667;339,027777777778;200;255255000
vpja82;15;7895;8062;238,533333333333;294,427777777778;167;0
vpja82;15;8083;8636;267,233333333333;285,827777777778;553;255
vpja82;15;8725;9141;-501,866666666667;322,927777777778;416;255255000
vpja82;15;9177;9306;-421,566666666667;325,427777777778;129;255255000
vpja82;15;9371;9558;245,133333333333;282,927777777778;187;255
vpja82;15;9576;9756;255,233333333333;259,127777777778;180;0
vpja82;15;9916;9936;291,633333333333;341,927777777778;20;0
vpja82;15;9947;10000;253,133333333333;254,627777777778;53;0
vpja82;16;262;431;-33,8000000000001;-264;169;255000
vpja82;16;510;820;-431,5;240;310;255
vpja82;16;887;1042;-39,9;-83,4;155;2,55e+08
vpja82;16;1088;1318;-47,6;-287,4;230;255000
vpja82;16;1325;1639;-53,3000000000001;-286,1;314;255000
vpja82;16;1717;1932;425,7;234,1;215;255255000
vpja82;16;1961;2276;404,9;166,2;315;255255000
vpja82;16;2297;2448;348,3;185,1;151;255255000
vpja82;16;2528;3093;-424,5;232,9;565;255
vpja82;16;3273;3589;-379;192,3;316;0
vpja82;16;3611;4089;-407,2;215,8;478;255
vpja82;16;4113;4434;-370,6;252,6;321;255
vpja82;16;4517;4670;325;205,1;153;255255000
vpja82;16;4696;5056;407,9;177;360;255255000
vpja82;16;5195;5335;-47,7;-321,8;140;255000
vpja82;16;5350;5624;-62,3000000000001;-294,5;274;255000
vpja82;16;5665;5944;153,4;-396,4;279;0
vpja82;16;5982;6139;19,9;-311,6;157;255000
vpja82;16;6162;6458;-22,6;-289,9;296;255000
vpja82;16;6480;7149;-25,5;-246,3;669;255000
vpja82;16;7258;7289;-331,8;91,5;31;0
vpja82;16;7297;7489;-332,1;130,1;192;0
vpja82;16;7554;7907;362,2;197,9;353;255255000
vpja82;16;7970;8149;17,1;-65,4;179;2,55e+08
vpja82;16;8199;8416;-24,2;-279,6;217;255000
vpja82;16;8432;8850;-49,2;-287,9;418;255000
vpja82;16;8874;9054;4,60000000000002;-277,7;180;255000
vpja82;16;9102;9469;203,4;-383,2;367;0
vpja82;16;9540;9757;427,1;7,5;217;0
vpja82;16;9795;10000;392,6;179,6;205;255255000
vpja82;17;6;208;17,4995145631068;-9,15970873786409;202;0
vpja82;17;242;619;-83,7004854368931;-111,459708737864;377;255000
vpja82;17;670;965;-45,0004854368932;-374,659708737864;295;0
vpja82;17;1028;1192;55,4995145631069;-8,85970873786414;164;0
vpja82;17;1233;1458;232,199514563107;114,140291262136;225;255
vpja82;17;1480;1741;190,499514563107;106,440291262136;261;255
vpja82;17;1801;2319;-431,700485436893;120,440291262136;518;255255000
vpja82;17;2344;2756;-487,300485436893;108,840291262136;412;255255000
vpja82;17;2826;2959;-453,500485436893;-227,459708737864;133;0
vpja82;17;3002;3217;-394,200485436893;-373,959708737864;215;0
vpja82;17;3267;3437;-605,100485436893;-127,959708737864;170;0
vpja82;17;3488;3716;-450,600485436893;144,540291262136;228;255255000
vpja82;17;3744;4138;-523,000485436893;133,940291262136;394;0
vpja82;17;4164;4835;-451,400485436893;125,740291262136;671;255255000
vpja82;17;4875;5024;-320,500485436893;115,240291262136;149;255255000
vpja82;17;5079;5349;165,899514563107;96,3402912621359;270;255
vpja82;17;5369;5728;195,599514563107;107,040291262136;359;255
vpja82;17;5911;5967;-11,9004854368932;16,8402912621359;56;2,55e+08
vpja82;17;6004;6144;-126,500485436893;-105,859708737864;140;0
vpja82;17;6166;6362;-86,7004854368931;-121,659708737864;196;255000
vpja82;17;6370;6983;-88,4004854368932;-124,259708737864;613;255000
vpja82;17;7026;7430;-67,1004854368932;29,3402912621359;404;2,55e+08
vpja82;17;7448;7630;-44,2004854368931;23,8402912621359;182;2,55e+08
vpja82;17;7653;7969;-50,4004854368932;-26,0597087378641;316;2,55e+08
vpja82;17;8020;8261;225,399514563107;85,6402912621359;241;0
vpja82;17;8282;8750;187,399514563107;100,640291262136;468;255
vpja82;17;8796;8975;272,299514563107;4,94029126213593;179;0
vpja82;17;9011;9554;392,499514563107;3,54029126213595;543;0
vpja82;17;9636;9799;-27,0004854368932;-281,859708737864;163;0
vpja82;17;9825;10000;-40,4004854368932;-372,259708737864;175;0
vpja82;18;248;408;-393,805586773704;-59,9373526740294;160;255000
vpja82;18;791;839;-368,905586773704;266,162647325971;48;0
vpja82;18;915;1192;161,494413226296;164,862647325971;277;255255000
vpja82;18;1247;1482;362,494413226296;-58,6373526740293;235;0
vpja82;18;1515;1707;487,294413226296;-87,5373526740294;192;0
vpja82;18;1747;2078;217,194413226296;-21,4373526740294;331;0
vpja82;18;2097;2217;181,494413226296;-27,0373526740294;120;0
vpja82;18;2274;2578;-382,105586773704;-77,3373526740294;304;255000
vpja82;18;2601;2751;-413,805586773704;-73,1373526740293;150;255000
vpja82;18;2803;4230;-319,705586773704;250,562647325971;1427;255
vpja82;18;4247;4979;-345,305586773704;255,162647325971;732;255
vpja82;18;5004;5243;-279,405586773704;248,862647325971;239;255
vpja82;18;5265;5947;-331,605586773704;256,362647325971;682;255
vpja82;18;5968;6286;-281,105586773704;245,362647325971;318;255
vpja82;18;6308;6939;-329,005586773704;251,762647325971;631;255
vpja82;18;6958;7301;-280,505586773704;248,162647325971;343;255
vpja82;18;7309;7471;-288,505586773704;245,962647325971;162;255
vpja82;18;7527;7864;132,894413226296;186,462647325971;337;255255000
vpja82;18;7903;8203;145,294413226296;88,4626473259706;300;0
vpja82;18;8231;8505;222,894413226296;40,5626473259706;274;0
vpja82;18;8530;8737;180,594413226296;-12,2373526740294;207;0
vpja82;18;8754;8868;211,094413226296;-15,2373526740294;114;0
vpja82;18;8934;9106;-373,505586773704;-92,5373526740294;172;255000
vpja82;18;9130;9507;-398,605586773704;-71,2373526740294;377;255000
vpja82;18;9571;9800;133,394413226296;42,4626473259706;229;0
vpja82;18;9829;10000;211,494413226296;-15,1373526740293;171;0
vpja82;19;219;373;61,6;-35,5;154;255000
vpja82;19;418;671;1,79999999999995;194,8;253;255
vpja82;19;714;855;228,3;133,2;141;0
vpja82;19;881;1191;305,4;85,2;310;255255000
vpja82;19;1309;1481;233,7;62,4;172;0
vpja82;19;1523;1757;53;-53,4;234;255000
vpja82;19;1769;2069;45,4;-60,8;300;255000
vpja82;19;2125;2336;330,8;-219,9;211;0
vpja82;19;2502;2749;274,8;-115;247;0
vpja82;19;2803;3541;59,8;-57,3;738;255000
vpja82;19;3562;3734;94,7;-55,1999999999999;172;0
vpja82;19;3757;4374;57,8;-49,5;617;255000
vpja82;19;4428;4672;327,5;112,6;244;255255000
vpja82;19;4696;5110;256,8;112,4;414;0
vpja82;19;5150;5791;38,8;187;641;255
vpja82;19;5838;6163;316;108,8;325;255255000
vpja82;19;6201;6381;200;100,7;180;0
vpja82;19;6422;7030;37;181,5;608;255
vpja82;19;7036;7367;44,6;177,3;331;255
vpja82;19;7415;7636;297,9;113,2;221;255255000
vpja82;19;7691;7999;25;180,1;308;255
vpja82;19;8047;8256;336,5;124,2;209;255255000
vpja82;19;8281;8325;283,9;103,8;44;255255000
vpja82;19;8528;8659;265,7;92,5;131;255255000
vpja82;19;8682;8837;307,3;77,6;155;0
vpja82;19;8883;9024;10,9;-69,9;141;255000
vpja82;19;9048;9156;54,8;-51,5;108;255000
vpja82;19;9209;9638;402,1;-137,8;429;0
vpja82;19;9687;9876;41,7;-161,6;189;0
vpja82;19;9900;10000;-4;-157,7;100;0
vpja82;20;292;412;-198,8;31,9;120;255255000
vpja82;20;467;631;174,5;-213,2;164;255000
vpja82;20;643;938;163,6;-224;295;255000
vpja82;20;954;1094;192,2;-215,6;140;255000
vpja82;20;1165;1389;-330,2;45,6;224;255255000
vpja82;20;1434;1652;-420,9;-115;218;0
vpja82;20;1697;1915;-313,5;102,4;218;255255000
vpja82;20;1980;2120;185,3;-155,1;140;255000
vpja82;20;2142;2289;180,8;-198,2;147;255000
vpja82;20;2309;2462;183,6;-228,2;153;255000
vpja82;20;2605;2716;385,2;-304,2;111;0
vpja82;20;2996;3388;412,9;-339,1;392;0
vpja82;20;3614;3752;271,3;211;138;255
vpja82;20;3838;4085;-385,8;141;247;255255000
vpja82;20;4132;4449;-268,6;-28,1;317;0
vpja82;20;4495;4766;-128,9;-154,2;271;0
vpja82;20;4803;5014;-35,6;-233,9;211;0
vpja82;20;5053;5421;-50,8000000000001;-373,1;368;0
vpja82;20;5476;5585;-77,6;-111,7;109;0
vpja82;20;5698;5876;-134,6;-92,8000000000001;178;0
vpja82;20;5921;6204;-318,4;61;283;255255000
vpja82;20;6292;6320;292,8;146,4;28;0
vpja82;20;6337;6802;293,9;171,9;465;255
vpja82;20;6867;7101;-59,1;29,3;234;0
vpja82;20;7156;7336;-341,4;-64,1;180;0
vpja82;20;7393;7836;122,1;-51;443;2,55e+08
vpja82;20;7984;8412;-332,2;60,1999999999999;428;255255000
vpja82;20;8474;9124;329,3;183,5;650;255
vpja82;20;9344;9659;-358,3;92,4;315;255255000
vpja82;20;9683;10000;-324,3;36,1999999999999;317;255255000
vpja82;21;293;409;-222,9;92,9;116;0
vpja82;21;443;613;-386,6;115,9;170;0
vpja82;21;682;811;-72,3;-287,2;129;0
vpja82;21;832;1198;-32,9;-303,1;366;255000
vpja82;21;1219;1410;-11,4;-259,3;191;255000
vpja82;21;1472;1629;354,2;37,4;157;0
vpja82;21;1661;2191;237,3;77,5999999999999;530;255
vpja82;21;2388;2702;-371,6;115,9;314;255255000
vpja82;21;2714;3011;-382,7;112,3;297;0
vpja82;21;3053;3407;-628,5;41,6999999999999;354;0
vpja82;21;3422;3658;-645,9;36,8;236;NA
vpja82;21;3672;3882;-658,9;35,5999999999999;210;NA
vpja82;21;3928;4101;-342,1;108,8;173;255255000
vpja82;21;4364;4467;245,7;48,0999999999999;103;255
vpja82;21;4740;4807;220,3;35,1999999999999;67;0
vpja82;21;4816;4853;213;44,8;37;0
vpja82;21;4915;5050;-291;88,3;135;0
vpja82;21;5091;5340;-397,5;101,6;249;0
vpja82;21;5402;5914;222,9;49,4;512;0
vpja82;21;5973;6242;36,1;411,5;269;0
vpja82;21;6268;6448;106,3;423;180;0
vpja82;21;6684;6858;-393,3;58,6999999999999;174;0
vpja82;21;6911;7191;-52,4;-7,30000000000007;280;2,55e+08
vpja82;21;7218;7548;21,5;-79,3000000000001;330;2,55e+08
vpja82;21;7606;7824;-242,7;17;218;0
vpja82;21;7867;7999;-389;70,9;132;0
vpja82;21;8054;8282;-656,4;37,1999999999999;228;NA
vpja82;21;8304;8581;-616,7;24,6999999999999;277;0
vpja82;21;8642;9038;-61,1999999999999;-112,2;396;2,55e+08
vpja82;21;9087;9501;-21,6999999999999;-314,6;414;255000
vpja82;21;9526;9684;-21,5999999999999;-262,1;158;255000
vpja82;21;9752;10000;-366,3;31,8;248;0
vpja82;22;26;208;-16,6055867737043;0,662647325970624;182;0
vpja82;22;260;416;-315,605586773704;-168,337352674029;156;255000
vpja82;22;496;900;82,9944132262957;312,562647325971;404;255
vpja82;22;969;1256;-491,805586773704;336,362647325971;287;255255000
vpja82;22;1280;1697;-544,105586773704;337,462647325971;417;255255000
vpja82;22;1712;1853;-523,405586773704;331,162647325971;141;255255000
vpja82;22;1923;2120;-341,305586773704;-196,637352674029;197;255000
vpja82;22;2145;2512;-288,005586773704;-219,737352674029;367;255000
vpja82;22;2583;2917;128,694413226296;263,562647325971;334;255
vpja82;22;2936;3934;100,594413226296;244,362647325971;998;255
vpja82;22;3957;4379;164,194413226296;261,162647325971;422;255
vpja82;22;4409;4677;187,594413226296;320,862647325971;268;255
vpja82;22;4713;5069;96,5944132262956;231,762647325971;356;255
vpja82;22;5120;5329;387,394413226296;186,262647325971;209;0
vpja82;22;5344;5835;409,294413226296;177,462647325971;491;0
vpja82;22;5929;5962;-312,305586773704;89,3626473259707;33;2,55e+08
vpja82;22;5977;6132;-268,305586773704;123,662647325971;155;2,55e+08
vpja82;22;6193;6634;-504,505586773704;317,262647325971;441;255255000
vpja82;22;6707;6871;-427,705586773704;-212,737352674029;164;255000
vpja82;22;6921;7198;-565,105586773704;-221,437352674029;277;0
vpja82;22;7246;7451;-307,005586773704;-221,837352674029;205;255000
vpja82;22;7477;7726;-273,405586773704;-250,637352674029;249;255000
vpja82;22;7770;7907;-315,205586773704;-356,337352674029;137;255000
vpja82;22;7992;8883;576,594413226296;-56,5373526740294;891;0
vpja82;22;8909;9081;488,394413226296;-54,7373526740294;172;0
vpja82;22;9115;9466;391,794413226296;-2,13735267402933;351;0
vpja82;22;9514;9794;592,094413226296;-92,7373526740294;280;0
vpja82;22;9806;10000;566,594413226296;-94,0373526740294;194;0
vpja82;23;277;461;-214,543298969072;223,05704467354;184;255255000
vpja82;23;767;970;156,356701030928;144,457044673539;203;255
vpja82;23;988;1250;181,756701030928;137,357044673539;262;255
vpja82;23;1301;1395;-223,143298969072;217,25704467354;94;255255000
vpja82;23;1428;1700;-219,343298969072;217,55704467354;272;0
vpja82;23;1719;2008;-188,143298969072;241,75704467354;289;255255000
vpja82;23;2065;2654;190,656701030928;135,15704467354;589;255
vpja82;23;2668;2864;167,856701030928;127,55704467354;196;255
vpja82;23;2934;3193;-72,7432989690722;-282,042955326461;259;255000
vpja82;23;3207;3437;-67,6432989690721;-259,34295532646;230;255000
vpja82;23;3457;3741;-61,6432989690721;-213,242955326461;284;255000
vpja82;23;3892;4349;-197,843298969072;-147,042955326461;457;2,55e+08
vpja82;23;4410;4574;139,456701030928;65,3570446735395;164;0
vpja82;23;4600;5594;177,556701030928;131,857044673539;994;255
vpja82;23;5654;6121;-205,343298969072;103,75704467354;467;2,55e+08
vpja82;23;6168;6602;-372,143298969072;110,65704467354;434;2,55e+08
vpja82;23;6661;6781;61,7567010309278;192,05704467354;120;0
vpja82;23;6809;7155;168,656701030928;158,15704467354;346;255
vpja82;23;7167;7638;192,156701030928;156,65704467354;471;255
vpja82;23;7688;7967;-92,5432989690721;87,1570446735395;279;0
vpja82;23;7992;8089;-140,843298969072;86,1570446735395;97;0
vpja82;23;8236;8829;-190,743298969072;46,5570446735395;593;2,55e+08
vpja82;23;8837;9456;-212,043298969072;34,4570446735395;619;2,55e+08
vpja82;23;9500;9760;-415,443298969072;47,3570446735395;260;2,55e+08
vpja82;23;9821;9946;63,9567010309279;109,75704467354;125;0
vpja82;24;249;451;-126,9;36,5;202;255
vpja82;24;478;1012;-213,2;59,6;534;255
vpja82;24;1049;1198;-109,1;36,2;149;255
vpja82;24;1247;1473;274,2;75,7;226;255255000
vpja82;24;1500;1894;372,3;57;394;255255000
vpja82;24;1971;2097;101,6;-129,5;126;2,55e+08
vpja82;24;2144;2365;55,1999999999999;-327,7;221;255000
vpja82;24;2381;2659;39;-333,7;278;255000
vpja82;24;2723;3070;236,1;-39,6999999999999;347;0
vpja82;24;3105;3383;345,7;47,9000000000001;278;0
vpja82;24;3408;3604;283,5;88,3000000000001;196;255255000
vpja82;24;3640;3674;328,2;143,8;34;255255000
vpja82;24;3691;4305;282,4;91,5;614;255255000
vpja82;24;4345;4569;138,9;135,5;224;0
vpja82;24;4612;4871;-174,2;51,4000000000001;259;255
vpja82;24;4917;5845;-187,6;49,7;928;255
vpja82;24;5884;6073;-96,2;-6,19999999999993;189;255
vpja82;24;6397;6862;-196,6;65,2;465;255
vpja82;24;6880;7221;-159,8;78,6;341;255
vpja82;24;7243;8185;-204,3;88,9000000000001;942;255
vpja82;24;8212;8642;-123;32,3000000000001;430;255
vpja82;24;8667;8930;-197,8;39,1;263;255
vpja82;24;8953;9720;-191,2;84,7;767;255
vpja82;24;9746;9976;-122,1;59,9000000000001;230;255
vpja82;25;272;377;-34,9220994475138;-151,096685082873;105;255000
vpja82;25;428;1520;-373,422099447514;112,903314917127;1092;0
vpja82;25;1543;1844;-294,622099447514;107,603314917127;301;255
vpja82;25;1940;2181;173,077900552486;131,803314917127;241;0
vpja82;25;2205;3425;225,777900552486;153,003314917127;1220;255255000
vpja82;25;3448;3820;225,877900552486;118,003314917127;372;0
vpja82;25;3883;4031;22,0779005524862;-188,996685082873;148;255000
vpja82;25;4057;4537;-39,5220994475138;-215,596685082873;480;255000
vpja82;25;4597;4743;135,977900552486;-11,296685082873;146;2,55e+08
vpja82;25;4790;5174;276,777900552486;177,203314917127;384;255255000
vpja82;25;5195;5722;237,777900552486;174,603314917127;527;255255000
vpja82;25;5778;5998;137,877900552486;52,5033149171271;220;2,55e+08
vpja82;25;6053;6081;-66,3220994475138;-215,296685082873;28;255000
vpja82;25;6087;6665;-28,4220994475138;-215,996685082873;578;255000
vpja82;25;6700;6849;9,17790055248622;-163,796685082873;149;255000
vpja82;25;6916;7622;-357,722099447514;96,703314917127;706;255
vpja82;25;7648;7916;-298,522099447514;114,003314917127;268;255
vpja82;25;7931;8006;-285,122099447514;79,8033149171271;75;0
vpja82;25;8039;8208;-136,322099447514;60,203314917127;169;2,55e+08
vpja82;25;8260;8505;-20,8220994475138;-205,496685082873;245;255000
vpja82;25;8519;9054;-42,8220994475138;-211,096685082873;535;255000
vpja82;25;9104;9286;-243,622099447514;-193,296685082873;182;0
vpja82;25;9319;9596;-241,922099447514;-74,5966850828729;277;0
vpja82;25;9622;10000;-306,022099447514;-49,9966850828729;378;0
vpja82;26;302;450;-183,5;-46,2;148;2,55e+08
vpja82;26;486;535;-147;-113,4;49;2,55e+08
vpja82;26;560;706;-202,1;-184,6;146;255000
vpja82;26;762;1254;348,7;-14,1;492;255
vpja82;26;1303;1542;362,4;248,7;239;0
vpja82;26;1558;1967;335,3;266,3;409;0
vpja82;26;1982;2304;320,8;284;322;0
vpja82;26;2423;2729;-394,8;292;306;255255000
vpja82;26;2783;3031;-457,3;112,2;248;0
vpja82;26;3057;3289;-415,4;55,0999999999999;232;0
vpja82;26;3315;3497;-395,3;-8,30000000000007;182;0
vpja82;26;3531;3812;-513,5;13,8;281;0
vpja82;26;3838;4167;-456,8;60,9;329;0
vpja82;26;4181;4539;-458,6;82;358;0
vpja82;26;4566;4747;-449,2;133,7;181;0
vpja82;26;4760;5081;-439,1;110,5;321;0
vpja82;26;5135;5311;-341,9;-114;176;0
vpja82;26;5369;5574;-448,6;295,8;205;255255000
vpja82;26;5619;6672;-441,8;77,4;1053;0
vpja82;26;6722;7117;-209,6;183,2;395;2,55e+08
vpja82;26;7163;8072;-42,2;303,5;909;2,55e+08
vpja82;26;8097;8584;-62,9;370,4;487;0
vpja82;26;8605;8763;-72,2;307,8;158;0
vpja82;26;8822;9403;-392,1;56,4;581;0
vpja82;26;9426;9752;-435,9;89,4;326;0
vpja82;26;9799;10000;-390,3;249,2;201;255255000
