vp;trial;timest;timeend;x;y;duration;roi
vpja01;1;433;620;-55,9;-80,8;187;2,55e+08
vpja01;1;657;800;-154,8;-183,2;143;255000
vpja01;1;822;1020;-201,4;-203,1;198;255000
vpja01;1;1032;1558;-210,4;-220,2;526;255000
vpja01;1;1595;1776;-67,4;-243;181;0
vpja01;1;1796;2201;-30,8000000000001;-252,7;405;0
vpja01;1;2223;2512;-72,2;-247,8;289;0
vpja01;1;2537;2731;-114,9;-223,8;194;0
vpja01;1;2779;2979;84,4999999999999;-178,7;200;0
vpja01;1;3106;3131;-25,3000000000001;390,2;25;0
vpja01;1;3148;3424;-76,8000000000001;284,3;276;255255000
vpja01;1;3447;3741;-97,8000000000001;319;294;255255000
vpja01;1;3760;3879;-82;344,2;119;255255000
vpja01;1;6067;6217;-434,1;-245;150;0
vpja01;1;6259;6420;-209,8;-247,5;161;255000
vpja01;1;6432;6749;-202,3;-238;317;255000
vpja01;1;6758;6974;-209,2;-231,6;216;255000
vpja01;1;7010;7517;-75,3000000000001;-238,2;507;0
vpja01;1;7539;7658;-81,4;-201,8;119;0
vpja01;1;7688;7941;-187,2;-219,2;253;255000
vpja01;1;7983;8253;-19,4;-255,9;270;0
vpja01;1;8286;8395;122;-222,2;109;0
vpja01;1;8445;8936;-116,6;-234,5;491;255000
vpja01;1;8963;9333;-24,7;-246,1;370;0
vpja01;1;9345;9497;-16,2;-264,2;152;0
vpja01;1;9529;9794;96,4;-263,5;265;0
vpja01;1;9820;10000;189,5;-203,2;180;0
vpja01;2;85;262;5,39999999999998;7,20000000000005;177;0
vpja01;2;295;471;-70,5;-62,5999999999999;176;0
vpja01;2;516;674;115,4;150;158;255255000
vpja01;2;699;912;159,1;199,7;213;255255000
vpja01;2;932;1092;178,8;217,7;160;255255000
vpja01;2;1794;1909;-336,5;-198;115;255000
vpja01;2;1935;2828;-340,1;-248,7;893;255000
vpja01;2;2894;3102;160,8;-65;208;0
vpja01;2;3140;3374;296,7;12,2;234;0
vpja01;2;3404;3608;379,9;12,3000000000001;204;0
vpja01;2;3635;3901;299,7;12,4000000000001;266;0
vpja01;2;3929;4365;336,9;48,8000000000001;436;0
vpja01;2;4384;4630;313,9;21,2;246;0
vpja01;2;4671;4816;425,1;-80,4;145;0
vpja01;2;4840;5141;480,6;-110,1;301;0
vpja01;2;5183;5364;343,8;-74,9;181;0
vpja01;2;5410;5541;213,8;-95,4;131;0
vpja01;2;5585;5915;323,7;19,7;330;0
vpja01;2;5937;6286;348,7;44,1;349;0
vpja01;2;6309;6463;300,8;-9,89999999999998;154;0
vpja01;2;6515;6723;161,4;142,6;208;0
vpja01;2;6741;7043;159,8;166,3;302;255255000
vpja01;2;7073;7201;90;198,9;128;255255000
vpja01;2;7276;7455;-407,4;289,8;179;255
vpja01;2;7479;7754;-439;320;275;255
vpja01;2;7773;8255;-456,3;318;482;255
vpja01;2;8338;8573;-313,7;-282,5;235;255000
vpja01;2;8597;8866;-343,2;-256,9;269;255000
vpja01;2;8884;9162;-334,2;-289,6;278;255000
vpja01;2;9173;9493;-328,2;-304,2;320;255000
vpja01;2;9503;9832;-343,6;-302;329;255000
vpja01;2;9857;10000;-344,5;-251;143;255000
vpja01;3;37;195;10,8187579188776;4,76583132357985;158;0
vpja01;3;216;335;34,5187579188776;-26,4341686764202;119;255000
vpja01;3;352;529;38,8187579188776;-39,2341686764202;177;255000
vpja01;3;541;771;42,7187579188776;-48,5341686764202;230;255000
vpja01;3;822;1278;48,1187579188776;139,16583132358;456;2,55e+08
vpja01;3;1303;1505;59,1187579188776;185,86583132358;202;255
vpja01;3;1549;1627;214,118757918878;137,96583132358;78;0
vpja01;3;1657;1842;248,018757918878;90,3658313235798;185;0
vpja01;3;1861;2132;273,418757918878;78,4658313235798;271;255255000
vpja01;3;2186;2316;81,1187579188776;-40,0341686764202;130;255000
vpja01;3;2340;2524;56,4187579188775;-57,9341686764202;184;255000
vpja01;3;2536;2851;54,0187579188776;-72,3341686764202;315;255000
vpja01;3;2899;3300;131,418757918878;-255,63416867642;401;0
vpja01;3;3323;3545;161,418757918878;-213,43416867642;222;0
vpja01;3;3563;3699;157,618757918878;-240,33416867642;136;0
vpja01;3;3735;4130;289,718757918877;-233,93416867642;395;0
vpja01;3;4153;4760;287,118757918878;-192,43416867642;607;0
vpja01;3;4786;5265;351,718757918877;-191,23416867642;479;0
vpja01;3;5291;5551;286,718757918877;-187,43416867642;260;0
vpja01;3;5609;5830;17,9187579188775;-217,63416867642;221;0
vpja01;3;5885;6083;284,218757918877;-174,43416867642;198;0
vpja01;3;6147;6296;11,7187579188776;-216,43416867642;149;0
vpja01;3;6317;6947;-22,2812420811224;-219,43416867642;630;0
vpja01;3;6961;7219;-30,1812420811224;-235,23416867642;258;0
vpja01;3;7231;7585;-26,7812420811224;-250,03416867642;354;0
vpja01;3;7601;7879;-13,4812420811224;-240,33416867642;278;0
vpja01;3;7897;8222;-38,9812420811224;-249,23416867642;325;0
vpja01;3;8259;8793;-153,581242081122;-299,63416867642;534;0
vpja01;3;8831;9132;48,1187579188776;-292,43416867642;301;0
vpja01;3;9154;9334;85,7187579188775;-295,43416867642;180;0
vpja01;3;9400;9573;-208,581242081122;-169,43416867642;173;0
vpja01;3;9619;9929;-320,981242081122;-35,6341686764202;310;0
vpja01;4;223;322;-48,7;-87,4;99;255000
vpja01;4;339;523;-58,6;-107,1;184;255000
vpja01;4;534;1015;-66,6;-108;481;255000
vpja01;4;1068;1355;126,8;125,1;287;0
vpja01;4;1383;1568;68,0999999999999;209,6;185;2,55e+08
vpja01;4;1602;1741;174,1;179;139;0
vpja01;4;1761;2113;200,3;140,9;352;255
vpja01;4;2141;2307;155,3;83,3;166;0
vpja01;4;2347;2588;310,2;64,5999999999999;241;0
vpja01;4;2610;2827;370,2;65,1999999999999;217;0
vpja01;4;2841;3056;356,2;47;215;0
vpja01;4;3118;3218;-23,1;-57,1;100;0
vpja01;4;3245;3455;-62,5;-104,9;210;255000
vpja01;4;3464;3767;-75,4000000000001;-112,3;303;255000
vpja01;4;3775;4065;-73,3000000000001;-101,1;290;255000
vpja01;4;4100;4418;-113,7;36,5;318;2,55e+08
vpja01;4;4450;4613;-67,4000000000001;110,5;163;2,55e+08
vpja01;4;5231;5517;-370,3;144;286;255255000
vpja01;4;5562;6029;-484;132,6;467;255255000
vpja01;4;6051;6325;-430,2;136,1;274;255255000
vpja01;4;6346;6658;-393,6;138,3;312;255255000
vpja01;4;6690;7147;-476,6;139;457;255255000
vpja01;4;7184;7346;-384,1;111,5;162;255255000
vpja01;4;7419;7575;-364,5;36,5;156;0
vpja01;4;7617;8024;-420,7;-121;407;0
vpja01;4;8033;8398;-427,1;-115,7;365;0
vpja01;4;8414;8816;-433;-137,7;402;0
vpja01;4;8861;9031;-587,6;-149,5;170;0
vpja01;4;9061;9177;-514,1;-211,8;116;0
vpja01;4;9221;9267;-410,3;-331,2;46;0
vpja01;4;9322;9470;-78,2;-377,4;148;0
vpja01;4;9494;9759;-42,1;-382,8;265;0
vpja01;4;9800;9966;104,6;-333,2;166;0
vpja01;5;37;175;20,3187579188776;11,2658313235798;138;2,55e+08
vpja01;5;210;408;7,41875791887753;-100,03416867642;198;255000
vpja01;5;471;659;-47,2812420811224;183,66583132358;188;2,55e+08
vpja01;5;681;958;-77,4812420811224;222,76583132358;277;255
vpja01;5;979;1382;-91,0812420811225;252,46583132358;403;255
vpja01;5;1435;1648;13,9187579188775;-123,23416867642;213;255000
vpja01;5;1656;1828;22,4187579188775;-126,63416867642;172;255000
vpja01;5;1850;2020;-2,48124208112245;-87,6341686764202;170;255000
vpja01;5;2078;2333;-110,381242081122;93,9658313235798;255;2,55e+08
vpja01;5;2779;2946;-90,6812420811224;-22,2341686764202;167;2,55e+08
vpja01;5;2981;3476;-11,5812420811225;-123,23416867642;495;255000
vpja01;5;3499;3895;20,4187579188775;-148,63416867642;396;255000
vpja01;5;3919;4017;17,3187579188776;-108,93416867642;98;255000
vpja01;5;4070;4455;255,618757918878;-19,6341686764202;385;0
vpja01;5;4505;4624;58,3187579188776;53,6658313235798;119;2,55e+08
vpja01;5;4668;4874;-90,4812420811224;140,76583132358;206;2,55e+08
vpja01;5;4900;5131;-22,2812420811224;164,86583132358;231;2,55e+08
vpja01;5;5161;5474;-89,5812420811225;249,26583132358;313;255
vpja01;5;5487;6040;-107,181242081122;241,46583132358;553;255
vpja01;5;7559;7725;-90,0812420811225;248,96583132358;166;255
vpja01;5;8377;8702;1,2187579188776;-120,93416867642;325;255000
vpja01;5;8763;8952;-75,4812420811224;180,06583132358;189;2,55e+08
vpja01;5;8984;9596;-108,081242081122;217,16583132358;612;255
vpja01;5;9611;9767;-96,1812420811224;196,66583132358;156;0
vpja01;5;9818;10000;-3,98124208112245;-94,4341686764202;182;255000
vpja01;6;243;431;-7,60000000000002;118,9;188;255255000
vpja01;6;484;685;-247;147,7;201;0
vpja01;6;710;903;-279,9;158,3;193;0
vpja01;6;986;1154;-106,8;-187,6;168;255000
vpja01;6;1174;1438;-120,5;-181,7;264;255000
vpja01;6;1445;1834;-126,1;-174,9;389;255000
vpja01;6;1884;2090;-13,9;86,5;206;2,55e+08
vpja01;6;2116;2409;13,5;128,6;293;255255000
vpja01;6;2433;2741;12,5;158,8;308;255255000
vpja01;6;2763;2944;6,60000000000002;122,1;181;255255000
vpja01;6;2993;3196;-24,6;-14,1999999999999;203;2,55e+08
vpja01;6;3239;3670;10,6999999999999;109,2;431;255255000
vpja01;6;3695;3895;0,5;148,5;200;255255000
vpja01;6;3920;4070;24,1;183,4;150;255255000
vpja01;6;4123;4259;-188,6;285,4;136;0
vpja01;6;4293;4569;-248,8;331,2;276;0
vpja01;6;4591;4755;-230,3;304,6;164;0
vpja01;6;4808;4963;-113,2;109,2;155;0
vpja01;6;5017;5142;-75,2;-65,5;125;2,55e+08
vpja01;6;5176;5372;-117;-172,5;196;255000
vpja01;6;5388;5613;-129,7;-183,5;225;255000
vpja01;6;5634;5822;-111,7;-216,1;188;255000
vpja01;6;5860;5991;8,5;-276,8;131;0
vpja01;6;6062;6289;-385,2;-190,4;227;0
vpja01;6;6326;6568;-458,2;-172,7;242;0
vpja01;6;6593;6942;-487,6;-158,8;349;0
vpja01;6;6973;7241;-490,3;-83,5;268;0
vpja01;6;7272;7498;-452,7;-57,6999999999999;226;0
vpja01;6;7515;7891;-461,9;-32,9;376;0
vpja01;6;7948;8410;-480,5;187,3;462;0
vpja01;6;8494;8642;-24,4;-59,9;148;2,55e+08
vpja01;6;8688;8877;33,6999999999999;-256,6;189;0
vpja01;6;8925;9104;-122,5;-187;179;255000
vpja01;6;9118;9785;-141,6;-182,9;667;255000
vpja01;6;9851;10000;-313,9;130;149;0
vpja01;7;13;172;-6,88124208112242;16,7658313235798;159;2,55e+08
vpja01;7;207;391;6,61875791887758;-109,93416867642;184;2,55e+08
vpja01;7;418;638;-12,4812420811224;-171,63416867642;220;255000
vpja01;7;658;743;-30,4812420811224;-185,13416867642;85;255000
vpja01;7;1299;1506;-19,2812420811224;-185,33416867642;207;255000
vpja01;7;1523;1917;-26,2812420811224;-208,43416867642;394;255000
vpja01;7;1983;2439;217,418757918878;169,16583132358;456;255255000
vpja01;7;4528;4630;-51,4812420811224;133,86583132358;102;2,55e+08
vpja01;7;4680;4962;206,518757918878;181,76583132358;282;255255000
vpja01;7;4982;5643;230,418757918878;164,66583132358;661;255255000
vpja01;7;5680;5978;144,418757918878;71,9658313235798;298;2,55e+08
vpja01;7;6035;6169;29,5187579188776;-169,73416867642;134;255000
vpja01;7;6193;6633;-23,8812420811224;-193,13416867642;440;255000
vpja01;7;6646;6867;-36,9812420811224;-182,23416867642;221;255000
vpja01;7;6884;7327;-20,7812420811224;-201,13416867642;443;255000
vpja01;7;7343;7599;-36,1812420811224;-188,03416867642;256;255000
vpja01;7;7656;7836;-218,481242081122;-9,9341686764202;180;0
vpja01;7;7877;8391;-255,281242081122;-140,63416867642;514;0
vpja01;7;8434;8664;-233,881242081122;-8,13416867642024;230;0
vpja01;7;9079;9256;-146,181242081122;119,06583132358;177;2,55e+08
vpja01;7;9277;9436;-118,081242081122;141,16583132358;159;2,55e+08
vpja01;7;9475;9866;-78,9812420811224;20,2658313235798;391;2,55e+08
vpja01;8;202;320;5,09999999999991;-163;118;2,55e+08
vpja01;8;375;1052;17,0999999999999;-358,1;677;255000
vpja01;8;1068;1499;15,8;-352,7;431;255000
vpja01;8;1511;1905;24,4;-376,3;394;255000
vpja01;8;1988;2226;42;92,9;238;0
vpja01;8;2276;2496;250,8;164,6;220;0
vpja01;8;2539;2685;358,1;256,2;146;255255000
vpja01;8;2704;3302;376,2;275,9;598;255255000
vpja01;8;3363;3587;93,8999999999999;133,5;224;0
vpja01;8;3653;3855;-207,6;111,6;202;0
vpja01;8;3891;4364;-285,3;119,6;473;255
vpja01;8;4416;4559;-15,3000000000001;104,4;143;0
vpja01;8;4583;4746;36;121;163;2,55e+08
vpja01;8;4796;4914;48,6999999999999;-36;118;2,55e+08
vpja01;8;4967;5100;-33,8000000000001;-208,3;133;0
vpja01;8;5152;5322;38,1999999999999;-360,4;170;255000
vpja01;8;5337;5608;25,6999999999999;-372,2;271;255000
vpja01;8;5616;5849;19,8;-372,9;233;255000
vpja01;8;5859;6134;13,1999999999999;-365,3;275;255000
vpja01;8;6150;6368;21,4;-384,7;218;255000
vpja01;8;6403;6681;-4,10000000000002;-298,2;278;2,55e+08
vpja01;8;6716;6873;42,5;-262,2;157;255000
vpja01;8;6922;7050;62,4;-128,3;128;2,55e+08
vpja01;8;7116;7361;473,2;-132;245;0
vpja01;8;7388;7703;478,1;-190;315;0
vpja01;8;7722;7913;511,6;-183,9;191;0
vpja01;8;7944;8261;603,3;-172,2;317;0
vpja01;8;8344;8706;117,7;-429,7;362;0
vpja01;8;8744;9012;22,1999999999999;-391,8;268;255000
vpja01;8;9023;9420;20;-383,9;397;255000
vpja01;8;9489;9610;24;28;121;2,55e+08
vpja01;8;9651;9802;14,3;125,9;151;2,55e+08
vpja01;8;9889;10000;-252,9;-226,3;111;0
vpja01;9;215;311;-35,2714285714286;-179,286428571429;96;255000
vpja01;9;334;507;-19,2714285714286;-230,786428571429;173;255000
vpja01;9;524;858;-20,9714285714286;-252,786428571429;334;255000
vpja01;9;931;1175;305,728571428571;179,613571428571;244;255
vpja01;9;1191;1544;307,828571428571;205,213571428571;353;255
vpja01;9;1568;1900;320,328571428571;258,913571428571;332;255
vpja01;9;1920;2640;304,928571428571;223,813571428571;720;255
vpja01;9;2660;3082;328,828571428571;247,113571428571;422;255
vpja01;9;3101;3646;307,428571428571;224,613571428571;545;255
vpja01;9;3725;3942;-252,871428571429;210,213571428571;217;0
vpja01;9;4898;5098;283,128571428571;263,713571428571;200;255
vpja01;9;5120;5413;321,328571428571;248,113571428571;293;255
vpja01;9;5431;5746;316,428571428571;215,113571428571;315;255
vpja01;9;5784;5914;339,428571428571;116,713571428571;130;0
vpja01;9;5964;6102;93,5285714285715;69,8135714285713;138;0
vpja01;9;6162;6314;-14,8714285714286;-203,386428571429;152;255000
vpja01;9;6339;6503;-16,7714285714286;-259,386428571429;164;255000
vpja01;9;6518;6822;-36,1714285714286;-260,486428571429;304;255000
vpja01;9;6847;7193;-22,9714285714286;-201,886428571429;346;255000
vpja01;9;7231;7458;51,3285714285714;-276,186428571429;227;0
vpja01;9;7493;7829;176,328571428571;-283,586428571429;336;0
vpja01;9;7849;8147;212,228571428571;-264,386428571429;298;0
vpja01;9;8198;8364;12,8285714285714;-289,286428571429;166;255000
vpja01;9;8388;8731;-14,1714285714286;-276,986428571429;343;255000
vpja01;9;8788;9079;222,128571428571;-289,086428571429;291;0
vpja01;9;9110;9349;325,628571428571;-274,386428571429;239;0
vpja01;9;9371;9704;362,728571428571;-280,086428571429;333;0
vpja01;9;9718;9967;360,428571428571;-296,786428571429;249;0
vpja01;10;56;83;186,3;181,2;27;255255000
vpja01;10;122;205;28,2;8,60000000000002;83;2,55e+08
vpja01;10;244;341;-28,4;-147,8;97;2,55e+08
vpja01;10;370;559;-55,0999999999999;-216,2;189;255000
vpja01;10;620;877;327,2;146,9;257;255255000
vpja01;10;904;1044;397,3;191,4;140;255255000
vpja01;10;1069;1249;398,7;119,6;180;255255000
vpja01;10;1264;1494;377;95,3;230;255255000
vpja01;10;1511;1890;363,2;66,4;379;255255000
vpja01;10;1914;2076;395,9;102,6;162;255255000
vpja01;10;3556;3633;-522,7;44,4;77;0
vpja01;10;3658;3833;-523,4;-18,3000000000001;175;0
vpja01;10;3872;4027;-498,1;-136,8;155;0
vpja01;10;4088;4296;-67;-234,6;208;255000
vpja01;10;4315;4677;-43,8;-254,3;362;255000
vpja01;10;4700;4885;-60,3;-215,6;185;255000
vpja01;10;4904;5043;-44,3;-244,3;139;255000
vpja01;10;6915;7221;-503,1;-25,3000000000001;306;0
vpja01;10;7248;7779;-417;-66,3000000000001;531;0
vpja01;10;7799;7955;-386,3;-68,7;156;0
vpja01;10;7979;8288;-332,7;-48,7;309;0
vpja01;10;8305;8654;-350,3;-43,6;349;0
vpja01;10;8669;8891;-332,6;-41,3000000000001;222;0
vpja01;10;8911;9164;-362,7;-39,1;253;0
vpja01;10;9183;9461;-388,4;-62,8000000000001;278;0
vpja01;10;9504;9661;-486,3;-66,1;157;0
vpja01;10;9687;9857;-428,5;-113,2;170;0
vpja01;10;9920;10000;-44,8;-261,9;80;255000
vpja01;11;274;504;66,0668965517243;-142,040689655172;230;2,55e+08
vpja01;11;560;697;119,366896551724;-297,340689655172;137;255000
vpja01;11;709;1411;133,166896551724;-286,640689655172;702;255000
vpja01;11;1475;1694;287,766896551724;67,6593103448276;219;0
vpja01;11;1719;2093;305,066896551724;102,259310344828;374;255
vpja01;11;2106;2438;308,266896551724;120,159310344828;332;255
vpja01;11;2469;2713;206,466896551724;99,8593103448276;244;0
vpja01;11;2744;2943;289,566896551724;124,059310344828;199;255
vpja01;11;2956;3297;309,366896551724;115,059310344828;341;255
vpja01;11;3347;3573;137,766896551724;98,2593103448277;226;0
vpja01;11;3620;3837;-38,2331034482758;58,9593103448276;217;255255000
vpja01;11;3862;4688;-95,8331034482758;60,7593103448277;826;255255000
vpja01;11;4713;4885;-153,833103448276;79,1593103448276;172;255255000
vpja01;11;5405;5532;-296,933103448276;5,4593103448276;127;0
vpja01;11;5587;5739;13,8668965517243;-71,9406896551724;152;2,55e+08
vpja01;11;5791;5931;96,0668965517243;-234,940689655172;140;2,55e+08
vpja01;11;5955;6297;127,166896551724;-281,440689655172;342;255000
vpja01;11;6348;6852;256,666896551724;-38,9406896551724;504;0
vpja01;11;6901;7077;180,266896551724;-163,740689655172;176;2,55e+08
vpja01;11;7109;7371;148,466896551724;-250,140689655172;262;255000
vpja01;11;7438;7586;-135,533103448276;-5,94068965517238;148;0
vpja01;11;7887;8167;-146,633103448276;96,6593103448276;280;255255000
vpja01;11;8204;8548;-18,6331034482757;63,9593103448276;344;0
vpja01;11;8579;8736;65,4668965517243;86,2593103448277;157;0
vpja01;11;8793;8940;104,766896551724;-181,440689655172;147;2,55e+08
vpja01;11;8978;10000;134,666896551724;-282,540689655172;1022;255000
vpja01;12;198;364;135,3;-81,7;166;2,55e+08
vpja01;12;388;787;151,7;-115,1;399;255000
vpja01;12;857;1078;-64,8;218,4;221;255
vpja01;12;1178;1467;-134,2;312;289;255
vpja01;12;2084;2525;-128;310,8;441;255
vpja01;12;2754;3290;276,6;379,1;536;255255000
vpja01;12;3327;3547;390,5;334,2;220;255255000
vpja01;12;3564;3677;416;331,3;113;255255000
vpja01;12;3756;3787;-146,8;303,1;31;255
vpja01;12;4439;4602;-126,4;367;163;0
vpja01;12;4674;4792;121,2;-34,1;118;2,55e+08
vpja01;12;4820;5014;153,3;-105;194;255000
vpja01;12;5024;5488;156,5;-118,2;464;255000
vpja01;12;5513;5755;214,3;-112;242;255000
vpja01;12;5779;5991;155;-123,5;212;255000
vpja01;12;6204;6422;159,9;-110,7;218;255000
vpja01;12;6457;6735;121,9;10,2;278;2,55e+08
vpja01;12;6758;6917;157,5;21,3;159;2,55e+08
vpja01;12;6953;7141;159,3;-84,5;188;2,55e+08
vpja01;12;7163;7658;155,9;-124,3;495;255000
vpja01;12;7679;7879;165,7;-157,5;200;255000
vpja01;12;7901;8236;153,1;-119,9;335;255000
vpja01;12;8250;8517;151,2;-100,8;267;255000
vpja01;12;8531;8883;153,9;-122,2;352;255000
vpja01;12;8913;9165;176,8;-35,5;252;2,55e+08
vpja01;12;9196;9651;147,8;52,3;455;2,55e+08
vpja01;12;9697;9824;90;207,3;127;0
vpja01;12;9854;10000;39,6;289,1;146;0
vpja01;13;191;420;-0,899999999999977;-109,7;229;2,55e+08
vpja01;13;446;671;-37,6999999999999;-54,8000000000001;225;255
vpja01;13;729;908;-17,4;-279,4;179;255000
vpja01;13;968;1326;-230,5;-66,1;358;0
vpja01;13;1400;1556;-50;-25,7;156;255
vpja01;13;1608;1893;200,2;-18,4000000000001;285;0
vpja01;13;1941;2082;60,5;54,8;141;2,55e+08
vpja01;13;2141;2311;42;355,3;170;0
vpja01;13;2387;2474;2,60000000000002;-194,1;87;2,55e+08
vpja01;13;2516;2714;4,89999999999998;-305,5;198;255000
vpja01;13;2730;3332;-9,39999999999998;-324,9;602;255000
vpja01;13;3341;3808;-11,6;-319,2;467;255000
vpja01;13;3832;4146;-17,1;-265,7;314;255000
vpja01;13;4179;4338;-8,60000000000002;-188;159;2,55e+08
vpja01;13;4368;4658;-39,4;-116,2;290;255
vpja01;13;4688;5012;-98;-57,8000000000001;324;255
vpja01;13;5039;5308;-161,7;-8,70000000000005;269;0
vpja01;13;5334;5584;-236,6;-27,9000000000001;250;255255000
vpja01;13;5606;5872;-263,7;-26,4000000000001;266;0
vpja01;13;5884;6268;-255,8;-43,6;384;0
vpja01;13;6291;6647;-220,6;-63,3000000000001;356;0
vpja01;13;6670;7002;-236,7;-46;332;255255000
vpja01;13;7019;7350;-247;-40,9000000000001;331;255255000
vpja01;13;7361;7811;-240,1;-57,8000000000001;450;0
vpja01;13;7829;7880;-249,2;-60,8000000000001;51;0
vpja01;13;7932;8141;-110,6;-221;209;0
vpja01;13;8175;8366;-40,9;-296,9;191;255000
vpja01;13;8377;9456;-29,8;-309,2;1079;255000
vpja01;13;9468;9670;-13,4;-324,1;202;255000
vpja01;13;9722;10000;-51,9;-140,3;278;2,55e+08
vpja01;14;190;238;24,625;-89,6140410958903;48;2,55e+08
vpja01;14;278;391;30,425;-178,31404109589;113;2,55e+08
vpja01;14;427;647;34,125;-277,01404109589;220;255000
vpja01;14;660;996;29,325;-291,21404109589;336;255000
vpja01;14;1019;1514;41,825;-249,21404109589;495;255000
vpja01;14;1596;1790;277,225;196,18595890411;194;0
vpja01;14;1817;2004;310,525;252,88595890411;187;0
vpja01;14;2015;2260;295,225;254,58595890411;245;0
vpja01;14;2285;2957;339,825;216,28595890411;672;255
vpja01;14;2972;3319;353,125;217,48595890411;347;255
vpja01;14;3396;3576;-148,675;179,38595890411;180;255255000
vpja01;14;3848;4118;42,725;184,28595890411;270;0
vpja01;14;4571;4846;-298,275;-69,3140410958903;275;0
vpja01;14;4871;5138;-341,675;-47,3140410958903;267;0
vpja01;14;5160;5346;-367,675;-83,6140410958903;186;0
vpja01;14;5382;5641;-483,175;-158,41404109589;259;0
vpja01;14;5668;5885;-469,775;-190,71404109589;217;0
vpja01;14;5904;6066;-462,975;-226,51404109589;162;0
vpja01;14;6121;6277;-186,275;-307,51404109589;156;0
vpja01;14;6320;6483;-20,675;-304,41404109589;163;255000
vpja01;14;6548;6735;259,825;-93,4140410958903;187;0
vpja01;14;6789;7207;496,725;-19,1140410958903;418;0
vpja01;14;7226;7342;532,925;-27,7140410958904;116;0
vpja01;14;7370;7722;481,225;-84,5140410958903;352;0
vpja01;14;7791;7955;46,625;-294,01404109589;164;255000
vpja01;14;7969;8392;40,925;-310,61404109589;423;255000
vpja01;14;8412;8578;35,525;-274,81404109589;166;255000
vpja01;14;8591;9048;39,025;-248,21404109589;457;255000
vpja01;14;9080;9400;77,925;-124,61404109589;320;2,55e+08
vpja01;14;9437;9800;-33,375;-96,4140410958903;363;2,55e+08
vpja01;14;9833;10000;33,725;-62,8140410958903;167;2,55e+08
vpja01;15;189;380;-61,6;-108;191;2,55e+08
vpja01;15;414;522;-109,9;-188,7;108;2,55e+08
vpja01;15;548;739;-154,9;-231,5;191;255000
vpja01;15;746;1781;-163,4;-227,3;1035;255000
vpja01;15;6278;6544;326,7;176;266;0
vpja01;15;6568;6792;318,1;221,9;224;0
vpja01;15;6816;7269;298,4;241,9;453;0
vpja01;15;7301;7526;303,5;320,5;225;0
vpja01;15;7539;7776;295,4;331;237;0
vpja01;15;7801;8162;319,2;266,5;361;0
vpja01;15;8187;8435;296,7;223,6;248;0
vpja01;15;8479;8694;283,6;397,2;215;0
vpja01;15;8716;8881;280,5;418,8;165;0
vpja01;15;8907;9059;313,9;410,3;152;0
vpja01;15;9093;9373;326,6;312,4;280;0
vpja01;15;9406;9524;329,6;244,1;118;0
vpja01;15;9550;9729;297,2;269,6;179;0
vpja01;15;9738;9920;307,6;279,4;182;0
vpja01;15;9938;10000;308,4;253,3;62;0
vpja01;16;179;266;8,10000000000002;-0,200000000000045;87;2,55e+08
vpja01;16;320;422;-1,39999999999998;-195,7;102;255000
vpja01;16;447;571;-26,1;-248,3;124;255000
vpja01;16;601;847;-20,4;-312,2;246;255000
vpja01;16;858;946;-17,4;-296;88;255000
vpja01;16;2882;3111;-556,5;279;229;255
vpja01;16;3127;3295;-567,3;289;168;255
vpja01;16;3364;3700;54,8;276,8;336;255255000
vpja01;16;3718;3889;67,1;306;171;255255000
vpja01;16;3936;4107;-127,8;247,9;171;2,55e+08
vpja01;16;4140;4350;-154,1;171;210;2,55e+08
vpja01;16;4397;4547;-108,8;41,6999999999999;150;2,55e+08
vpja01;16;4611;4773;-29,2;-238,9;162;255000
vpja01;16;4802;5190;-13,4;-303,9;388;255000
vpja01;16;5235;5391;-157,7;-268,8;156;0
vpja01;16;5431;5600;-34,6;-277,6;169;255000
vpja01;16;5615;5809;-12,4;-290,5;194;255000
vpja01;16;5834;6142;-51,1;-235,2;308;255000
vpja01;16;6155;6465;-47,5;-225;310;255000
vpja01;16;6495;6707;-38,6;-290;212;255000
vpja01;16;7583;7793;327,5;230;210;0
vpja01;16;7829;8183;412,7;267,1;354;0
vpja01;16;8205;8278;420,6;279,9;73;0
vpja01;16;8343;8499;111,4;346,1;156;2,55e+08
vpja01;16;9019;9319;77,4;255,1;300;255255000
vpja01;16;9342;9500;79,4;306,2;158;255255000
vpja01;16;9531;9762;53,3;204;231;255255000
vpja01;16;9830;10000;9,89999999999998;-282,7;170;255000
vpja01;17;297;415;10,3;-95,9;118;2,55e+08
vpja01;17;454;629;-11,3000000000001;-258,2;175;255000
vpja01;17;640;736;-16,5;-276,5;96;255000
vpja01;17;1657;1971;-214;-0,5;314;0
vpja01;17;3446;3624;236,3;154,6;178;0
vpja01;17;3643;4027;257;140,9;384;255255000
vpja01;17;4046;4533;268,2;137,7;487;255255000
vpja01;17;4544;4888;249,6;136,6;344;255255000
vpja01;17;4919;5187;211,4;91,7;268;0
vpja01;17;5224;5382;66,9;18,4;158;2,55e+08
vpja01;17;5416;5633;38,1;-73,8;217;2,55e+08
vpja01;17;5666;5865;29,9;-151,3;199;2,55e+08
vpja01;17;5901;6079;-2,39999999999998;-258,5;178;255000
vpja01;17;6095;6382;-19,6;-282,2;287;255000
vpja01;17;6396;7719;-34,3000000000001;-285,6;1323;255000
vpja01;17;7731;9714;-26,2;-270;1983;255000
vpja01;17;9732;10000;-32,7;-270,2;268;255000
vpja01;18;187;435;-96,7812420811224;-75,2341686764202;248;0
vpja01;18;478;647;176,418757918878;7,0658313235798;169;0
vpja01;18;672;925;247,318757918878;50,4658313235798;253;255
vpja01;18;945;1116;252,918757918878;80,4658313235798;171;255
vpja01;18;1174;1368;-23,2812420811224;214,46583132358;194;0
vpja01;18;1408;1574;-131,581242081122;280,36583132358;166;255255000
vpja01;18;1625;1728;-140,081242081122;83,1658313235798;103;0
vpja01;18;1785;2559;-252,181242081122;-162,63416867642;774;255000
vpja01;18;2576;4019;-250,881242081122;-163,23416867642;1443;255000
vpja01;18;4037;4145;-251,881242081122;-162,03416867642;108;255000
vpja01;18;4198;4418;198,018757918878;3,46583132357978;220;0
vpja01;18;4443;6324;240,518757918878;29,1658313235798;1881;255
vpja01;18;6335;6732;246,918757918878;37,9658313235798;397;255
vpja01;18;6759;6933;247,818757918878;102,96583132358;174;255
vpja01;18;6994;7343;-94,7812420811224;299,36583132358;349;255255000
vpja01;18;7369;7696;-172,181242081122;318,56583132358;327;255255000
vpja01;18;7716;7876;-185,581242081122;299,26583132358;160;255255000
vpja01;18;7930;8127;38,0187579188776;182,96583132358;197;0
vpja01;18;8184;8298;-178,381242081122;62,7658313235798;114;0
vpja01;18;8354;8552;-280,581242081122;-151,13416867642;198;255000
vpja01;18;8598;8775;-105,181242081122;-147,03416867642;177;0
vpja01;18;8811;8931;-9,38124208112242;-153,73416867642;120;0
vpja01;18;8988;9660;-254,981242081122;-171,93416867642;672;255000
vpja01;18;9674;10000;-254,981242081122;-158,83416867642;326;255000
vpja01;19;223;282;3,79999999999995;-165,8;59;2,55e+08
vpja01;19;311;439;3,79999999999995;-243,6;128;255000
vpja01;19;459;676;11,4;-279,7;217;255000
vpja01;19;683;843;18,9;-286,7;160;255000
vpja01;19;868;1155;-13,2;-238,9;287;255000
vpja01;19;2694;3022;244,1;166,4;328;255255000
vpja01;19;3042;3269;278,7;167,3;227;0
vpja01;19;3290;3768;240,9;164,1;478;255255000
vpja01;19;3806;3942;116,9;89,3;136;0
vpja01;19;4936;5016;-63,6;-202;80;0
vpja01;19;5047;5229;5,59999999999991;-265,1;182;255000
vpja01;19;5248;5506;26,3;-298,4;258;255000
vpja01;19;5531;5830;-2,5;-246,6;299;255000
vpja01;19;5861;6032;5,19999999999993;-325,1;171;255000
vpja01;19;6059;6389;-42;-376,6;330;0
vpja01;19;6410;6574;-68,7;-415,8;164;0
vpja01;19;6593;7094;-84,9000000000001;-447,9;501;0
vpja01;19;7113;7492;-52,2;-458,7;379;0
vpja01;19;7520;7731;-120,8;-435,1;211;0
vpja01;19;7762;7998;-88,4000000000001;-363,1;236;0
vpja01;19;8026;8183;-93,6;-427,4;157;0
vpja01;19;8238;8673;180;-366,1;435;0
vpja01;19;8718;8955;6,59999999999991;-313,1;237;255000
vpja01;19;8982;9380;-16,5;-267,8;398;255000
vpja01;19;9401;9591;-13,8000000000001;-305,9;190;255000
vpja01;19;9604;10000;2,5;-322,1;396;255000
vpja01;20;214;311;-181,9;-56,8;97;0
vpja01;20;358;680;-337,8;-95,7;322;255000
vpja01;20;695;1593;-359;-115,9;898;255000
vpja01;20;1625;1830;-312,5;-20,6;205;2,55e+08
vpja01;20;2533;2851;-41,2;64,7;318;255255000
vpja01;20;4192;4595;-40,4;81,6;403;255255000
vpja01;20;4621;4805;19,6999999999999;71,5;184;255255000
vpja01;20;4828;4964;59;69,3000000000001;136;255255000
vpja01;20;5009;5144;-1,30000000000007;-123,3;135;0
vpja01;20;5177;5385;-28,6;-210,5;208;0
vpja01;20;5407;5572;-30;-244,7;165;0
vpja01;20;5602;5843;-152,1;-230,9;241;0
vpja01;20;5896;6181;-355,7;-110,8;285;255000
vpja01;20;6194;6464;-366,7;-123;270;255000
vpja01;20;6472;6608;-374,8;-131,4;136;255000
vpja01;20;6645;6850;-246,1;-214,6;205;0
vpja01;20;6871;7063;-217,5;-238,7;192;0
vpja01;20;7097;7240;-137;-276,7;143;0
vpja01;20;7275;7488;-11,5;-342,2;213;0
vpja01;20;7509;7685;36,9;-373,4;176;0
vpja01;20;7703;7875;70,6;-408,7;172;0
vpja01;20;7905;8090;179;-408,2;185;0
vpja01;20;8114;8511;180,9;-370,1;397;0
vpja01;20;8539;8754;98,1;-378,9;215;0
vpja01;20;8791;8948;21,1999999999999;-357,6;157;0
vpja01;20;8998;9212;-157,6;-247,6;214;0
vpja01;20;9271;9553;-374,4;-104,1;282;255000
vpja01;21;345;547;81,4000000000001;77,6;202;255255000
vpja01;21;1339;1450;-123,8;-128,3;111;2,55e+08
vpja01;21;1472;1681;-119,1;-174,8;209;255000
vpja01;21;1695;1885;-121,3;-198,4;190;255000
vpja01;21;2645;2968;92;88,9;323;255255000
vpja01;21;2988;3471;69,3000000000001;84;483;255255000
vpja01;21;4186;4255;-286;104,9;69;0
vpja01;21;4317;4496;-110,5;-185,1;179;255000
vpja01;21;4515;4980;-112,9;-210;465;255000
vpja01;21;6322;6659;67,9000000000001;91,1;337;255255000
vpja01;21;6672;8032;80,5;72,8000000000001;1360;255255000
vpja01;21;9289;9411;-94,1999999999999;-127,9;122;2,55e+08
vpja01;21;9439;9651;-105,7;-199,5;212;255000
vpja01;21;9662;10000;-113,7;-210,7;338;255000
vpja01;22;200;382;7,30000000000007;-124;182;2,55e+08
vpja01;22;404;573;17,7;-168,9;169;2,55e+08
vpja01;22;620;840;7,5;-347,7;220;255000
vpja01;22;1481;1644;366,7;357,1;163;0
vpja01;22;1670;1918;430,6;403,8;248;0
vpja01;22;1938;2107;418,8;432,3;169;255255000
vpja01;22;2174;2300;74,2;202,7;126;0
vpja01;22;2358;2482;188,4;-82,7;124;2,55e+08
vpja01;22;2523;2681;288,9;-174,6;158;0
vpja01;22;2728;3010;36,5;-309,8;282;255000
vpja01;22;3041;3417;-11,5;-314;376;255000
vpja01;22;3445;3646;14,7;-372,4;201;255000
vpja01;22;3714;4226;-314,5;-276,5;512;0
vpja01;22;4275;4463;-471;-267,1;188;0
vpja01;22;4488;4914;-518,3;-279,7;426;0
vpja01;22;4941;5117;-453,6;-285,7;176;0
vpja01;22;5167;5338;-529,8;-170,6;171;0
vpja01;22;5373;5464;-359,4;-123,1;91;0
vpja01;22;5506;5696;-259;-259,7;190;0
vpja01;22;5741;5842;-336,9;-169,3;101;0
vpja01;22;5905;6084;-34;-365,9;179;255000
vpja01;22;6108;6268;14,4000000000001;-391,4;160;255000
vpja01;22;6320;6646;63,3000000000001;-154,9;326;2,55e+08
vpja01;22;6678;6713;58,4000000000001;-231,5;35;2,55e+08
vpja01;22;6746;7044;1,5;-336,9;298;255000
vpja01;22;7062;7244;3,10000000000002;-368,9;182;255000
vpja01;22;7254;7497;14,8000000000001;-377;243;255000
vpja01;22;7521;7679;0,300000000000068;-332,2;158;255000
vpja01;22;7736;7934;263,3;-230,6;198;0
vpja01;22;7956;8121;259;-205,6;165;0
vpja01;22;8173;8376;65,6;-278,6;203;2,55e+08
vpja01;22;8440;8643;226,8;-1,29999999999995;203;2,55e+08
vpja01;22;8673;8874;307,8;8,60000000000002;201;0
vpja01;22;8933;9118;423,2;307,6;185;255255000
vpja01;22;9147;9402;442,9;409,5;255;255255000
vpja01;22;9420;9767;439,8;438,8;347;255255000
vpja01;22;9790;9986;395,6;453,3;196;255255000
vpja01;23;224;339;-16,2244604316546;-80,1438848920864;115;2,55e+08
vpja01;23;395;615;-116,424460431655;-256,243884892086;220;255000
vpja01;23;638;791;-103,824460431655;-304,343884892086;153;255000
vpja01;23;1081;1358;-446,224460431655;315,656115107914;277;255
vpja01;23;1385;1572;-486,024460431655;352,656115107914;187;255
vpja01;23;1595;2568;-495,024460431655;368,156115107914;973;255
vpja01;23;2593;2982;-459,824460431655;342,956115107914;389;255
vpja01;23;3001;3172;-441,924460431655;329,256115107914;171;255
vpja01;23;3249;3435;234,175539568345;280,556115107914;186;0
vpja01;23;3461;3924;253,275539568345;253,756115107914;463;255255000
vpja01;23;3948;4171;269,075539568345;274,856115107914;223;255255000
vpja01;23;4222;4344;289,075539568345;123,556115107914;122;0
vpja01;23;4372;4635;320,575539568345;72,5561151079137;263;0
vpja01;23;4654;4960;347,175539568345;93,1561151079136;306;0
vpja01;23;4979;5196;373,175539568345;76,6561151079136;217;0
vpja01;23;5231;5638;468,875539568345;31,0561151079137;407;0
vpja01;23;5676;5788;383,575539568345;57,9561151079137;112;0
vpja01;23;5837;6154;282,975539568345;243,756115107914;317;0
vpja01;23;6176;6727;290,075539568345;271,956115107914;551;0
vpja01;23;6814;7029;-422,124460431655;306,756115107914;215;255
vpja01;23;7056;7283;-466,724460431655;351,256115107914;227;255
vpja01;23;7302;7892;-489,924460431655;356,456115107914;590;255
vpja01;23;7918;8253;-445,524460431655;303,756115107914;335;255
vpja01;23;8272;8481;-471,524460431655;297,356115107914;209;255
vpja01;23;8526;8629;-367,224460431655;149,056115107914;103;0
vpja01;23;8696;8854;-169,924460431655;-274,743884892086;158;255000
vpja01;23;8881;9044;-134,924460431655;-306,643884892086;163;255000
vpja01;23;9063;9426;-114,324460431655;-328,743884892086;363;255000
vpja01;23;9451;9647;-123,224460431655;-277,143884892086;196;255000
vpja01;23;9669;9931;-123,424460431655;-255,243884892086;262;255000
vpja01;24;279;395;179,6;148,9;116;0
vpja01;24;448;658;-39,5;296;210;255
vpja01;24;720;887;305,3;229,4;167;0
vpja01;24;907;1094;345,8;226,5;187;0
vpja01;24;1111;1274;377,8;235,6;163;0
vpja01;24;1344;1623;-43,9000000000001;315;279;255
vpja01;24;1632;1868;-46,1;324,5;236;255
vpja01;24;1897;2023;-26,8000000000001;272,1;126;255
vpja01;24;2091;2267;-49,8000000000001;-200,7;176;255000
vpja01;24;2294;2567;-44,4000000000001;-250,2;273;255000
vpja01;24;2592;3083;-61;-200;491;255000
vpja01;24;3104;3521;-43,5;-241,9;417;255000
vpja01;24;3549;3808;-64,9000000000001;-197,4;259;255000
vpja01;24;3829;4003;-57,3000000000001;-234,5;174;255000
vpja01;24;4016;4284;-57,7;-252,1;268;255000
vpja01;24;4329;4561;-102,6;-162,4;232;2,55e+08
vpja01;24;4591;4729;-133,9;-63,2;138;2,55e+08
vpja01;24;4775;5004;-262;5,69999999999993;229;2,55e+08
vpja01;24;5197;5374;-30;214,5;177;2,55e+08
vpja01;24;5398;5795;20,0999999999999;217,4;397;2,55e+08
vpja01;24;5821;5984;88,8;218,3;163;0
vpja01;24;6011;6409;-0,600000000000023;223,2;398;2,55e+08
vpja01;24;6435;6595;65,8;212,1;160;2,55e+08
vpja01;24;6612;6826;87,5999999999999;211,3;214;2,55e+08
vpja01;24;6861;7064;16,8;259;203;0
vpja01;24;7090;7386;77,8999999999999;225,1;296;0
vpja01;24;7397;7613;87,8999999999999;210,8;216;2,55e+08
vpja01;24;7657;7930;-24;312,1;273;255
vpja01;24;7951;8219;-51,5;321,4;268;255
vpja01;24;8227;8424;-66;326,9;197;255
vpja01;24;8464;8706;21,6999999999999;226,7;242;2,55e+08
vpja01;24;8764;9178;319,9;217,8;414;0
vpja01;24;9440;10000;365,3;223,1;560;0
vpja01;25;254;379;-26,6833333333334;-29,1666666666666;125;0
vpja01;25;440;655;-173,483333333333;-243,766666666667;215;255000
vpja01;25;668;1316;-197,683333333333;-254,466666666667;648;255000
vpja01;25;1378;1534;-163,083333333333;28,3333333333334;156;2,55e+08
vpja01;25;1574;1768;-94,4833333333333;230,833333333333;194;0
vpja01;25;1790;2044;-80,6833333333334;249,933333333333;254;2,55e+08
vpja01;25;2078;2226;-64,7833333333333;127,333333333333;148;255
vpja01;25;2255;2525;-38,4833333333333;51,0333333333334;270;255
vpja01;25;2545;2958;-50,8833333333333;30,9333333333334;413;255
vpja01;25;2995;3152;-101,783333333333;-79,9666666666666;157;2,55e+08
vpja01;25;3214;3354;-370,483333333333;-37,2666666666667;140;0
vpja01;25;3396;3650;-473,383333333333;14,9333333333334;254;255255000
vpja01;25;3673;3874;-500,283333333333;-20,1666666666666;201;255255000
vpja01;25;3892;4984;-500,483333333333;-48,5666666666666;1092;255255000
vpja01;25;4992;5346;-481,383333333333;-52,5666666666666;354;255255000
vpja01;25;5367;5723;-463,283333333333;-50,3666666666667;356;255255000
vpja01;25;5743;6023;-474,883333333333;-57,8666666666667;280;255255000
vpja01;25;6050;6145;-473,983333333333;-11,3666666666667;95;255255000
vpja01;25;6193;6417;-273,183333333333;-29,3666666666667;224;0
vpja01;25;6443;6643;-256,983333333333;27,4333333333334;200;0
vpja01;25;6701;6862;-480,483333333333;75,2333333333333;161;255255000
vpja01;25;6892;7140;-462,683333333333;-11,0666666666666;248;255255000
vpja01;25;7207;7423;-47,9833333333333;19,8333333333334;216;255
vpja01;25;7460;7649;60,0166666666667;-15,5666666666666;189;0
vpja01;25;7700;7937;246,116666666667;-49,9666666666666;237;0
vpja01;25;7973;8154;336,816666666667;-54,0666666666666;181;0
vpja01;25;8186;8333;396,416666666667;-90,7666666666667;147;0
vpja01;25;8374;8536;562,416666666667;-148,866666666667;162;0
vpja01;25;8554;9183;597,516666666667;-176,166666666667;629;0
vpja01;25;9194;9439;598,916666666667;-191,766666666667;245;0
vpja01;25;9460;9544;600,016666666667;-158,366666666667;84;0
vpja01;25;9594;9783;464,416666666667;-417,266666666667;189;0
vpja01;25;9810;10000;341,116666666667;-439,966666666667;190;0
vpja01;26;187;443;112,9;-73,6;256;2,55e+08
vpja01;26;483;832;117;-208,4;349;255000
vpja01;26;852;1011;116;-240,6;159;255000
vpja01;26;1076;1289;-337,7;29,7;213;0
vpja01;26;1325;2024;-401,9;64,6;699;255
vpja01;26;2043;2943;-419,3;64,9;900;255
vpja01;26;2997;3394;-137,7;101,5;397;0
vpja01;26;3445;3740;-319,2;94;295;0
vpja01;26;3800;4091;68,3;126,4;291;255255000
vpja01;26;4134;4625;194,5;154,5;491;255255000
vpja01;26;4658;4776;188,2;82,5;118;255255000
vpja01;26;4839;4931;63,1999999999999;-198,6;92;2,55e+08
vpja01;26;4958;5283;96,9;-247,7;325;255000
vpja01;26;5324;5467;-55,7;-326,1;143;0
vpja01;26;5529;5776;-397;-164;247;0
vpja01;26;5845;6004;-122,5;-355;159;0
vpja01;26;6043;6145;-3,70000000000005;-341,3;102;0
vpja01;26;6178;6377;-88,7;-410,6;199;0
vpja01;26;6407;6736;6;-337,6;329;0
vpja01;26;6780;6911;90,9;-243,9;131;255000
vpja01;26;6959;7153;5,19999999999993;-352,1;194;0
vpja01;26;7162;7406;9,5;-348,8;244;0
vpja01;26;7420;7985;22,6999999999999;-339,9;565;0
vpja01;26;7998;8160;13,3;-350,5;162;0
vpja01;26;8222;8432;-253,9;-354,6;210;0
vpja01;26;8457;8593;-211,6;-325,9;136;0
vpja01;26;8645;8936;6,60000000000002;-342,5;291;0
vpja01;26;8979;9253;104,4;-257,6;274;255000
vpja01;26;9302;9437;-71,4;-189,8;135;0
vpja01;26;9505;9773;-403,8;22,6;268;255
vpja01;26;9799;10000;-441,9;65,1;201;255
