vp;trial;timest;timeend;x;y;duration;roi
vpja88;1;59;255;3,20000000000005;3,10000000000002;196;2,55e+08
vpja88;1;350;492;-18,5;-328,6;142;255000
vpja88;1;592;718;-358,7;298,4;126;255
vpja88;1;768;1058;-511,8;355,7;290;255
vpja88;1;1160;1386;391,3;336,1;226;0
vpja88;1;1420;1504;440;341,4;84;0
vpja88;1;1686;1750;151,1;-294,7;64;0
vpja88;1;1759;1849;134,5;-278,6;90;0
vpja88;1;1900;2071;-13,1999999999999;-366,9;171;255000
vpja88;1;2252;2337;-3,19999999999993;-439,3;85;255000
vpja88;1;2351;2501;2,20000000000005;-410;150;255000
vpja88;1;2563;2863;-264,6;-319,9;300;0
vpja88;1;2890;3035;-310,3;-306,6;145;0
vpja88;1;3090;3257;-528,3;-345,1;167;0
vpja88;1;3355;3885;425,9;-265,4;530;0
vpja88;1;4100;4142;400,4;-300,4;42;0
vpja88;1;4161;4237;400,5;-252,6;76;0
vpja88;1;4293;4775;569,1;-118,9;482;0
vpja88;1;4818;5042;594,5;47,1999999999999;224;0
vpja88;1;5231;5314;559,4;100,2;83;0
vpja88;1;5394;5626;348,3;-83,3000000000001;232;0
vpja88;1;5656;5884;367;20,9;228;0
vpja88;1;5920;6002;308,3;-31,2;82;0
vpja88;1;6052;6390;281,2;-219,1;338;0
vpja88;1;6417;6527;282,2;-277,6;110;0
vpja88;1;6612;6883;-311,3;-301,5;271;0
vpja88;1;6911;7089;-232,2;-353,1;178;0
vpja88;1;7113;7473;-202,3;-369,1;360;0
vpja88;1;7544;7720;-573,9;-369,6;176;0
vpja88;1;7751;8103;-562,2;-463,4;352;0
vpja88;1;8186;8475;22,3000000000001;-442,5;289;255000
vpja88;1;8654;8862;-30,0999999999999;-205,1;208;2,55e+08
vpja88;1;8901;8937;109,7;-164,6;36;2,55e+08
vpja88;1;9138;9290;114,4;-149,6;152;2,55e+08
vpja88;1;9309;9580;123,3;-135,1;271;2,55e+08
vpja88;1;9636;9916;-47,4;33,1999999999999;280;2,55e+08
vpja88;1;9945;10000;-26,8;106,7;55;2,55e+08
vpja88;2;112;301;8,94798233875338;21,7286851625115;189;2,55e+08
vpja88;2;341;500;-35,0520176612466;-155,571314837489;159;2,55e+08
vpja88;2;525;714;-48,7520176612467;-176,371314837489;189;255000
vpja88;2;763;885;-250,752017661247;-229,271314837489;122;0
vpja88;2;925;1210;-402,952017661247;-239,471314837489;285;0
vpja88;2;1283;1387;-503,752017661247;193,628685162511;104;0
vpja88;2;1429;1793;-527,752017661247;293,528685162511;364;255
vpja88;2;1857;1988;-39,1520176612466;347,628685162511;131;0
vpja88;2;2012;2220;14,9479823387534;357,428685162511;208;255255000
vpja88;2;2245;2399;62,9479823387534;299,028685162511;154;255255000
vpja88;2;2592;2680;-23,3520176612466;-264,871314837489;88;255000
vpja88;2;2721;3046;-33,8520176612466;-307,871314837489;325;255000
vpja88;2;3202;3229;321,147982338753;189,028685162511;27;0
vpja88;2;3423;3588;376,347982338753;181,228685162512;165;0
vpja88;2;3612;3667;423,847982338753;131,728685162512;55;0
vpja88;2;3928;4317;446,547982338753;188,428685162511;389;0
vpja88;2;4644;4871;225,747982338753;33,4286851625114;227;2,55e+08
vpja88;2;4905;5019;181,547982338753;-85,9713148374885;114;2,55e+08
vpja88;2;5082;5323;-2,05201766124662;-277,171314837489;241;255000
vpja88;2;5358;5505;-26,2520176612467;-131,371314837489;147;2,55e+08
vpja88;2;5705;6075;-57,8520176612466;-285,671314837489;370;255000
vpja88;2;6168;6344;-438,352017661247;274,228685162512;176;255
vpja88;2;6373;6538;-529,852017661247;281,628685162511;165;255
vpja88;2;6641;6819;-65,5520176612466;-283,671314837489;178;255000
vpja88;2;6847;7169;-63,6520176612466;-327,971314837489;322;255000
vpja88;2;7266;7714;-490,152017661247;272,728685162512;448;255
vpja88;2;7740;7868;-540,352017661247;266,128685162511;128;255
vpja88;2;8030;8063;-540,752017661247;289,528685162511;33;255
vpja88;2;8307;8357;-568,152017661247;300,728685162512;50;255
vpja88;2;8573;8674;-552,252017661247;281,728685162512;101;255
vpja88;2;8693;8714;-554,952017661247;304,828685162511;21;255
vpja88;2;8919;9090;-464,152017661247;-59,6713148374886;171;0
vpja88;2;9125;9341;-448,552017661247;-161,871314837489;216;0
vpja88;2;9368;9524;-515,752017661247;-124,371314837489;156;0
vpja88;2;9552;9774;-580,752017661247;-231,371314837489;222;0
vpja88;2;9800;10000;-612,552017661247;-299,671314837489;200;0
vpja88;3;237;367;39,6;-57,9;130;255000
vpja88;3;389;747;54,6999999999999;-65,4;358;255000
vpja88;3;763;955;58,0000000000001;-78,3;192;255000
vpja88;3;997;1033;29,6;-176,1;36;0
vpja88;3;1082;1224;-1,79999999999995;-297,1;142;0
vpja88;3;1276;1513;-156,1;-366,3;237;0
vpja88;3;1553;1586;42,6999999999999;-331,1;33;0
vpja88;3;1618;1830;187,2;-317,6;212;0
vpja88;3;1892;1964;277,4;-82,8;72;0
vpja88;3;2126;2244;16,6;-45,9;118;255000
vpja88;3;2320;2610;290,1;163;290;255
vpja88;3;2626;2886;311,4;158,6;260;255
vpja88;3;2901;3088;284,2;158,6;187;0
vpja88;3;3148;3297;9;108,9;149;255255000
vpja88;3;3325;3678;-42,1999999999999;80,3;353;255255000
vpja88;3;3717;3846;20,5;-13,7;129;255000
vpja88;3;3915;4032;271,7;-172,5;117;0
vpja88;3;4058;4300;304,4;-177;242;0
vpja88;3;4325;4551;369,9;-187,2;226;0
vpja88;3;4564;4783;386,4;-187,8;219;0
vpja88;3;4799;5009;380,6;-196,4;210;0
vpja88;3;5074;5373;-5,39999999999998;-239,2;299;0
vpja88;3;5555;5632;-91,4;-275,5;77;0
vpja88;3;5678;5947;-322,7;-274,6;269;0
vpja88;3;6008;6250;-554,3;-211,6;242;0
vpja88;3;6311;6462;-610,4;102,3;151;0
vpja88;3;6486;7008;-572,1;137,9;522;0
vpja88;3;7063;7262;-573,1;379,7;199;0
vpja88;3;7298;7436;-495;378,9;138;0
vpja88;3;7462;7591;-367;331,2;129;0
vpja88;3;7771;7871;352,1;16,9;100;0
vpja88;3;7908;8059;276,8;69,1;151;0
vpja88;3;8089;8179;165,9;62,5;90;0
vpja88;3;8405;8532;118,7;110,6;127;0
vpja88;3;8559;8840;50,3000000000001;52,2;281;2,55e+08
vpja88;3;8867;8929;53,8000000000001;-28,1;62;255000
vpja88;3;8963;9188;58,6;-82,1;225;255000
vpja88;3;9200;9751;60,3000000000001;-82,9;551;255000
vpja88;3;9948;10000;314,6;171,5;52;255
vpja88;4;304;391;-50,1;-208,1;87;255000
vpja88;4;414;525;-52,8;-273;111;255000
vpja88;4;750;909;339,7;202,3;159;255
vpja88;4;930;1403;331,3;194,6;473;255
vpja88;4;1488;1672;-398,2;206;184;255255000
vpja88;4;1696;1993;-449,5;177,8;297;255255000
vpja88;4;2030;2366;-437,9;252,8;336;255255000
vpja88;4;2382;2469;-421,5;274,6;87;255255000
vpja88;4;2664;2686;-469,9;460,6;22;0
vpja88;4;2704;2914;-432,8;305,8;210;255255000
vpja88;4;2929;3113;-424,6;268,3;184;255255000
vpja88;4;3138;3413;-378,5;215,8;275;255255000
vpja88;4;3438;3716;-421,9;277,6;278;255255000
vpja88;4;3729;3928;-411,7;277,4;199;255255000
vpja88;4;3953;4044;-382,9;215,8;91;255255000
vpja88;4;4129;4235;-419;-76,7;106;0
vpja88;4;4278;4459;-546,2;-167,6;181;0
vpja88;4;4482;4684;-551,6;-201;202;0
vpja88;4;4744;4982;-476,4;66,3;238;0
vpja88;4;5021;5092;-534,8;31,1;71;0
vpja88;4;5189;5420;6,30000000000007;-444,2;231;0
vpja88;4;5445;5675;97,8000000000001;-430,8;230;0
vpja88;4;5724;5894;244,5;-432,7;170;0
vpja88;4;5980;6102;480,5;41,4;122;0
vpja88;4;6300;6373;481,7;-4,29999999999995;73;0
vpja88;4;6400;6590;563,3;-65,4;190;0
vpja88;4;6608;6660;579,8;-37,1;52;0
vpja88;4;6729;6977;119,9;29;248;0
vpja88;4;7005;7159;32,3000000000001;17,5;154;2,55e+08
vpja88;4;7199;7376;-26,5;-106;177;2,55e+08
vpja88;4;7418;7566;-45,1;-257,8;148;255000
vpja88;4;7589;7925;-29,5;-276,3;336;255000
vpja88;4;8065;8217;303,2;207,7;152;255
vpja88;4;8244;8563;323,6;223,1;319;255
vpja88;4;8586;9292;312,5;205,7;706;255
vpja88;4;9542;9601;-405,6;-83;59;0
vpja88;4;9655;9708;-482,3;-175,8;53;0
vpja88;4;9778;9936;-41,1999999999999;-210,5;158;255000
vpja88;4;9964;10000;-35,6999999999999;-259,2;36;255000
vpja88;5;23;222;3,34798233875335;-15,3713148374885;199;2,55e+08
vpja88;5;272;446;62,1479823387534;-251,971314837489;174;255000
vpja88;5;505;564;228,147982338753;-103,771314837489;59;0
vpja88;5;617;789;53,7479823387533;-271,971314837489;172;255000
vpja88;5;864;1184;370,247982338753;202,028685162511;320;255
vpja88;5;1210;1401;379,547982338753;151,028685162511;191;255
vpja88;5;1424;1653;407,447982338753;114,428685162511;229;255
vpja88;5;1672;2026;404,947982338753;99,7286851625115;354;255
vpja88;5;2045;2381;383,347982338753;79,9286851625114;336;255
vpja88;5;2461;2588;-348,152017661247;114,428685162511;127;0
vpja88;5;2628;2880;-456,352017661247;193,928685162511;252;255255000
vpja88;5;2904;3154;-497,152017661247;203,428685162511;250;255255000
vpja88;5;3293;3805;-498,752017661247;-69,9713148374885;512;0
vpja88;5;3826;4000;-515,452017661247;-45,9713148374885;174;0
vpja88;5;4098;4304;-595,652017661247;-359,971314837489;206;0
vpja88;5;4330;4625;-589,352017661247;-389,471314837489;295;0
vpja88;5;4646;4783;-561,552017661247;-383,471314837489;137;0
vpja88;5;4886;4981;-387,952017661247;-27,1713148374886;95;0
vpja88;5;5008;5390;-406,952017661247;-66,7713148374885;382;0
vpja88;5;5403;5631;-388,852017661247;-66,6713148374886;228;0
vpja88;5;5656;5957;-326,052017661247;-30,0713148374886;301;0
vpja88;5;6142;6371;90,5479823387533;-242,171314837489;229;255000
vpja88;5;6390;6851;86,6479823387534;-251,571314837489;461;255000
vpja88;5;6921;7088;493,947982338753;-309,871314837489;167;0
vpja88;5;7115;7408;557,347982338753;-324,371314837489;293;0
vpja88;5;7441;7621;493,747982338753;-253,171314837489;180;0
vpja88;5;7641;7829;483,847982338753;-221,871314837489;188;0
vpja88;5;8028;8075;186,047982338753;-117,671314837489;47;2,55e+08
vpja88;5;8112;8342;100,747982338753;-238,371314837489;230;255000
vpja88;5;8366;8401;77,4479823387534;-270,671314837489;35;255000
vpja88;5;8633;8734;68,0479823387533;-182,071314837489;101;255000
vpja88;5;8765;9024;15,4479823387534;-75,3713148374885;259;2,55e+08
vpja88;5;9090;9260;88,6479823387534;-265,271314837489;170;255000
vpja88;5;9333;9528;374,247982338753;103,528685162511;195;255
vpja88;5;9552;9999;361,647982338753;149,928685162511;447;255
vpja88;6;204;305;95,1003610108304;-131,048375451263;101;255000
vpja88;6;328;551;133,10036101083;-125,048375451263;223;255000
vpja88;6;617;775;350,80036101083;130,951624548737;158;0
vpja88;6;802;971;390,60036101083;194,451624548737;169;255
vpja88;6;1044;1194;139,90036101083;-102,148375451263;150;255000
vpja88;6;1221;1616;146,40036101083;-128,148375451263;395;255000
vpja88;6;1686;1838;336,40036101083;174,251624548737;152;0
vpja88;6;1865;2100;407,70036101083;199,551624548737;235;255
vpja88;6;2137;2352;436,70036101083;282,351624548737;215;255
vpja88;6;2382;2566;412,40036101083;183,251624548737;184;255
vpja88;6;2577;2772;398,80036101083;176,151624548737;195;0
vpja88;6;2783;2968;405,70036101083;184,851624548737;185;255
vpja88;6;3101;3204;175,70036101083;-108,048375451263;103;255000
vpja88;6;3223;3382;154,90036101083;-118,448375451263;159;2,55e+08
vpja88;6;3416;3678;210,40036101083;-135,848375451263;262;0
vpja88;6;3690;3876;224,70036101083;-133,748375451263;186;0
vpja88;6;3946;4102;-91,2996389891697;201,551624548737;156;255255000
vpja88;6;4128;4265;-110,39963898917;265,251624548737;137;255255000
vpja88;6;4868;5089;-422,89963898917;98,4516245487366;221;0
vpja88;6;5140;5292;-457,39963898917;-39,6483754512634;152;0
vpja88;6;5328;5537;-470,79963898917;-102,448375451263;209;0
vpja88;6;5602;5778;-409,09963898917;-303,148375451263;176;0
vpja88;6;5812;5991;-288,89963898917;-350,748375451263;179;0
vpja88;6;6024;6264;-189,09963898917;-348,448375451263;240;0
vpja88;6;6291;6467;-112,79963898917;-322,948375451263;176;0
vpja88;6;6525;6637;71,0003610108303;-193,948375451263;112;255000
vpja88;6;6666;6920;132,60036101083;-111,048375451263;254;255000
vpja88;6;7084;7137;173,20036101083;-128,748375451263;53;0
vpja88;6;7347;7666;156,70036101083;-113,948375451263;319;2,55e+08
vpja88;6;7723;7931;226,80036101083;63,3516245487366;208;2,55e+08
vpja88;6;7952;8233;201,70036101083;90,6516245487365;281;2,55e+08
vpja88;6;8279;8558;384,50036101083;277,851624548737;279;255
vpja88;6;8832;8857;535,30036101083;454,151624548737;25;0
vpja88;6;8895;9068;412,20036101083;319,751624548737;173;255
vpja88;6;9131;9393;596,60036101083;429,251624548737;262;0
vpja88;6;9440;9703;405,30036101083;260,951624548737;263;255
vpja88;6;9724;10000;419,10036101083;292,551624548737;276;255
vpja88;7;287;526;-402;-240,3;239;255000
vpja88;7;648;974;-557,7;295,4;326;255
vpja88;7;997;1295;-521,9;334,6;298;255
vpja88;7;1329;1473;-540,8;303,2;144;255
vpja88;7;1549;1649;-446,1;-223,3;100;255000
vpja88;7;1674;1988;-413;-281,9;314;255000
vpja88;7;2005;2154;-397,9;-299,9;149;255000
vpja88;7;2234;2476;74,6000000000001;184,2;242;255255000
vpja88;7;2497;2833;92,5;200,3;336;255255000
vpja88;7;2856;3079;51;206,2;223;255255000
vpja88;7;3184;3240;393,6;-230,6;56;0
vpja88;7;3254;3428;391,8;-187,9;174;0
vpja88;7;3438;3759;379,7;-169,6;321;0
vpja88;7;3781;4000;389,7;-208,9;219;0
vpja88;7;4037;4426;267,8;-99,3;389;0
vpja88;7;4452;5013;243,4;5,10000000000002;561;0
vpja88;7;5174;5317;-445,5;-304,3;143;255000
vpja88;7;5375;6111;-610;-276,5;736;0
vpja88;7;6278;6395;-614,1;-226,9;117;0
vpja88;7;6428;6555;-488,9;-257,1;127;255000
vpja88;7;6604;6798;-380,9;-147,5;194;2,55e+08
vpja88;7;6864;7102;-476,2;238;238;0
vpja88;7;7127;7428;-513;278;301;255
vpja88;7;7489;7722;-196,5;318;233;0
vpja88;7;7776;7908;53,4000000000001;218,7;132;255255000
vpja88;7;7935;8253;88,4000000000001;173,5;318;255255000
vpja88;7;8340;8436;-389,6;-235,4;96;255000
vpja88;7;8463;8811;-409,5;-296,8;348;255000
vpja88;7;8973;9207;-401;-302,4;234;255000
vpja88;7;9220;9309;-408,9;-313,9;89;255000
vpja88;7;9537;9632;-418,7;-318,6;95;255000
vpja88;7;9655;9931;-443,8;-306,6;276;255000
vpja88;8;264;383;-92,2;-148;119;255000
vpja88;8;404;554;-119,5;-180,9;150;255000
vpja88;8;573;928;-129,5;-191,7;355;255000
vpja88;8;1870;2034;56;110,5;164;0
vpja88;8;2266;2356;92,2;144,8;90;0
vpja88;8;2370;2405;96,7;162,1;35;0
vpja88;8;2430;2466;145,8;267,9;36;0
vpja88;8;2710;2735;123,9;276,8;25;0
vpja88;8;2754;2786;58;202,7;32;0
vpja88;8;2805;3065;75,9000000000001;144,6;260;0
vpja88;8;3076;3440;85,2;88,7;364;255255000
vpja88;8;3465;3702;13,7;65,4000000000001;237;0
vpja88;8;3730;3833;66,5;84,9000000000001;103;255255000
vpja88;8;3886;4046;-125,8;-154,1;160;255000
vpja88;8;4065;4197;-122,4;-179,4;132;255000
vpja88;8;4254;4387;54,0999999999999;16,9000000000001;133;0
vpja88;8;4416;4717;81;99,4000000000001;301;255255000
vpja88;8;4727;4994;72,9000000000001;94,6;267;255255000
vpja88;8;5002;5192;79,8;105,6;190;255255000
vpja88;8;5204;5328;90;95,9000000000001;124;255255000
vpja88;8;5391;5701;308,7;-15,5;310;0
vpja88;8;5717;5936;304,8;-38;219;0
vpja88;8;5948;6057;301,9;-54,5999999999999;109;0
vpja88;8;6108;6310;581,4;-134,2;202;0
vpja88;8;6335;6544;592,4;-197;209;0
vpja88;8;6569;6883;588,8;-240,1;314;0
vpja88;8;6896;6949;590,7;-250,1;53;0
vpja88;8;7011;7260;304,7;-381,8;249;0
vpja88;8;7319;7404;60;-361,9;85;0
vpja88;8;7473;7704;-365;-328,5;231;0
vpja88;8;7739;7904;-459,7;-250,5;165;0
vpja88;8;7984;8182;-600,2;209,6;198;0
vpja88;8;8242;8379;-396;360,5;137;0
vpja88;8;8409;8642;-384,9;467,5;233;0
vpja88;8;8665;8802;-348;461,6;137;0
vpja88;8;9010;9062;-96;-40;52;2,55e+08
vpja88;8;9094;9213;-113,6;-167,8;119;255000
vpja88;8;9307;9342;-316,4;157,1;35;0
vpja88;8;9738;9903;-128,9;-164,9;165;255000
vpja88;8;9935;10000;-117;-195,7;65;255000
vpja88;9;207;255;-9,09999999999991;-184,3;48;255000
vpja88;9;284;906;-18,0999999999999;-278,9;622;255000
vpja88;9;1068;1292;-319,5;143,7;224;0
vpja88;9;1313;1743;-349,6;169,6;430;255
vpja88;9;1836;2378;-12,4;-289,2;542;255000
vpja88;9;2391;2468;-28,1999999999999;-287,7;77;255000
vpja88;9;2554;2713;328,5;130,9;159;0
vpja88;9;2747;3019;320,6;205,9;272;255255000
vpja88;9;3046;3204;344,4;185,5;158;255255000
vpja88;9;3310;3546;270;-414;236;0
vpja88;9;3572;3751;219,4;-423,3;179;0
vpja88;9;3813;4003;-84,0999999999999;-441,1;190;0
vpja88;9;4027;4420;-130,6;-449,3;393;0
vpja88;9;4471;4563;-51;-330,6;92;255000
vpja88;9;4592;4892;-23,8;-253,8;300;255000
vpja88;9;4933;5062;18,1;-110,2;129;2,55e+08
vpja88;9;5124;5313;-353,8;150,5;189;0
vpja88;9;5582;5727;-351,6;166,7;145;255
vpja88;9;5832;6103;0,300000000000068;-228,9;271;255000
vpja88;9;6292;6404;25,1;-247,6;112;255000
vpja88;9;6428;6570;48,4000000000001;-268,7;142;255000
vpja88;9;6596;6879;-9,19999999999993;-283,4;283;255000
vpja88;9;6901;7033;-31,8;-278,3;132;255000
vpja88;9;7124;7489;599,2;150,6;365;0
vpja88;9;7508;7683;583,7;185;175;0
vpja88;9;7769;7936;593,2;-104,2;167;0
vpja88;9;7966;8056;606,5;-177,1;90;0
vpja88;9;8141;8268;292,4;207,7;127;0
vpja88;9;8287;8472;311,4;210,2;185;255255000
vpja88;9;8571;8912;16,5;-282,6;341;255000
vpja88;9;8936;8976;-20,0999999999999;-261,7;40;255000
vpja88;9;9200;9226;-347,6;254,2;26;0
vpja88;9;9250;9539;-366,9;182,2;289;255
vpja88;9;9559;9803;-340,6;176,9;244;255
vpja88;9;9897;10000;-58,0999999999999;-241,6;103;0
vpja88;10;345;373;4,60000000000002;123,4;28;2,55e+08
vpja88;10;431;466;-10,3000000000001;-180,7;35;255000
vpja88;10;504;899;-17,3000000000001;-230,5;395;255000
vpja88;10;906;1381;-22,3000000000001;-211,7;475;255000
vpja88;10;1457;1851;-336,7;98,7;394;255
vpja88;10;1871;2297;-347,1;128,7;426;255
vpja88;10;2313;2417;-332,4;150,8;104;255
vpja88;10;2556;2851;-334,2;128,5;295;255
vpja88;10;2872;3017;-352,7;114,5;145;255
vpja88;10;3092;3342;229,3;165,8;250;255255000
vpja88;10;3364;3828;264,9;171,1;464;255255000
vpja88;10;3899;4009;39,1;-98,7;110;2,55e+08
vpja88;10;4071;4201;-309,6;109,1;130;255
vpja88;10;4255;4275;-347,6;129,3;20;255
vpja88;10;4345;4556;-343,8;122,6;211;255
vpja88;10;4836;4874;-248,6;-232,6;38;0
vpja88;10;4928;5075;-121,1;-288,8;147;0
vpja88;10;5106;5265;-198,2;-298,8;159;0
vpja88;10;5354;5642;511,7;-19;288;0
vpja88;10;5670;5738;510,2;-68,9;68;0
vpja88;10;5823;5932;-3,20000000000005;-139;109;255000
vpja88;10;5959;6761;-20,7;-197,8;802;255000
vpja88;10;6824;6987;-79;37,1;163;2,55e+08
vpja88;10;7013;7202;-132,5;106,2;189;2,55e+08
vpja88;10;7225;7704;-150,8;132,1;479;2,55e+08
vpja88;10;8870;8907;0,100000000000023;-155,4;37;255000
vpja88;10;9157;9181;-12,1;17,9;24;2,55e+08
vpja88;10;9436;9744;-17;-206,1;308;255000
vpja88;10;9812;9837;222,3;63,7;25;0
vpja88;11;199;293;-322,524911032029;-127,716725978648;94;255000
vpja88;11;315;434;-369,224911032028;-138,216725978648;119;255000
vpja88;11;465;630;-347,324911032028;-47,5167259786477;165;2,55e+08
vpja88;11;654;772;-311,124911032028;6,38327402135235;118;2,55e+08
vpja88;11;827;890;-362,724911032028;-164,416725978648;63;255000
vpja88;11;921;1108;-238,924911032028;-239,716725978648;187;0
vpja88;11;1147;1259;-276,024911032029;-193,116725978648;112;0
vpja88;11;1285;1474;-355,124911032028;-147,816725978648;189;255000
vpja88;11;1532;1817;6,57508896797151;59,5832740213523;285;255255000
vpja88;11;1837;2315;31,9750889679715;60,2832740213523;478;255255000
vpja88;11;2333;2563;56,3750889679716;63,3832740213523;230;255255000
vpja88;11;2837;2944;-363,024911032029;-97,2167259786477;107;255000
vpja88;11;2976;3398;-390,124911032028;-137,716725978648;422;255000
vpja88;11;3414;3782;-374,824911032028;-141,616725978648;368;255000
vpja88;11;3802;3997;-395,824911032028;-120,116725978648;195;255000
vpja88;11;4032;4105;-334,624911032028;-158,616725978648;73;255000
vpja88;11;4252;4361;-398,524911032029;-138,716725978648;109;255000
vpja88;11;4826;5169;-371,124911032028;-103,016725978648;343;255000
vpja88;11;5202;5450;-202,224911032028;-229,016725978648;248;0
vpja88;11;5497;5582;-314,724911032028;-150,316725978648;85;255000
vpja88;11;5697;5914;-361,224911032028;-109,716725978648;217;255000
vpja88;11;5955;6069;-271,024911032029;-162,516725978648;114;0
vpja88;11;6147;6276;365,675088967972;-171,716725978648;129;0
vpja88;11;6303;6444;429,775088967971;-147,916725978648;141;0
vpja88;11;6477;6654;574,775088967971;-159,616725978648;177;0
vpja88;11;6746;6955;196,675088967972;-438,516725978648;209;0
vpja88;11;6986;7138;85,0750889679716;-419,916725978648;152;0
vpja88;11;7160;7272;43,8750889679716;-422,416725978648;112;0
vpja88;11;7444;7487;-83,0249110320285;-276,516725978648;43;0
vpja88;11;7503;7704;-83,5249110320285;-270,316725978648;201;0
vpja88;11;7748;8108;-177,824911032028;-254,016725978648;360;0
vpja88;11;8131;8244;-239,124911032028;-254,416725978648;113;0
vpja88;11;8637;8674;-361,224911032028;5,48327402135226;37;2,55e+08
vpja88;11;8699;8833;-388,224911032028;-129,716725978648;134;255000
vpja88;11;9073;9183;-443,324911032028;-0,116725978647651;110;2,55e+08
vpja88;11;9221;9335;-323,224911032028;33,8832740213523;114;2,55e+08
vpja88;11;9344;9379;-325,424911032028;57,6832740213523;35;2,55e+08
vpja88;11;9423;9621;-66,1249110320284;110,083274021352;198;255255000
vpja88;11;9670;9820;-288,224911032028;107,783274021352;150;255
vpja88;12;301;499;-275,5;-149,5;198;255000
vpja88;12;576;807;254,7;25,5999999999999;231;255
vpja88;12;831;1114;229,6;65,3;283;255
vpja88;12;1277;1416;-157,7;295,1;139;255255000
vpja88;12;1438;1464;-156,9;297,2;26;255255000
vpja88;12;1483;1674;-129,7;288,7;191;255255000
vpja88;12;1839;1923;-322;-147;84;2,55e+08
vpja88;12;1946;2328;-283,5;-180,4;382;255000
vpja88;12;2349;2445;-249,7;-163;96;255000
vpja88;12;2465;2878;-276,3;-162,1;413;255000
vpja88;12;2897;3020;-275,6;-167,4;123;255000
vpja88;12;3073;3273;159,2;-126,1;200;0
vpja88;12;3427;3784;539;-130,2;357;0
vpja88;12;3805;3824;536,5;-156;19;0
vpja88;12;4025;4136;-113,4;-197,4;111;0
vpja88;12;4171;4378;-257,2;-216,1;207;255000
vpja88;12;4446;4610;-580,1;-270,7;164;0
vpja88;12;4637;4777;-653,3;-275,8;140;NA
vpja88;12;4815;5301;-455,3;-249,7;486;0
vpja88;12;5332;5500;-335,8;-311,6;168;0
vpja88;12;5544;5612;-395;-271,3;68;0
vpja88;12;5649;5880;-241,6;-201;231;255000
vpja88;12;5904;6032;-253,5;-179,4;128;255000
vpja88;12;6078;6198;-35,3;-163,4;120;0
vpja88;12;6344;6492;-123,6;-156,4;148;0
vpja88;12;6529;6928;-265,9;-163,9;399;255000
vpja88;12;6949;7227;-296,5;-169,3;278;255000
vpja88;12;7251;7491;-334,6;-163,5;240;255000
vpja88;12;7584;7639;209,7;10,1999999999999;55;255
vpja88;12;7887;8052;-317,5;15,4;165;2,55e+08
vpja88;12;8077;8226;-373,7;5,59999999999991;149;2,55e+08
vpja88;12;8284;8429;-305,3;-202,1;145;255000
vpja88;12;8452;8697;-279,4;-184,8;245;255000
vpja88;12;8724;8924;-346,7;-164,1;200;255000
vpja88;12;8974;9057;-334,8;-2,90000000000009;83;2,55e+08
vpja88;12;9218;9455;-324,5;-28,4000000000001;237;2,55e+08
vpja88;12;9510;9798;159,7;25,0999999999999;288;0
vpja88;12;9826;9999;230,7;59,6999999999999;173;255
vpja88;13;247;350;77;-147;103;2,55e+08
vpja88;13;377;518;85,5;-170,1;141;255000
vpja88;13;589;719;78,7;214;130;255
vpja88;13;743;937;51,5;255;194;255
vpja88;13;1014;1224;-429,4;105,9;210;0
vpja88;13;1241;1265;-411;102,7;24;0
vpja88;13;1530;1812;143;-160,1;282;255000
vpja88;13;1856;2070;140,6;-61,5;214;2,55e+08
vpja88;13;2108;2490;124,3;-164,9;382;255000
vpja88;13;2572;2810;-366,8;97,3;238;255255000
vpja88;13;2835;3230;-396,6;103,6;395;255255000
vpja88;13;3254;3404;-336,4;96,3;150;255255000
vpja88;13;3430;3831;-393,3;107,1;401;255255000
vpja88;13;3854;3978;-403,1;104,7;124;255255000
vpja88;13;4178;4585;129;-164,4;407;255000
vpja88;13;4608;4764;109,3;-94,2;156;2,55e+08
vpja88;13;4793;4984;135,1;5,5;191;2,55e+08
vpja88;13;5010;5302;128,2;56,5999999999999;292;2,55e+08
vpja88;13;5326;5415;84,5;-21,1;89;2,55e+08
vpja88;13;5667;5831;89,4000000000001;302,3;164;255
vpja88;13;5844;6167;66,4000000000001;278,1;323;255
vpja88;13;6181;6322;67,4000000000001;264,9;141;255
vpja88;13;6405;6618;119;-139,3;213;255000
vpja88;13;6645;7185;116,3;-167,2;540;255000
vpja88;13;7201;7408;128,5;-155,5;207;255000
vpja88;13;7648;7916;121,7;22,9;268;2,55e+08
vpja88;13;7979;8142;117;-169;163;255000
vpja88;13;8343;8411;146,9;-308,1;68;255000
vpja88;13;8624;8684;178,3;-323,8;60;255000
vpja88;13;8694;8812;172,2;-303;118;255000
vpja88;13;8829;9065;196,9;-302,1;236;255000
vpja88;13;9122;9248;216,8;-108,1;126;2,55e+08
vpja88;13;9274;9470;200;-160,2;196;255000
vpja88;13;9488;9608;186;-172,7;120;255000
vpja88;13;9632;10000;125,4;-162,8;368;255000
vpja88;14;200;252;-51,9656140350877;-100,708771929825;52;0
vpja88;14;285;341;-22,2656140350878;-276,308771929825;56;0
vpja88;14;380;538;19,8343859649123;-352,308771929825;158;255000
vpja88;14;558;861;8,83438596491226;-365,508771929825;303;255000
vpja88;14;869;1104;5,63438596491233;-364,408771929825;235;255000
vpja88;14;1192;1616;-358,365614035088;40,2912280701754;424;255
vpja88;14;1688;1775;203,034385964912;205,591228070175;87;0
vpja88;14;1803;1951;304,234385964912;255,791228070175;148;255255000
vpja88;14;1978;2527;368,434385964912;320,991228070175;549;255255000
vpja88;14;2560;2698;370,834385964912;265,391228070175;138;255255000
vpja88;14;2782;2833;469,734385964912;-158,208771929825;51;0
vpja88;14;2844;2957;464,234385964912;-117,008771929825;113;0
vpja88;14;3035;3180;8,0343859649123;-322,308771929825;145;0
vpja88;14;3214;3580;10,3343859649123;-360,508771929825;366;255000
vpja88;14;3660;3922;-451,665614035088;-310,808771929825;262;0
vpja88;14;4013;4116;-381,765614035088;132,691228070175;103;255
vpja88;14;4341;4371;-354,665614035088;92,6912280701755;30;255
vpja88;14;5040;5147;24,0343859649123;-329,908771929825;107;255000
vpja88;14;5179;5430;16,5343859649123;-376,208771929825;251;255000
vpja88;14;5465;5810;34,7343859649122;-276,008771929825;345;255000
vpja88;14;5836;6083;86,3343859649124;-231,908771929825;247;2,55e+08
vpja88;14;6108;6232;114,334385964912;-309,808771929825;124;0
vpja88;14;6265;6454;34,5343859649123;-350,208771929825;189;255000
vpja88;14;6521;6852;-316,765614035088;-359,608771929825;331;0
vpja88;14;6888;7349;-425,465614035088;-319,408771929825;461;0
vpja88;14;7406;7573;-433,765614035088;-465,908771929825;167;0
vpja88;14;7687;7747;292,534385964912;143,391228070175;60;0
vpja88;14;7940;8018;353,634385964912;245,991228070175;78;255255000
vpja88;14;8045;8098;361,134385964912;282,091228070175;53;255255000
vpja88;14;8175;8304;122,234385964912;-119,608771929825;129;0
vpja88;14;8370;8561;-316,565614035088;143,791228070175;191;255
vpja88;14;8595;8804;-414,065614035088;161,391228070175;209;255
vpja88;14;8856;8895;-299,865614035088;48,6912280701755;39;255
vpja88;14;8909;9023;-309,265614035088;53,1912280701755;114;255
vpja88;14;9170;9303;19,6343859649123;-357,108771929825;133;255000
vpja88;14;9323;9804;6,63438596491233;-375,108771929825;481;255000
vpja88;15;247;453;76,8479823387535;-255,271314837489;206;255000
vpja88;15;471;645;84,2479823387533;-256,171314837489;174;255000
vpja88;15;726;883;-477,052017661247;-24,5713148374886;157;0
vpja88;15;911;1472;-459,352017661247;65,8286851625114;561;255
vpja88;15;1492;1597;-480,552017661247;96,0286851625115;105;255
vpja88;15;1687;2102;262,747982338753;205,028685162511;415;255255000
vpja88;15;2125;2346;249,047982338753;172,328685162511;221;255255000
vpja88;15;2369;2636;275,147982338753;169,428685162511;267;255255000
vpja88;15;2697;2726;171,347982338753;-73,5713148374886;29;2,55e+08
vpja88;15;2741;2839;146,747982338753;-185,271314837489;98;2,55e+08
vpja88;15;2873;3035;114,647982338753;-238,971314837489;162;255000
vpja88;15;3058;3473;70,3479823387535;-263,571314837489;415;255000
vpja88;15;3534;3854;-298,252017661247;-352,971314837489;320;0
vpja88;15;3886;4014;-286,852017661247;-228,371314837489;128;0
vpja88;15;4071;4341;-439,752017661247;-10,6713148374886;270;0
vpja88;15;4497;4730;-142,552017661247;-223,571314837489;233;0
vpja88;15;4779;4826;78,2479823387533;-194,971314837489;47;255000
vpja88;15;4856;5038;146,647982338753;-199,971314837489;182;255000
vpja88;15;5061;5221;94,5479823387533;-244,971314837489;160;255000
vpja88;15;5243;5651;82,7479823387533;-253,671314837489;408;255000
vpja88;15;5730;5942;209,147982338753;171,328685162511;212;255255000
vpja88;15;6027;6273;-457,352017661247;83,0286851625115;246;255
vpja88;15;6824;6865;-647,952017661247;269,528685162511;41;NA
vpja88;15;6885;7034;-545,952017661247;123,428685162511;149;255
vpja88;15;7054;7285;-498,152017661247;81,9286851625114;231;255
vpja88;15;7327;7496;-418,452017661247;58,1286851625115;169;255
vpja88;15;7549;7589;-64,6520176612466;-127,971314837489;40;0
vpja88;15;7619;7778;64,6479823387534;-222,271314837489;159;255000
vpja88;15;7820;8144;143,547982338753;-73,5713148374886;324;2,55e+08
vpja88;15;8171;8415;230,547982338753;-88,3713148374885;244;2,55e+08
vpja88;15;8436;8760;281,847982338753;-110,871314837489;324;2,55e+08
vpja88;15;8791;8939;161,347982338753;-237,471314837489;148;255000
vpja88;15;8962;9165;104,747982338753;-258,471314837489;203;255000
vpja88;15;9359;9437;-576,452017661247;190,328685162511;78;0
vpja88;15;9469;9949;-518,052017661247;93,3286851625114;480;255
vpja88;16;258;462;-26,8;-298,2;204;255000
vpja88;16;474;1037;-6,89999999999998;-296,4;563;255000
vpja88;16;1084;1217;170,5;-101,2;133;0
vpja88;16;1242;1370;216,9;-74,2;128;0
vpja88;16;1434;1646;308;189,9;212;255
vpja88;16;1668;2039;322,6;171,7;371;255
vpja88;16;2058;2260;287,5;164,8;202;255
vpja88;16;2356;2440;36,3;-250,8;84;255000
vpja88;16;2463;2950;-3,59999999999991;-280,3;487;255000
vpja88;16;3345;3366;-315,5;163,2;21;0
vpja88;16;3419;3457;-285,3;144,8;38;255255000
vpja88;16;3518;3601;-280,8;144,5;83;255255000
vpja88;16;3700;3817;-275,3;104,6;117;255255000
vpja88;16;3841;3881;-275,2;106;40;255255000
vpja88;16;4228;4303;-223,7;30,9;75;0
vpja88;16;4506;4811;-15,4;-248,9;305;255000
vpja88;16;4833;5112;-1,29999999999995;-273,2;279;255000
vpja88;16;5186;5280;202,5;56,8;94;0
vpja88;16;5582;5638;330,2;289;56;0
vpja88;16;5644;5700;304,2;242,1;56;0
vpja88;16;5729;5984;317,6;193,6;255;255
vpja88;16;6365;6393;406,5;451,4;28;0
vpja88;16;6472;6643;143,1;80,6999999999999;171;0
vpja88;16;6689;6991;16,8000000000001;-151,6;302;2,55e+08
vpja88;16;7028;7174;90,2;-76,9000000000001;146;2,55e+08
vpja88;16;7214;7367;211;-4,80000000000007;153;0
vpja88;16;7417;7656;254,5;-72;239;0
vpja88;16;7682;7870;217,5;-40,9000000000001;188;0
vpja88;16;7886;7917;235,1;-33,5;31;0
vpja88;16;7981;8129;306,3;194,2;148;255
vpja88;16;8154;8377;329,6;139,4;223;255
vpja88;16;8405;8593;229,4;167,8;188;255
vpja88;16;8616;8832;194,4;189;216;255
vpja88;16;9316;9526;-2,5;-260,1;210;255000
vpja88;16;9587;9643;223,4;-111,7;56;0
vpja88;16;9838;10000;224,5;-98,4;162;0
vpja88;17;224;334;-39,9428571428572;-159,781954887218;110;2,55e+08
vpja88;17;362;545;-86,1428571428571;-223,281954887218;183;255000
vpja88;17;633;1037;-512,542857142857;38,8180451127819;404;0
vpja88;17;1049;1401;-492,642857142857;56,6180451127819;352;0
vpja88;17;1423;1732;-456,042857142857;54,6180451127819;309;255
vpja88;17;1752;2107;-493,142857142857;67,718045112782;355;255
vpja88;17;2121;2296;-511,242857142857;71,0180451127819;175;255
vpja88;17;2319;2456;-527,142857142857;76,9180451127819;137;255
vpja88;17;2521;2708;-45,7428571428571;38,718045112782;187;255255000
vpja88;17;2778;2963;-98,8428571428572;-192,181954887218;185;255000
vpja88;17;2984;3198;-112,242857142857;-228,781954887218;214;255000
vpja88;17;3263;3409;-65,8428571428572;38,6180451127819;146;255255000
vpja88;17;3438;3691;-34,4428571428572;110,918045112782;253;255255000
vpja88;17;3763;4279;-470,642857142857;-20,6819548872181;516;0
vpja88;17;4310;4500;-499,142857142857;-75,5819548872181;190;0
vpja88;17;4557;4775;-613,142857142857;56,8180451127819;218;0
vpja88;17;4978;5288;-497,442857142857;-60,1819548872181;310;0
vpja88;17;5319;5704;-484,642857142857;17,4180451127819;385;0
vpja88;17;5726;5923;-517,842857142857;50,218045112782;197;255
vpja88;17;5993;6087;-115,542857142857;-159,881954887218;94;0
vpja88;17;6114;6912;-102,942857142857;-235,281954887218;798;255000
vpja88;17;6989;7231;-489,942857142857;86,4180451127819;242;255
vpja88;17;7253;7327;-536,442857142857;69,9180451127819;74;255
vpja88;17;7489;7514;-672,642857142857;186,418045112782;25;NA
vpja88;17;7766;7789;-651,942857142857;212,318045112782;23;NA
vpja88;17;7809;7837;-556,242857142857;124,118045112782;28;255
vpja88;17;7866;8196;-557,442857142857;42,718045112782;330;0
vpja88;17;8221;8721;-498,242857142857;46,0180451127819;500;0
vpja88;17;8747;8806;-454,242857142857;129,318045112782;59;255
vpja88;17;8830;9050;-469,842857142857;104,718045112782;220;255
vpja88;17;9084;9203;-520,442857142857;93,8180451127819;119;255
vpja88;17;9223;9324;-544,842857142857;68,8180451127819;101;255
vpja88;17;9543;9609;-607,942857142857;74,4180451127819;66;0
vpja88;17;9646;9859;-515,842857142857;39,0180451127819;213;0
vpja88;17;9873;10000;-503,042857142857;58,6180451127819;127;255
vpja88;18;194;236;-56,1032967032967;-103,627838827839;42;255
vpja88;18;291;400;-63,8032967032966;-246,027838827839;109;0
vpja88;18;424;642;-54,7032967032966;-298,727838827839;218;0
vpja88;18;654;1003;-38,0032967032967;-310,227838827839;349;255000
vpja88;18;1014;1232;-51,4032967032966;-314,727838827839;218;255000
vpja88;18;1290;1535;-29,5032967032967;-82,1278388278388;245;255
vpja88;18;1551;1899;-46,1032967032967;-85,8278388278388;348;255
vpja88;18;1912;2108;-66,0032967032967;-87,7278388278388;196;255
vpja88;18;2151;2632;-259,603296703297;-31,8278388278388;481;0
vpja88;18;2656;2734;-205,403296703297;-16,1278388278388;78;255255000
vpja88;18;2947;3426;-253,103296703297;-20,9278388278389;479;255255000
vpja88;18;3448;3669;-283,703296703297;-30,8278388278388;221;0
vpja88;18;3963;4040;-282,903296703297;0,672161172161168;77;255255000
vpja88;18;4416;4527;-268,503296703297;8,57216117216115;111;0
vpja88;18;4543;4745;-280,603296703297;-20,6278388278388;202;255255000
vpja88;18;4812;4918;-81,1032967032967;-282,827838827839;106;0
vpja88;18;4952;5148;-60,0032967032967;-318,027838827839;196;0
vpja88;18;5164;5441;-39,3032967032966;-321,027838827839;277;255000
vpja88;18;5507;5778;-16,1032967032967;-20,8278388278388;271;2,55e+08
vpja88;18;5808;6079;24,7967032967034;21,2721611721612;271;2,55e+08
vpja88;18;6154;6375;20,3967032967033;256,672161172161;221;2,55e+08
vpja88;18;6425;6672;13,0967032967034;66,4721611721611;247;0
vpja88;18;6882;7034;47,9967032967035;71,2721611721612;152;0
vpja88;18;7064;7241;-35,8032967032966;-67,8278388278388;177;255
vpja88;18;7307;7590;-42,8032967032966;-295,127838827839;283;255000
vpja88;18;7642;7855;-56,9032967032966;-137,927838827839;213;2,55e+08
vpja88;18;7910;8098;-33,7032967032966;-335,627838827839;188;255000
vpja88;18;8160;8247;-63,4032967032966;-81,9278388278389;87;255
vpja88;18;8478;8924;-54,9032967032966;-92,1278388278388;446;255
vpja88;18;8936;9083;-75,8032967032966;-100,427838827839;147;255
vpja88;18;9271;9545;-62,5032967032967;-53,4278388278389;274;255
vpja88;18;9560;9854;-41,0032967032967;-69,1278388278388;294;255
vpja88;18;9876;9965;-48,7032967032966;-64,3278388278388;89;255
vpja88;19;27;98;84,2479823387533;99,8286851625114;71;0
vpja88;19;195;262;-97,1520176612466;-108,971314837489;67;2,55e+08
vpja88;19;293;426;-133,052017661247;-242,171314837489;133;255000
vpja88;19;448;816;-160,052017661247;-266,371314837489;368;255000
vpja88;19;894;1010;-464,152017661247;179,428685162511;116;0
vpja88;19;1035;1317;-472,852017661247;238,028685162511;282;255
vpja88;19;1354;1680;-510,652017661247;309,028685162511;326;255
vpja88;19;1702;1988;-460,152017661247;285,528685162511;286;255
vpja88;19;2023;2207;-493,452017661247;231,228685162512;184;255
vpja88;19;2236;2444;-498,952017661247;130,028685162511;208;0
vpja88;19;2486;2508;-354,152017661247;239,228685162512;22;0
vpja88;19;2535;2604;-354,852017661247;247,628685162511;69;0
vpja88;19;2674;2812;-144,552017661247;-208,371314837489;138;255000
vpja88;19;2838;3447;-169,352017661247;-258,771314837489;609;255000
vpja88;19;3713;3777;-450,552017661247;224,628685162511;64;255
vpja88;19;3807;3937;-488,752017661247;311,828685162511;130;255
vpja88;19;4088;4131;-522,052017661247;455,928685162512;43;0
vpja88;19;4377;4518;-542,252017661247;453,228685162512;141;0
vpja88;19;4545;4604;-620,152017661247;336,928685162511;59;0
vpja88;19;4619;4699;-586,652017661247;265,728685162512;80;0
vpja88;19;4722;4970;-536,152017661247;241,228685162512;248;255
vpja88;19;5201;5292;-212,252017661247;-180,971314837489;91;0
vpja88;19;5317;5540;-165,052017661247;-265,671314837489;223;255000
vpja88;19;5558;5714;-180,952017661247;-263,171314837489;156;255000
vpja88;19;5791;5996;377,147982338753;113,828685162511;205;255255000
vpja88;19;6028;6325;346,447982338753;222,328685162511;297;0
vpja88;19;6345;6697;333,947982338753;252,328685162511;352;0
vpja88;19;6721;7015;313,647982338753;208,028685162511;294;0
vpja88;19;7085;7233;346,247982338753;9,22868516251151;148;255255000
vpja88;19;7453;7629;355,047982338753;-28,4713148374885;176;255255000
vpja88;19;7657;7934;256,047982338753;-28,2713148374885;277;255255000
vpja88;19;7975;8203;309,947982338753;-101,971314837489;228;255255000
vpja88;19;8227;8407;248,947982338753;-48,2713148374885;180;255255000
vpja88;19;8429;8567;221,247982338753;-9,97131483748853;138;0
vpja88;19;8627;8741;2,94798233875338;-117,071314837489;114;0
vpja88;19;8800;8901;-129,952017661247;-161,971314837489;101;2,55e+08
vpja88;19;8949;9239;-169,352017661247;-230,271314837489;290;255000
vpja88;19;9283;9525;-42,7520176612467;-418,071314837489;242;0
vpja88;19;9592;9729;-218,652017661247;-157,671314837489;137;2,55e+08
vpja88;19;9774;9928;-411,252017661247;-210,471314837489;154;0
vpja88;20;286;300;-11,3520176612466;-12,7713148374885;14;2,55e+08
vpja88;20;357;549;-8,9520176612466;-311,071314837489;192;255000
vpja88;20;573;844;3,34798233875335;-326,971314837489;271;255000
vpja88;20;855;1286;12,1479823387534;-328,371314837489;431;255000
vpja88;20;1301;1400;27,3479823387534;-334,271314837489;99;255000
vpja88;20;1490;1602;311,247982338753;363,628685162511;112;0
vpja88;20;1626;1886;278,247982338753;300,728685162512;260;255
vpja88;20;1903;3064;288,147982338753;307,228685162512;1161;255
vpja88;20;3281;3422;-7,4520176612466;-289,571314837489;141;255000
vpja88;20;3458;3686;7,24798233875333;-330,171314837489;228;255000
vpja88;20;3700;4336;32,3479823387534;-336,271314837489;636;255000
vpja88;20;4357;4887;-1,85201766124658;-331,371314837489;530;255000
vpja88;20;4914;4952;-60,2520176612467;-320,971314837489;38;255000
vpja88;20;5048;5218;-427,452017661247;247,728685162512;170;0
vpja88;20;5258;5537;-488,252017661247;315,428685162511;279;255255000
vpja88;20;5561;5939;-533,052017661247;347,128685162511;378;255255000
vpja88;20;6062;6250;-68,8520176612466;-273,671314837489;188;255000
vpja88;20;6276;6555;-0,652017661246646;-301,371314837489;279;255000
vpja88;20;6767;6819;15,9479823387534;-244,771314837489;52;255000
vpja88;20;6832;7038;-16,5520176612466;-297,471314837489;206;255000
vpja88;20;7097;7284;-365,652017661247;-294,371314837489;187;0
vpja88;20;7332;7543;-79,2520176612467;-336,571314837489;211;255000
vpja88;20;7573;7675;-175,352017661247;-334,371314837489;102;255000
vpja88;20;7738;8102;266,647982338753;-100,571314837489;364;0
vpja88;20;8170;8234;162,747982338753;114,628685162511;64;2,55e+08
vpja88;20;8340;8561;-25,4520176612466;-302,671314837489;221;255000
vpja88;20;8584;8959;-7,55201766124662;-317,271314837489;375;255000
vpja88;20;9057;9133;317,547982338753;401,628685162511;76;0
vpja88;20;9158;9292;301,347982338753;340,328685162511;134;0
vpja88;20;9312;9396;304,347982338753;317,528685162511;84;255
vpja88;20;9677;9956;353,647982338753;420,928685162511;279;0
vpja88;20;9968;10000;336,247982338753;459,028685162511;32;0
vpja88;21;20;114;-8,75201766124667;109,328685162511;94;0
vpja88;21;218;489;-229,852017661247;-262,871314837489;271;255000
vpja88;21;508;730;-263,752017661247;-262,671314837489;222;255000
vpja88;21;1247;1572;-121,152017661247;341,428685162511;325;255
vpja88;21;1587;1669;-102,052017661247;315,728685162512;82;255
vpja88;21;1797;1941;-209,852017661247;-211,171314837489;144;255000
vpja88;21;1960;2238;-244,952017661247;-248,971314837489;278;255000
vpja88;21;2252;2951;-257,152017661247;-261,371314837489;699;255000
vpja88;21;3078;3209;-88,0520176612466;395,928685162511;131;0
vpja88;21;3231;3402;-134,152017661247;356,628685162511;171;255
vpja88;21;3437;3747;-100,552017661247;314,528685162511;310;255
vpja88;21;4072;4433;-240,452017661247;-267,671314837489;361;255000
vpja88;21;4509;4783;-497,652017661247;302,928685162511;274;0
vpja88;21;4803;5606;-485,652017661247;294,528685162511;803;0
vpja88;21;5621;5925;-504,752017661247;303,728685162512;304;0
vpja88;21;5946;6069;-513,852017661247;322,228685162512;123;0
vpja88;21;6148;6566;-240,052017661247;-244,571314837489;418;255000
vpja88;21;6758;6799;-248,952017661247;-179,571314837489;41;2,55e+08
vpja88;21;7013;7168;-215,752017661247;-181,571314837489;155;2,55e+08
vpja88;21;7194;7502;-232,652017661247;-260,171314837489;308;255000
vpja88;21;7570;7824;-231,252017661247;93,2286851625115;254;2,55e+08
vpja88;21;7852;7921;-188,352017661247;67,2286851625115;69;2,55e+08
vpja88;21;7998;8203;-175,952017661247;-231,671314837489;205;0
vpja88;21;8256;8476;184,547982338753;-259,771314837489;220;0
vpja88;21;8504;8639;270,647982338753;-300,871314837489;135;0
vpja88;21;8666;8836;274,947982338753;-350,071314837489;170;0
vpja88;21;9091;9215;-207,252017661247;-285,571314837489;124;255000
vpja88;21;9248;9324;-115,952017661247;-271,371314837489;76;0
vpja88;21;9521;9703;-31,5520176612466;-318,371314837489;182;0
vpja88;21;9763;10000;-428,652017661247;-409,971314837489;237;0
vpja88;22;43;142;-18,6;70,2;99;2,55e+08
vpja88;22;252;429;-77;-251,9;177;255000
vpja88;22;447;715;-62,9;-264,2;268;255000
vpja88;22;728;949;-41,4;-257,1;221;255000
vpja88;22;961;1080;-53,3000000000001;-264;119;255000
vpja88;22;1375;1744;-73,2;291;369;255
vpja88;22;1756;2132;-54,9;302,8;376;255
vpja88;22;2141;2358;-70,6;312,6;217;255
vpja88;22;2391;2619;-80,8000000000001;318,7;228;0
vpja88;22;2627;2733;-68,1;316,5;106;255
vpja88;22;2836;3005;-47;-227;169;255000
vpja88;22;3028;3390;-67;-263,7;362;255000
vpja88;22;3411;3695;-41,9;-267,9;284;255000
vpja88;22;3924;4060;360,5;278;136;0
vpja88;22;4082;4427;352,5;206,9;345;255255000
vpja88;22;4439;4666;361,7;199,5;227;255255000
vpja88;22;4676;5281;339,2;201,2;605;255255000
vpja88;22;5296;5516;357,2;218,2;220;0
vpja88;22;5530;5624;376,6;225,5;94;0
vpja88;22;5725;5899;-104,8;-208,4;174;255000
vpja88;22;5922;6066;-79;-235,8;144;255000
vpja88;22;6090;6307;-47,1;-254,9;217;255000
vpja88;22;6325;6514;-75,6;-259,4;189;255000
vpja88;22;6565;6709;-87,6;-87,7;144;2,55e+08
vpja88;22;6812;6879;-232,4;557,6;67;NA
vpja88;22;7174;7272;-78,7;-28,3;98;2,55e+08
vpja88;22;7307;7554;-60,5;-55,6;247;2,55e+08
vpja88;22;8297;9200;-77,1;423,4;903;0
vpja88;22;9855;9943;-55;528,8;88;NA
vpja88;22;9950;10000;-52,3000000000001;522,7;50;NA
vpja88;23;342;425;-19,9520176612466;-50,2713148374885;83;0
vpja88;23;484;631;24,0479823387534;-293,571314837489;147;255000
vpja88;23;651;1485;41,3479823387534;-310,271314837489;834;255000
vpja88;23;1505;1708;36,5479823387534;-286,071314837489;203;255000
vpja88;23;1728;2029;35,8479823387534;-313,571314837489;301;255000
vpja88;23;2051;2104;50,4479823387534;-266,571314837489;53;255000
vpja88;23;2124;2280;49,4479823387534;-234,071314837489;156;2,55e+08
vpja88;23;2498;2741;50,5479823387533;-264,071314837489;243;255000
vpja88;23;2762;2875;9,5479823387534;-268,571314837489;113;0
vpja88;23;3201;3295;-220,352017661247;51,0286851625115;94;255
vpja88;23;3321;3736;-179,752017661247;72,3286851625114;415;255
vpja88;23;3758;3948;-209,452017661247;76,7286851625115;190;255
vpja88;23;3966;4077;-188,552017661247;65,8286851625114;111;255
vpja88;23;4158;4357;11,2479823387533;-310,771314837489;199;0
vpja88;23;4374;4941;34,8479823387534;-316,571314837489;567;255000
vpja88;23;5017;5185;-138,752017661247;55,2286851625115;168;255
vpja88;23;5206;5960;-175,352017661247;53,2286851625115;754;255
vpja88;23;5971;6234;-165,852017661247;45,0286851625115;263;255
vpja88;23;6253;6412;-201,052017661247;50,3286851625114;159;255
vpja88;23;6433;6696;-238,052017661247;72,1286851625115;263;255
vpja88;23;6882;7024;391,747982338753;42,6286851625115;142;255255000
vpja88;23;7096;7197;-33,1520176612466;-360,471314837489;101;0
vpja88;23;7224;7513;12,5479823387534;-333,471314837489;289;255000
vpja88;23;7536;7676;43,0479823387533;-371,271314837489;140;255000
vpja88;23;7712;8186;58,2479823387533;-404,771314837489;474;0
vpja88;23;8372;8405;515,347982338753;156,428685162511;33;0
vpja88;23;8431;8586;451,747982338753;76,4286851625114;155;255255000
vpja88;23;8604;8858;428,247982338753;80,4286851625114;254;255255000
vpja88;23;8869;9131;408,847982338753;72,8286851625114;262;255255000
vpja88;23;9150;9391;417,747982338753;61,2286851625115;241;255255000
vpja88;23;9714;9920;471,847982338753;186,728685162512;206;0
vpja88;24;179;284;-7,20000000000005;-123,7;105;2,55e+08
vpja88;24;324;349;-63,6;-167,3;25;2,55e+08
vpja88;24;381;530;-48,2;-288,5;149;0
vpja88;24;600;707;-356,1;63,2;107;0
vpja88;24;778;991;-390,1;125;213;0
vpja88;24;1076;1233;-35,6;-261,7;157;255000
vpja88;24;1260;1603;-32,9000000000001;-295,4;343;255000
vpja88;24;1740;2435;-33,9000000000001;-303,8;695;255000
vpja88;24;2808;2875;-395,4;132,4;67;0
vpja88;24;2947;2971;-394,2;134,7;24;0
vpja88;24;3043;3084;-393,4;137,1;41;0
vpja88;24;4189;4292;-101,5;-251,1;103;0
vpja88;24;4317;4577;-43,1;-273,7;260;0
vpja88;24;4850;5105;241,9;128,2;255;255255000
vpja88;24;5474;5512;297,8;349,8;38;0
vpja88;24;5547;5706;394,9;270,2;159;0
vpja88;24;5733;6027;270,6;200,4;294;0
vpja88;24;6041;6302;259,4;153,3;261;0
vpja88;24;6324;6968;276,1;64,3000000000001;644;255255000
vpja88;24;7225;7370;301,6;169,9;145;0
vpja88;24;7409;7524;211,2;-48,4;115;0
vpja88;24;7544;7689;242,1;-52;145;0
vpja88;24;8104;8331;-36,1;-260,6;227;255000
vpja88;24;9784;9892;192,7;125,4;108;0
vpja88;24;9916;10000;234,2;115,1;84;255255000
vpja88;25;23;43;17;-2,39999999999998;20;0
vpja88;25;297;345;-25,9;65,2;48;2,55e+08
vpja88;25;651;776;8,39999999999998;160,8;125;0
vpja88;25;845;1055;-73,6;-176,6;210;255000
vpja88;25;1079;1417;-74,7;-194,7;338;255000
vpja88;25;1466;1491;-22,7;-88,6999999999999;25;2,55e+08
vpja88;25;1547;1732;17,9;166,9;185;0
vpja88;25;1754;2515;46,5;167,3;761;0
vpja88;25;2538;2647;25,1999999999999;90,2;109;2,55e+08
vpja88;25;2807;3020;-313,5;117,4;213;255255000
vpja88;25;3067;3127;-70,5;13,4;60;2,55e+08
vpja88;25;3151;3197;-72;78,8000000000001;46;2,55e+08
vpja88;25;3467;3767;-40,7;-154,3;300;255000
vpja88;25;4109;4196;-42,9;107;87;0
vpja88;25;4236;4429;17,6999999999999;157,6;193;0
vpja88;25;4443;4473;23;111,5;30;0
vpja88;25;4527;4641;-45,6;-139,3;114;2,55e+08
vpja88;25;4667;5177;-62,4;-199,1;510;255000
vpja88;25;5339;5367;101,6;294,6;28;0
vpja88;25;5437;5586;3,60000000000002;178,2;149;0
vpja88;25;5606;5919;34,5;188,6;313;255
vpja88;25;5980;6098;-31,9;-145,2;118;2,55e+08
vpja88;25;6126;6389;-59,1;-197,6;263;255000
vpja88;25;6571;6626;-67,9;-93,5;55;2,55e+08
vpja88;25;6655;6820;-65;-101,5;165;2,55e+08
vpja88;25;6832;7033;-52,5;-106,2;201;2,55e+08
vpja88;25;7084;8004;-29;29,2;920;2,55e+08
vpja88;25;8019;8308;-12,2;41,2;289;2,55e+08
vpja88;25;8330;8501;-35,1;56,9;171;2,55e+08
vpja88;25;8562;8694;-82,9;-159,7;132;255000
vpja88;25;8717;8837;-71,7;-192,7;120;255000
vpja88;25;9809;10000;-315,8;88,8000000000001;191;255255000
vpja88;26;61;96;69,5479823387533;20,2286851625115;35;0
vpja88;26;125;167;71,0479823387533;54,8286851625114;42;0
vpja88;26;199;296;-18,0520176612466;-36,0713148374886;97;2,55e+08
vpja88;26;318;596;-77,0520176612466;-101,071314837489;278;255000
vpja88;26;610;1129;-95,3520176612466;-103,271314837489;519;255000
vpja88;26;1139;1349;-79,4520176612466;-94,3713148374885;210;255000
vpja88;26;1389;1564;-70,1520176612466;1,52868516251147;175;2,55e+08
vpja88;26;1607;1799;-70,3520176612466;-217,771314837489;192;0
vpja88;26;1832;1952;-45,4520176612466;-109,271314837489;120;255000
vpja88;26;1971;1998;-70,5520176612466;-98,4713148374885;27;255000
vpja88;26;2168;2274;-93,5520176612466;-46,1713148374886;106;2,55e+08
vpja88;26;2327;2408;35,2479823387533;148,328685162511;81;2,55e+08
vpja88;26;2517;2638;200,847982338753;174,928685162511;121;0
vpja88;26;2916;3014;215,847982338753;197,428685162511;98;0
vpja88;26;3034;3095;237,447982338753;258,128685162511;61;0
vpja88;26;3112;3411;288,247982338753;325,328685162511;299;0
vpja88;26;3724;3963;289,647982338753;309,328685162511;239;0
vpja88;26;3976;4034;247,547982338753;249,928685162511;58;0
vpja88;26;4044;4212;228,947982338753;217,328685162511;168;0
vpja88;26;4225;4870;234,447982338753;186,128685162511;645;0
vpja88;26;4880;4992;228,047982338753;144,128685162511;112;0
vpja88;26;5069;5169;-38,5520176612466;0,628685162511488;100;2,55e+08
vpja88;26;5193;5465;-77,2520176612467;-82,8713148374885;272;255000
vpja88;26;5543;5720;187,647982338753;148,428685162511;177;255
vpja88;26;5741;5839;188,247982338753;106,328685162511;98;255
vpja88;26;6093;6209;263,947982338753;249,928685162511;116;0
vpja88;26;6561;6720;150,947982338753;142,728685162512;159;0
vpja88;26;6793;6939;-434,352017661247;141,028685162511;146;255255000
vpja88;26;6967;7452;-535,952017661247;157,828685162511;485;0
vpja88;26;7477;7778;-469,552017661247;159,028685162511;301;255255000
vpja88;26;8535;8809;-525,752017661247;148,228685162512;274;0
vpja88;26;8828;9240;-535,352017661247;157,828685162511;412;0
vpja88;26;9262;9558;-476,252017661247;164,528685162511;296;255255000
vpja88;26;9928;10000;-377,952017661247;132,928685162511;72;255255000
