vp;trial;timest;timeend;x;y;duration;roi
vpja48;1;328;443;-127,6;-121,3;115;2,55e+08
vpja48;1;464;1264;-135,4;-184,6;800;255000
vpja48;1;1274;1699;-130,9;-196,3;425;255000
vpja48;1;1764;1973;-332,7;208,7;209;0
vpja48;1;2012;2373;-455,1;275,1;361;0
vpja48;1;2408;2635;-361,2;329,7;227;0
vpja48;1;2690;2833;-64,9;340,6;143;2,55e+08
vpja48;1;2930;3142;365,9;332;212;0
vpja48;1;3170;3429;448,3;321,2;259;255255000
vpja48;1;3455;3636;456,2;394,3;181;0
vpja48;1;3704;3859;242,8;-22,9;155;0
vpja48;1;3915;4125;69,0000000000001;-278,8;210;0
vpja48;1;4146;4365;27,9;-325,9;219;0
vpja48;1;4407;4570;-124,6;-165,1;163;255000
vpja48;1;4584;4795;-136,6;-185,8;211;255000
vpja48;1;4841;5021;-358;-172,4;180;0
vpja48;1;5076;5254;-398,6;64,3;178;0
vpja48;1;5301;5648;-344,6;-204,7;347;0
vpja48;1;5667;5881;-315,8;-219,5;214;0
vpja48;1;5928;6143;-361,2;14,6;215;0
vpja48;1;6178;6391;-470,4;40,5;213;255
vpja48;1;6437;6736;-466,8;287,8;299;0
vpja48;1;6758;7101;-431,8;261,8;343;0
vpja48;1;7125;7467;-463,5;330,2;342;0
vpja48;1;7509;7708;-274,8;361,7;199;0
vpja48;1;7785;8059;407,7;353,7;274;255255000
vpja48;1;8087;8414;434;408,7;327;0
vpja48;1;8424;8577;420,6;429,8;153;0
vpja48;1;8613;8968;449,5;287;355;255255000
vpja48;1;9011;9176;416,6;44,1999999999999;165;0
vpja48;1;9201;9326;319,7;-15,3000000000001;125;0
vpja48;1;9388;9573;390,6;-402,8;185;0
vpja48;1;9584;9809;402,8;-414,3;225;0
vpja48;1;9818;9997;405,3;-425,4;179;0
vpja48;2;335;660;-13,8000000000001;-257,9;325;255000
vpja48;2;704;924;-47,2;-60,6999999999999;220;255
vpja48;2;963;1657;-9,89999999999998;-271,8;694;255000
vpja48;2;1737;1919;70,8000000000001;243,8;182;2,55e+08
vpja48;2;1961;2165;46,6;419,4;204;2,55e+08
vpja48;2;2183;2343;22,1;448,1;160;2,55e+08
vpja48;2;2393;2608;-235,6;296,6;215;0
vpja48;2;2641;2881;-224,2;184,7;240;0
vpja48;2;2922;3151;-205,9;-7,29999999999995;229;255255000
vpja48;2;3192;3407;-43,5;-42,3;215;255
vpja48;2;3456;3762;234,9;-16,1999999999999;306;0
vpja48;2;3791;4107;318,9;7,10000000000002;316;0
vpja48;2;4130;4421;342,8;60,6;291;0
vpja48;2;4446;4583;308,3;-1,89999999999998;137;0
vpja48;2;4627;4893;515,8;-19,4;266;0
vpja48;2;4950;5273;294,7;-241,7;323;0
vpja48;2;5295;5596;297,1;-176,5;301;0
vpja48;2;5615;6044;335,6;-154,8;429;0
vpja48;2;6072;6248;315,2;-265,5;176;0
vpja48;2;6276;6456;291,4;-396,2;180;0
vpja48;2;6475;6753;252,9;-417,8;278;0
vpja48;2;6884;7153;-196,2;-241,7;269;0
vpja48;2;7180;7351;-199,7;-172,6;171;0
vpja48;2;7416;7733;-536;49,9000000000001;317;0
vpja48;2;7760;7942;-568,6;153,6;182;0
vpja48;2;7982;8186;-483,1;37,2;204;0
vpja48;2;8251;8409;-431;392,5;158;0
vpja48;2;8436;8887;-317,4;441,6;451;0
vpja48;2;8927;9223;-214,6;272,4;296;0
vpja48;2;9268;9463;31,4;346,2;195;2,55e+08
vpja48;2;9488;9653;53,9;433,8;165;2,55e+08
vpja48;2;9706;9917;397;414,3;211;0
vpja48;2;9969;10000;488,3;119,1;31;0
vpja48;3;384;541;-330,080427046263;-94,1583629893238;157;255000
vpja48;3;559;1030;-369,780427046263;-124,858362989324;471;255000
vpja48;3;1084;1284;-13,2804270462633;-18,1583629893238;200;0
vpja48;3;1333;1579;-59,1804270462633;-283,058362989324;246;0
vpja48;3;1623;1958;33,6195729537367;-400,358362989324;335;0
vpja48;3;1995;2228;133,319572953737;-421,058362989324;233;0
vpja48;3;2264;2435;258,819572953737;-372,258362989324;171;0
vpja48;3;2484;2740;472,919572953737;-166,458362989324;256;0
vpja48;3;2758;2965;453,519572953737;-138,058362989324;207;0
vpja48;3;3035;3178;-70,8804270462633;-198,558362989324;143;0
vpja48;3;3202;3382;-94,5804270462633;-237,158362989324;180;0
vpja48;3;3415;3820;-195,680427046263;-258,258362989324;405;0
vpja48;3;3848;4059;-77,9804270462633;-241,358362989324;211;0
vpja48;3;4212;4473;48,7195729537367;-398,158362989324;261;0
vpja48;3;4502;4692;160,519572953737;-422,158362989324;190;0
vpja48;3;4726;4953;52,2195729537367;-398,258362989324;227;0
vpja48;3;4975;5184;20,3195729537367;-383,158362989324;209;0
vpja48;3;5260;5438;-264,280427046263;61,8416370106762;178;2,55e+08
vpja48;3;5465;5674;-258,080427046263;130,741637010676;209;255
vpja48;3;5742;6252;-520,480427046263;437,841637010676;510;0
vpja48;3;6283;6528;-543,380427046263;436,041637010676;245;0
vpja48;3;6603;6737;128,419572953737;249,741637010676;134;0
vpja48;3;6809;7055;535,119572953737;-158,558362989324;246;0
vpja48;3;7083;7275;601,419572953737;-141,958362989324;192;0
vpja48;3;7308;7702;459,719572953737;-155,758362989324;394;0
vpja48;3;7752;8031;446,919572953737;-414,758362989324;279;0
vpja48;3;8057;8272;545,119572953737;-433,258362989324;215;0
vpja48;3;8325;8481;490,519572953737;-125,558362989324;156;0
vpja48;3;8498;8695;456,419572953737;-133,758362989324;197;0
vpja48;3;8711;8858;454,619572953737;-151,558362989324;147;0
vpja48;3;8889;8971;527,019572953737;-97,9583629893238;82;0
vpja48;3;9061;9168;-319,080427046263;-147,958362989324;107;255000
vpja48;3;9193;9433;-359,880427046263;-126,758362989324;240;255000
vpja48;3;9475;9786;-193,880427046263;-253,058362989324;311;0
vpja48;3;9819;10000;-51,3804270462633;-245,058362989324;181;0
vpja48;4;357;679;-78,8;55,4000000000001;322;255255000
vpja48;4;705;858;-114,4;77,3000000000001;153;255255000
vpja48;4;912;1088;284,2;121,7;176;255
vpja48;4;1148;1334;135,3;-257,6;186;255000
vpja48;4;1348;1759;135,7;-266,8;411;255000
vpja48;4;1778;2158;140;-278;380;255000
vpja48;4;2171;2324;142,4;-261,3;153;255000
vpja48;4;2391;2774;-107,4;49,4000000000001;383;255255000
vpja48;4;2820;3377;-329;112,2;557;0
vpja48;4;3415;3699;-447,9;127,9;284;0
vpja48;4;3744;4033;-584,2;255,7;289;0
vpja48;4;4083;4264;-371;101,3;181;0
vpja48;4;4281;4439;-351,5;88,3000000000001;158;0
vpja48;4;4472;4758;-283,1;-11,8;286;0
vpja48;4;4935;5084;230,5;-15,0999999999999;149;0
vpja48;4;5111;5383;135,9;-106,4;272;2,55e+08
vpja48;4;5410;5639;122,8;-202,1;229;2,55e+08
vpja48;4;5660;5818;117,3;-246,4;158;2,55e+08
vpja48;4;5827;6091;115,6;-230,9;264;2,55e+08
vpja48;4;6117;6566;151,3;-279,9;449;255000
vpja48;4;6576;6739;139,2;-266,2;163;255000
vpja48;4;6761;6926;110;-225;165;2,55e+08
vpja48;4;6934;7137;118,3;-226;203;2,55e+08
vpja48;4;7165;7434;152,1;-289,2;269;255000
vpja48;4;7497;7866;319;121;369;255
vpja48;4;7890;8133;369,2;62,8000000000001;243;255
vpja48;4;8201;8447;-85,5999999999999;50,3000000000001;246;255255000
vpja48;4;8471;8822;-124;89,4000000000001;351;255255000
vpja48;4;8862;9042;-127,3;240,9;180;0
vpja48;4;9087;9230;33,4000000000001;64,5;143;0
vpja48;4;9374;9601;70,6000000000001;45,7;227;0
vpja48;4;9650;9841;85,7;-178,5;191;2,55e+08
vpja48;4;9871;10000;139,4;-280,9;129;255000
vpja48;5;262;521;-76;-94,9;259;255000
vpja48;5;528;1252;-95,0999999999999;-93,5;724;255000
vpja48;5;1297;1518;-105,1;89;221;2,55e+08
vpja48;5;1563;2082;117,3;123,1;519;0
vpja48;5;2127;2725;243,4;240,8;598;0
vpja48;5;2759;3009;136,1;138,1;250;0
vpja48;5;3029;3324;115,5;106,4;295;255255000
vpja48;5;3395;3954;-456,7;154,4;559;255
vpja48;5;3972;4294;-414,9;161,1;322;0
vpja48;5;4318;4585;-456,9;135,6;267;255
vpja48;5;4626;5003;-314,6;82,5;377;0
vpja48;5;5014;5160;-328,7;90,3;146;0
vpja48;5;5218;5332;-432,8;-168,4;114;0
vpja48;5;5375;5600;-457,7;-341,8;225;0
vpja48;5;5617;5879;-470;-365,2;262;0
vpja48;5;5933;6305;-105,5;-371,2;372;0
vpja48;5;6347;6718;57,3;-346;371;0
vpja48;5;6873;7104;90;-358,3;231;0
vpja48;5;7171;7377;400,6;34,9;206;0
vpja48;5;7407;7828;333,1;94,3;421;0
vpja48;5;7855;8121;297,7;22,1;266;0
vpja48;5;8165;8464;519,9;90;299;0
vpja48;5;8498;8756;383,4;84,8;258;0
vpja48;5;8782;8940;334,4;131,3;158;0
vpja48;5;8990;9292;569,9;261,2;302;0
vpja48;5;9316;9588;510;226,2;272;0
vpja48;5;9604;9807;510,9;207,7;203;0
vpja48;5;9852;10000;545;0;148;0
vpja48;6;300;422;18,8;-209,1;122;255000
vpja48;6;443;976;33,4;-244,2;533;255000
vpja48;6;1063;1313;321,4;189,8;250;255
vpja48;6;1334;1409;362,2;233,7;75;255
vpja48;6;1490;1700;-307,4;232,2;210;255255000
vpja48;6;1750;1909;-328,9;-12,9000000000001;159;0
vpja48;6;1932;2264;-295,4;-49,4000000000001;332;0
vpja48;6;2298;2598;-375,6;15,5;300;0
vpja48;6;2639;3021;-302,6;-51,6;382;0
vpja48;6;3051;3240;-199,7;-68,4;189;0
vpja48;6;3298;3489;207,7;-80,9;191;0
vpja48;6;3555;3762;-148,5;181,6;207;255255000
vpja48;6;3821;4158;311,3;228,1;337;255
vpja48;6;4179;4376;324;247,3;197;255
vpja48;6;5068;5281;-31,5;196,6;213;0
vpja48;6;5449;5635;66,8;220,1;186;0
vpja48;6;5798;5978;-11,5;206,8;180;0
vpja48;6;6016;6251;185;212,8;235;0
vpja48;6;6288;6457;330,8;188,9;169;255
vpja48;6;6500;6670;307,2;-23,5;170;0
vpja48;6;6690;6804;290,2;-57,0000000000001;114;0
vpja48;6;6959;7248;297,1;-60,3000000000001;289;0
vpja48;6;7258;7434;293,6;-77,1;176;0
vpja48;6;7511;7759;-244;-58,8000000000001;248;0
vpja48;6;7778;8097;-274,9;-58,0000000000001;319;0
vpja48;6;8141;8534;-468,7;-27,2;393;0
vpja48;6;8566;8795;-403,3;-0,600000000000023;229;0
vpja48;6;8979;9279;452;-30,5;300;0
vpja48;6;9333;9590;318,1;210,9;257;255
vpja48;6;9672;10000;-303,9;244,2;328;255255000
vpja48;7;356;559;-278,138129496403;-99,8496402877698;203;2,55e+08
vpja48;7;622;805;247,461870503597;41,0503597122303;183;255
vpja48;7;823;1030;249,361870503597;77,5503597122303;207;255
vpja48;7;1091;1497;-142,538129496403;325,85035971223;406;255255000
vpja48;7;1572;1727;-319,738129496403;-105,14964028777;155;2,55e+08
vpja48;7;1751;2116;-263,338129496403;-121,24964028777;365;255000
vpja48;7;2319;2544;-141,738129496403;341,85035971223;225;255255000
vpja48;7;2612;2862;242,061870503597;47,0503597122303;250;255
vpja48;7;2893;3225;226,561870503597;-86,1496402877698;332;0
vpja48;7;3257;3460;134,261870503597;-3,64964028776978;203;0
vpja48;7;3514;3708;-237,138129496403;0,750359712230193;194;2,55e+08
vpja48;7;3761;3987;-498,138129496403;-41,8496402877697;226;0
vpja48;7;4028;4317;-572,938129496403;-23,9496402877697;289;0
vpja48;7;4369;4621;-217,738129496403;-38,1496402877698;252;2,55e+08
vpja48;7;4662;4889;-124,138129496403;-121,64964028777;227;0
vpja48;7;4931;5215;16,061870503597;-173,34964028777;284;0
vpja48;7;5267;5484;286,761870503597;-93,1496402877698;217;0
vpja48;7;5500;5654;252,061870503597;-83,7496402877698;154;0
vpja48;7;5703;5905;509,661870503597;-52,3496402877697;202;0
vpja48;7;5959;6176;273,261870503597;58,7503597122302;217;255
vpja48;7;6199;6312;245,461870503597;93,8503597122302;113;255
vpja48;7;6369;6669;-142,938129496403;309,05035971223;300;255255000
vpja48;7;6696;6949;-211,238129496403;338,35035971223;253;255255000
vpja48;7;7153;7368;-167,038129496403;285,85035971223;215;255255000
vpja48;7;7430;7659;-264,838129496403;-95,7496402877698;229;2,55e+08
vpja48;7;7686;7858;-264,938129496403;-149,74964028777;172;255000
vpja48;7;7906;8227;-471,438129496403;-244,44964028777;321;0
vpja48;7;8240;8783;-458,738129496403;-230,34964028777;543;0
vpja48;7;8823;9039;-547,338129496403;-279,24964028777;216;0
vpja48;7;9062;9385;-583,838129496403;-340,54964028777;323;0
vpja48;7;9409;9597;-535,238129496403;-298,84964028777;188;0
vpja48;7;9631;9951;-637,138129496403;-244,74964028777;320;0
vpja48;8;300;463;-191,3;-237;163;255000
vpja48;8;482;644;-234,4;-256,1;162;255000
vpja48;8;722;966;-153,4;295,8;244;0
vpja48;8;1027;1262;-444,6;298;235;255255000
vpja48;8;1281;1975;-449,7;259,9;694;255255000
vpja48;8;2004;2529;-325,4;163,5;525;2,55e+08
vpja48;8;2568;3094;-442,5;247,9;526;255255000
vpja48;8;3145;3529;-128,7;275;384;255
vpja48;8;3584;3737;-193,2;25,5999999999999;153;2,55e+08
vpja48;8;3787;4054;-219,7;-277;267;255000
vpja48;8;4069;4257;-222,1;-250,8;188;255000
vpja48;8;4377;5233;-38,9;-245;856;0
vpja48;8;5252;5716;-41,6999999999999;-216,6;464;0
vpja48;8;5739;6098;-37,5;-264,3;359;0
vpja48;8;6110;6614;-53,4;-273,3;504;0
vpja48;8;6644;7025;22;-281,7;381;0
vpja48;8;7036;7260;17,1;-292,2;224;0
vpja48;8;7317;7523;311;-55,2;206;0
vpja48;8;7567;7708;277;-255,9;141;0
vpja48;8;7739;7952;326,1;-372,8;213;0
vpja48;8;8024;8143;-184,1;-275,4;119;255000
vpja48;8;8167;8572;-220,2;-241,2;405;255000
vpja48;8;8579;8757;-223,9;-247,7;178;255000
vpja48;8;8825;8965;-353,9;98,8;140;2,55e+08
vpja48;8;8991;9206;-342,5;154,7;215;2,55e+08
vpja48;8;9223;9403;-352,4;166;180;2,55e+08
vpja48;8;9430;9687;-275,4;197,3;257;2,55e+08
vpja48;8;9798;9999;-216,7;192,7;201;2,55e+08
vpja48;9;300;650;-13,4;-233,8;350;255000
vpja48;9;714;743;388,5;141,3;29;255
vpja48;9;768;977;426,9;221,5;209;255
vpja48;9;999;1330;438,7;179,5;331;255
vpja48;9;1368;1508;239,5;105,7;140;0
vpja48;9;1571;1656;3,5;-201,5;85;255000
vpja48;9;1681;1942;-10,4;-270,8;261;255000
vpja48;9;1964;2262;-15,7;-236,7;298;255000
vpja48;9;2288;2636;-25,1;-298,5;348;255000
vpja48;9;2833;3037;-418,3;255,1;204;255255000
vpja48;9;3068;3311;-389,1;254,3;243;255255000
vpja48;9;3355;3885;-447,6;103,6;530;0
vpja48;9;3922;4101;-359,4;181,7;179;255255000
vpja48;9;4123;4536;-384,6;214,4;413;255255000
vpja48;9;4614;4872;358,7;198,5;258;255
vpja48;9;5583;5789;378,6;1,10000000000002;206;0
vpja48;9;5962;6255;-360,4;58,8;293;0
vpja48;9;6414;6530;-396,3;-78,6;116;0
vpja48;9;6592;6847;-374,4;226,7;255;255255000
vpja48;9;6924;7031;252,6;158,2;107;0
vpja48;9;7066;7308;403,1;196,8;242;255
vpja48;9;7337;7466;432,2;252,3;129;255
vpja48;9;7655;7933;-6,70000000000005;-64,9;278;2,55e+08
vpja48;9;7955;8163;-34,7;-26,4;208;2,55e+08
vpja48;9;8189;8458;-20,9;-104,5;269;2,55e+08
vpja48;9;8496;8948;-24,9;-270,5;452;255000
vpja48;9;8966;9211;-20,6;-230,7;245;255000
vpja48;9;9256;9460;125,5;-380,8;204;0
vpja48;9;9499;9804;-5,20000000000005;-279,9;305;255000
vpja48;10;7;292;-13,5;2,39999999999998;285;2,55e+08
vpja48;10;331;511;35,5999999999999;-180,5;180;255000
vpja48;10;526;857;43,8999999999999;-200,3;331;255000
vpja48;10;920;1095;311,5;194,2;175;255
vpja48;10;1122;1418;322,6;253,2;296;255
vpja48;10;1501;1727;-356,8;200;226;255255000
vpja48;10;1756;1966;-360,7;114,7;210;255255000
vpja48;10;1976;2257;-366,5;105,6;281;255255000
vpja48;10;2286;2741;-294,6;196,7;455;255255000
vpja48;10;2781;3000;-128,7;265,1;219;0
vpja48;10;3161;3452;52,5;-139,4;291;2,55e+08
vpja48;10;3479;3738;57,0999999999999;-210,1;259;255000
vpja48;10;3789;3917;-195,4;-149,8;128;0
vpja48;10;3973;4147;-393,5;-15,3;174;0
vpja48;10;4170;4374;-441,9;-50,2;204;0
vpja48;10;4392;4672;-432,2;-21,6;280;0
vpja48;10;4689;5012;-409,1;-28,1;323;0
vpja48;10;5035;5557;-358,7;-0,299999999999955;522;0
vpja48;10;5569;6014;-375,2;7,5;445;0
vpja48;10;6037;6479;-334,5;-1,60000000000002;442;0
vpja48;10;6512;6877;-435,7;-32,9;365;0
vpja48;10;7043;7229;-368,6;198,1;186;255255000
vpja48;10;7291;7707;79,3999999999999;309;416;0
vpja48;10;7757;7807;385;228,6;50;255
vpja48;10;7877;7963;58,8;-143,4;86;255000
vpja48;10;7990;8209;51,3999999999999;-223;219;255000
vpja48;10;8223;8617;44,5999999999999;-196,8;394;255000
vpja48;10;8631;8777;42,2;-218,7;146;255000
vpja48;10;8970;9264;328;231,8;294;255
vpja48;10;9286;9618;309,1;278,8;332;255
vpja48;10;9707;9859;-305,3;246,6;152;255255000
vpja48;10;9886;10000;-373,9;190;114;255255000
vpja48;11;301;476;167,136101083032;-108,987003610108;175;255000
vpja48;11;534;760;-136,363898916968;247,212996389892;226;255
vpja48;11;857;992;312,436101083032;365,312996389892;135;255255000
vpja48;11;1017;1251;298,536101083032;419,712996389892;234;255255000
vpja48;11;1292;1552;437,736101083032;311,212996389892;260;255255000
vpja48;11;1625;1791;-112,563898916968;274,712996389892;166;255
vpja48;11;1817;1992;-183,463898916968;268,512996389892;175;255
vpja48;11;2005;2236;-209,663898916968;274,312996389892;231;255
vpja48;11;2297;2433;123,836101083033;-36,6870036101084;136;2,55e+08
vpja48;11;2461;2857;162,036101083032;-115,887003610108;396;255000
vpja48;11;2870;3291;154,936101083032;-132,287003610108;421;255000
vpja48;11;3347;3653;408,936101083032;134,012996389892;306;0
vpja48;11;3672;4161;418,136101083032;165,412996389892;489;0
vpja48;11;4172;4453;427,436101083032;171,112996389892;281;255255000
vpja48;11;4472;4610;424,036101083032;138,412996389892;138;0
vpja48;11;4710;5171;59,0361010830323;-154,087003610108;461;0
vpja48;11;5238;5624;-364,563898916968;-64,5870036101084;386;0
vpja48;11;5656;5957;-436,663898916968;-46,9870036101083;301;0
vpja48;11;5985;6100;-318,563898916968;-70,7870036101083;115;0
vpja48;11;6147;6519;-156,763898916968;-256,087003610108;372;0
vpja48;11;6568;6866;155,736101083032;-136,487003610108;298;255000
vpja48;11;6885;7150;165,136101083032;-111,187003610108;265;255000
vpja48;11;7168;7731;167,236101083032;-137,687003610108;563;255000
vpja48;11;7858;8228;-131,063898916968;292,912996389892;370;255
vpja48;11;8250;8415;-193,763898916968;288,212996389892;165;255
vpja48;11;8427;8778;-219,463898916968;291,212996389892;351;255
vpja48;11;8804;9251;-159,863898916968;302,912996389892;447;255
vpja48;11;9280;10000;-227,263898916968;278,712996389892;720;255
vpja48;12;336;508;194,1;96,1999999999999;172;2,55e+08
vpja48;12;541;747;239,6;151,5;206;255
vpja48;12;816;1525;-353,1;160,3;709;255255000
vpja48;12;1594;1727;3,39999999999998;-217,1;133;255000
vpja48;12;1747;2630;30;-176,9;883;255000
vpja48;12;2716;2988;254,5;169,9;272;255
vpja48;12;3004;3233;221,8;182,1;229;255
vpja48;12;3316;3580;-331,1;161;264;255255000
vpja48;12;3604;3766;-362,1;153;162;0
vpja48;12;3926;4080;-65,4;-255,6;154;0
vpja48;12;4127;4356;126,3;-221,2;229;0
vpja48;12;4384;4771;211,8;-198,8;387;0
vpja48;12;4844;5084;-267,6;-218,1;240;0
vpja48;12;5121;5309;-380,2;-182,7;188;0
vpja48;12;5348;5525;-337,1;-46,3000000000001;177;0
vpja48;12;5592;5763;27,7;-176,8;171;255000
vpja48;12;5882;6235;495,4;-29,4;353;0
vpja48;12;6261;6488;518,9;-84,7;227;0
vpja48;12;6533;6932;385,3;-263;399;0
vpja48;12;6986;7287;131,2;-252,9;301;0
vpja48;12;7312;7520;183,3;-259,9;208;0
vpja48;12;7540;7796;152,8;-286,8;256;0
vpja48;12;7864;8227;-255,8;-208,2;363;0
vpja48;12;8283;8511;-479,8;-222,8;228;0
vpja48;12;8536;8746;-496,6;-305,9;210;0
vpja48;12;8770;9094;-512,3;-367;324;0
vpja48;12;9252;9444;-579,9;-13,5;192;0
vpja48;12;9468;9713;-612,2;32,8;245;0
vpja48;12;9761;9953;-422,2;218,3;192;0
vpja48;13;34;194;-42,8784946236559;-11,1440860215052;160;2,55e+08
vpja48;13;255;506;-118,778494623656;290,855913978495;251;255
vpja48;13;526;670;-116,978494623656;251,255913978495;144;255
vpja48;13;730;890;-523,678494623656;151,255913978495;160;255255000
vpja48;13;915;1231;-556,378494623656;158,755913978495;316;255255000
vpja48;13;1290;1542;-99,8784946236559;250,455913978495;252;255
vpja48;13;1603;1725;9,82150537634402;-154,044086021505;122;255000
vpja48;13;1750;2171;-0,178494623655979;-96,7440860215053;421;255000
vpja48;13;2239;2409;-418,778494623656;-13,3440860215053;170;0
vpja48;13;2436;2660;-393,778494623656;91,1559139784947;224;0
vpja48;13;2713;3165;-543,378494623656;173,855913978495;452;255255000
vpja48;13;3205;3658;-390,778494623656;110,455913978495;453;0
vpja48;13;3679;4064;-370,878494623656;82,7559139784947;385;0
vpja48;13;4083;4252;-360,478494623656;44,2559139784947;169;0
vpja48;13;4290;4341;-386,178494623656;-101,244086021505;51;0
vpja48;13;4400;4594;10,5215053763441;-145,044086021505;194;255000
vpja48;13;4614;4837;10,5215053763441;-107,544086021505;223;255000
vpja48;13;4891;5233;45,521505376344;79,9559139784947;342;2,55e+08
vpja48;13;5267;5559;10,421505376344;181,655913978495;292;255
vpja48;13;5616;5810;337,521505376344;400,155913978495;194;0
vpja48;13;5849;6104;485,721505376344;429,455913978495;255;0
vpja48;13;6131;6404;585,021505376344;397,455913978495;273;0
vpja48;13;6463;6604;419,321505376344;110,855913978495;141;0
vpja48;13;6663;6817;181,921505376344;-183,444086021505;154;0
vpja48;13;6867;7043;11,921505376344;-147,644086021505;176;255000
vpja48;13;7098;7449;313,021505376344;-248,144086021505;351;0
vpja48;13;7508;7627;19,821505376344;-159,144086021505;119;255000
vpja48;13;7651;7890;-4,07849462365596;-105,044086021505;239;255000
vpja48;13;7947;8260;20,321505376344;140,355913978495;313;2,55e+08
vpja48;13;8302;8517;22,221505376344;-114,344086021505;215;255000
vpja48;13;8538;8896;7,62150537634409;-90,0440860215053;358;255000
vpja48;13;9005;9310;-60,278494623656;294,455913978495;305;255
vpja48;13;9342;9544;-52,578494623656;209,455913978495;202;0
vpja48;13;9564;9688;-79,578494623656;230,255913978495;124;255
vpja48;13;9760;10000;-536,578494623656;181,355913978495;240;255255000
vpja48;14;296;405;-212,534782608696;-167,678260869565;109;2,55e+08
vpja48;14;423;766;-240,234782608696;-195,678260869565;343;255000
vpja48;14;824;1192;-522,534782608696;103,921739130435;368;255255000
vpja48;14;1210;1485;-540,934782608696;80,4217391304347;275;255255000
vpja48;14;1511;2060;-478,634782608696;80,4217391304347;549;255255000
vpja48;14;2075;2278;-467,834782608696;69,2217391304348;203;255255000
vpja48;14;2298;2655;-432,034782608696;66,4217391304347;357;255255000
vpja48;14;2678;2896;-485,034782608696;79,6217391304348;218;255255000
vpja48;14;2964;3245;-32,5347826086957;128,821739130435;281;255
vpja48;14;3286;3465;-87,2347826086957;239,621739130435;179;2,55e+08
vpja48;14;3486;3761;-101,134782608696;286,921739130435;275;2,55e+08
vpja48;14;3794;4097;-15,2347826086957;167,221739130435;303;0
vpja48;14;4144;4302;205,965217391304;163,921739130435;158;0
vpja48;14;4348;4581;323,165217391304;12,3217391304347;233;0
vpja48;14;4611;4771;362,965217391304;-112,078260869565;160;0
vpja48;14;4817;5120;584,165217391304;-111,078260869565;303;0
vpja48;14;5152;5280;551,765217391304;-54,9782608695652;128;0
vpja48;14;5336;5538;349,365217391304;299,721739130435;202;0
vpja48;14;5600;5771;3,2652173913043;287,321739130435;171;0
vpja48;14;5800;5967;-92,0347826086957;297,021739130435;167;2,55e+08
vpja48;14;6025;6139;-194,634782608696;-122,878260869565;114;2,55e+08
vpja48;14;6167;6735;-218,934782608696;-205,478260869565;568;255000
vpja48;14;6755;7090;-210,834782608696;-197,978260869565;335;255000
vpja48;14;7141;7411;-228,634782608696;34,7217391304348;270;2,55e+08
vpja48;14;7442;7719;-264,934782608696;147,421739130435;277;0
vpja48;14;7773;7989;-529,234782608696;101,121739130435;216;255255000
vpja48;14;8022;8301;-608,634782608696;128,721739130435;279;0
vpja48;14;8344;8545;-496,834782608696;-28,7782608695652;201;0
vpja48;14;8718;8910;222,665217391304;-323,478260869565;192;0
vpja48;14;8939;9136;319,865217391304;-351,778260869565;197;0
vpja48;14;9149;9396;343,765217391304;-356,778260869565;247;0
vpja48;14;9449;9664;484,065217391304;-85,7782608695653;215;0
vpja48;14;9699;9945;591,365217391304;-103,278260869565;246;0
vpja48;15;322;516;212,9;66,6999999999999;194;255255000
vpja48;15;582;1085;-9,19999999999993;-254,5;503;255000
vpja48;15;1156;1282;-356;97,5;126;0
vpja48;15;1303;1896;-371,8;132,2;593;255
vpja48;15;1947;2325;-603,5;85,9;378;0
vpja48;15;2365;2593;-362,5;122,6;228;255
vpja48;15;2670;2865;229,3;98,5;195;255255000
vpja48;15;2900;3117;281,4;71,6;217;255255000
vpja48;15;3168;3385;574,8;32,1999999999999;217;0
vpja48;15;3411;3564;534,4;-30,6;153;0
vpja48;15;3608;3930;480,5;-212,4;322;0
vpja48;15;3951;4190;432,5;-220,4;239;0
vpja48;15;4259;4517;-36,9;-280,1;258;255000
vpja48;15;4547;5012;-11,1;-263,8;465;255000
vpja48;15;5067;5250;-176,7;22,1999999999999;183;0
vpja48;15;5459;5561;-261,1;294,8;102;0
vpja48;15;5608;5843;-348,3;129;235;255
vpja48;15;5861;6154;-365,8;122,7;293;255
vpja48;15;6230;6465;168,2;17,8;235;0
vpja48;15;6495;6721;274,9;50,1;226;255255000
vpja48;15;6775;6923;583,5;20,6;148;0
vpja48;15;7565;7796;172,8;-74,5;231;0
vpja48;15;7869;8003;-281,4;80,1;134;0
vpja48;15;8029;8102;-343,6;108,9;73;255
vpja48;15;8534;8857;-340,3;75,1;323;0
vpja48;15;8915;9409;-576,4;57,6999999999999;494;0
vpja48;15;9442;9651;-385;81;209;0
vpja48;15;9715;9916;141,9;36,1;201;0
vpja48;15;9949;10000;265,7;54,8;51;255255000
vpja48;16;307;419;56,504074074074;-29,2611111111111;112;255000
vpja48;16;474;861;5,90407407407406;192,538888888889;387;255
vpja48;16;917;1145;300,704074074074;134,638888888889;228;255255000
vpja48;16;1168;1366;300,404074074074;89,8388888888888;198;255255000
vpja48;16;1418;1561;76,9040740740741;-39,8611111111111;143;255000
vpja48;16;1580;1983;55,9040740740741;-17,3611111111111;403;255000
vpja48;16;2027;2292;7,10407407407399;-148,361111111111;265;0
vpja48;16;2357;2558;26,604074074074;173,738888888889;201;255
vpja48;16;2578;2874;18,304074074074;203,438888888889;296;255
vpja48;16;2924;3279;309,904074074074;124,838888888889;355;255255000
vpja48;16;3315;3458;316,004074074074;63,5388888888889;143;0
vpja48;16;3505;3895;339,604074074074;-156,061111111111;390;0
vpja48;16;3922;4197;400,104074074074;-146,661111111111;275;0
vpja48;16;4239;4451;293,204074074074;-260,561111111111;212;0
vpja48;16;4507;4665;65,3040740740739;-241,961111111111;158;0
vpja48;16;4722;4920;55,8040740740739;-3,16111111111115;198;2,55e+08
vpja48;16;4937;5187;37,704074074074;-20,2611111111111;250;255000
vpja48;16;5209;5419;52,6040740740741;-27,2611111111111;210;255000
vpja48;16;5505;5648;-542,195925925926;112,538888888889;143;0
vpja48;16;5672;5999;-553,095925925926;166,038888888889;327;0
vpja48;16;6066;6255;-55,195925925926;153,338888888889;189;0
vpja48;16;6299;6525;48,4040740740741;-2,46111111111111;226;2,55e+08
vpja48;16;6539;6956;49,3040740740739;-23,1611111111112;417;255000
vpja48;16;6992;7520;48,4040740740741;76,5388888888889;528;2,55e+08
vpja48;16;7582;7865;67,4040740740741;344,438888888889;283;0
vpja48;16;7903;8274;52,4040740740741;166,438888888889;371;0
vpja48;16;8295;8468;11,504074074074;171,038888888889;173;255
vpja48;16;8519;8901;287,904074074074;95,1388888888889;382;255255000
vpja48;16;8923;9153;314,704074074074;116,538888888889;230;255255000
vpja48;16;9176;9444;285,904074074074;72,4388888888889;268;255255000
vpja48;16;9494;9782;51,6040740740741;-43,3611111111111;288;255000
vpja48;16;9838;10000;40,504074074074;199,138888888889;162;255
vpja48;17;336;468;-105,1;-164,2;132;255000
vpja48;17;536;700;-209,5;294,3;164;0
vpja48;17;721;958;-155,9;293,5;237;0
vpja48;17;1017;1365;246,1;199,3;348;255255000
vpja48;17;1375;1581;260,5;199,1;206;255255000
vpja48;17;1594;1810;235,5;181,5;216;255255000
vpja48;17;1881;2146;-76,4000000000001;-129,3;265;2,55e+08
vpja48;17;2170;2521;-116,9;-178,4;351;255000
vpja48;17;2543;2810;-123,1;-222,3;267;255000
vpja48;17;2825;3021;-98,1;-224,6;196;255000
vpja48;17;3077;3217;-168;13,1999999999999;140;2,55e+08
vpja48;17;3285;3471;-352,8;97;186;2,55e+08
vpja48;17;3511;3739;-483,4;162,1;228;0
vpja48;17;3784;4050;-412,5;361,4;266;0
vpja48;17;4096;4220;-354,6;173,2;124;0
vpja48;17;4258;4524;-362,7;2,19999999999993;266;0
vpja48;17;4597;5020;268,7;-90,9;423;0
vpja48;17;5059;5321;176,6;49,1;262;0
vpja48;17;5361;5641;235,3;180,7;280;255255000
vpja48;17;5709;5868;-169,1;268,1;159;255
vpja48;17;6051;6292;-96,5;103,4;241;2,55e+08
vpja48;17;6313;6518;-63;149;205;2,55e+08
vpja48;17;6537;6934;-81,5;176,3;397;2,55e+08
vpja48;17;6960;7196;-3,5;154;236;2,55e+08
vpja48;17;7263;7492;-387,6;44,9;229;0
vpja48;17;7543;7743;-374,8;-210,7;200;0
vpja48;17;7770;7961;-423,8;-297,6;191;0
vpja48;17;7983;8397;-449,3;-347,8;414;0
vpja48;17;8447;8576;-132,3;-242,5;129;255000
vpja48;17;8600;9023;-115,7;-181,9;423;255000
vpja48;17;9072;9303;144,2;-69,7;231;0
vpja48;17;9392;9618;-478,4;120,6;226;0
vpja48;17;9676;10000;-457,5;345,1;324;0
vpja48;18;335;563;-41,1999999999999;-314,5;228;255000
vpja48;18;651;933;384,4;387,6;282;255
vpja48;18;1043;1232;-579,6;386,2;189;0
vpja48;18;1251;1445;-549,2;421,1;194;0
vpja48;18;1489;1630;-503,9;192,5;141;0
vpja48;18;1689;1971;-386,3;-177,9;282;0
vpja48;18;2037;2323;-54,6;-376,7;286;255000
vpja48;18;2340;2622;-60,6;-335,6;282;255000
vpja48;18;2642;2876;-57,8;-365,8;234;255000
vpja48;18;2940;3249;-412,5;-295,5;309;0
vpja48;18;3278;3475;-307,3;-291,1;197;0
vpja48;18;3605;3882;571,2;17,6999999999999;277;0
vpja48;18;3911;4135;596,9;71,5;224;0
vpja48;18;4198;4348;291,1;291,7;150;255
vpja48;18;4387;4557;162,8;242,4;170;255
vpja48;18;4646;4893;-522;343,3;247;0
vpja48;18;4922;5191;-551,4;426,1;269;255255000
vpja48;18;5239;5407;-345,2;214,2;168;0
vpja48;18;5435;5692;-250,4;230,9;257;0
vpja48;18;5750;5889;-356,3;-88,6;139;0
vpja48;18;5926;6255;-386,1;-273;329;0
vpja48;18;6284;6568;-331,5;-357,4;284;0
vpja48;18;6629;6811;91,3000000000001;-297;182;0
vpja48;18;6839;7188;186,8;-230,5;349;0
vpja48;18;7258;7498;579,8;-25,2;240;0
vpja48;18;7526;7838;618,5;62,9;312;0
vpja48;18;7932;8141;-23,4;-316,9;209;255000
vpja48;18;8168;8801;-48,1999999999999;-371,9;633;255000
vpja48;18;8876;9243;-108,6;67;367;2,55e+08
vpja48;18;9297;9524;-256,1;225;227;0
vpja48;18;9589;9970;-536,6;357,6;381;0
vpja48;19;361;560;89,7;-212,7;199;255000
vpja48;19;577;732;93,8999999999999;-240,3;155;255000
vpja48;19;874;1141;454,1;332,9;267;255
vpja48;19;1243;1430;-464;354,8;187;0
vpja48;19;1456;1697;-442,9;298,7;241;255255000
vpja48;19;1724;2004;-492,3;341,1;280;255255000
vpja48;19;2025;2259;-453,7;304,7;234;255255000
vpja48;19;2323;2550;9,69999999999993;86,3000000000001;227;2,55e+08
vpja48;19;2594;2736;116,6;-43,0999999999999;142;2,55e+08
vpja48;19;2779;3021;99;-267,9;242;255000
vpja48;19;3042;3281;106,3;-246,2;239;255000
vpja48;19;3303;3791;106,8;-277;488;255000
vpja48;19;3854;4151;-243,5;-208,1;297;0
vpja48;19;4191;4408;-393,6;-193;217;0
vpja48;19;4452;4752;-576,3;-200,1;300;0
vpja48;19;4932;5137;-304,8;287,8;205;0
vpja48;19;5185;5402;-51,1;165,5;217;2,55e+08
vpja48;19;5444;5712;80,3999999999999;59,5;268;2,55e+08
vpja48;19;5769;6001;432,8;31,1;232;0
vpja48;19;6027;6192;406,2;-31,4;165;0
vpja48;19;6235;6713;532,7;110,9;478;0
vpja48;19;6749;7102;383,8;67,2;353;0
vpja48;19;7128;7630;408,7;-12,1999999999999;502;0
vpja48;19;7654;7985;416,6;-72,1999999999999;331;0
vpja48;19;8036;8190;417,6;-262,8;154;0
vpja48;19;8226;8473;398,4;-397,7;247;0
vpja48;19;8514;8702;579,2;-330,8;188;0
vpja48;19;8725;8908;561,2;-395,2;183;0
vpja48;19;8988;9463;90,3999999999999;-261,6;475;255000
vpja48;19;9707;9883;77,8999999999999;85,1;176;2,55e+08
vpja48;19;9925;10000;-92,4000000000001;96,4000000000001;75;2,55e+08
vpja48;20;274;538;-8,08947368421059;-250,226315789474;264;255000
vpja48;20;602;654;-376,089473684211;73,8736842105263;52;0
vpja48;20;679;1078;-364,989473684211;142,973684210526;399;0
vpja48;20;1150;1597;251,31052631579;152,573684210526;447;255255000
vpja48;20;1673;1775;16,6105263157895;-207,126315789474;102;255000
vpja48;20;1803;2249;-2,08947368421059;-273,326315789474;446;255000
vpja48;20;2270;2497;15,2105263157895;-284,326315789474;227;255000
vpja48;20;2571;3022;-351,68947368421;152,173684210526;451;255
vpja48;20;3039;3220;-348,389473684211;135,273684210526;181;255
vpja48;20;3274;3677;0,910526315789411;-41,8263157894737;403;2,55e+08
vpja48;20;3734;4013;289,31052631579;143,873684210526;279;255255000
vpja48;20;4034;4275;250,51052631579;152,473684210526;241;255255000
vpja48;20;4340;4480;103,110526315789;-197,726315789474;140;255000
vpja48;20;4517;5075;5,71052631578948;-276,726315789474;558;255000
vpja48;20;5114;5491;44,8105263157895;-156,726315789474;377;2,55e+08
vpja48;20;5514;5952;81,2105263157894;-127,226315789474;438;2,55e+08
vpja48;20;5996;6227;-135,18947368421;-190,426315789474;231;0
vpja48;20;6265;6598;-89,9894736842106;-311,026315789474;333;0
vpja48;20;6623;6889;-99,0894736842106;-374,926315789474;266;0
vpja48;20;7403;7579;-333,489473684211;236,473684210526;176;0
vpja48;20;7826;8155;-348,989473684211;106,973684210526;329;0
vpja48;20;8297;8651;-353,18947368421;109,073684210526;354;0
vpja48;20;8698;9342;-128,589473684211;227,173684210526;644;0
vpja48;20;9389;9745;-328,68947368421;128,973684210526;356;255
vpja48;20;9768;9903;-350,18947368421;127,873684210526;135;255
vpja48;21;276;493;56;97,7;217;255
vpja48;21;545;872;-263,5;111,3;327;255255000
vpja48;21;927;1210;-102,5;-159,7;283;255000
vpja48;21;1230;1431;-79,9;-153,9;201;255000
vpja48;21;1483;1717;85,1000000000001;109,4;234;0
vpja48;21;1736;2091;54,2;130,7;355;0
vpja48;21;2141;2413;-255,6;124,5;272;0
vpja48;21;2431;2870;-275,8;127,8;439;0
vpja48;21;2909;3101;-192,2;195,1;192;0
vpja48;21;3148;3311;39,8;132;163;0
vpja48;21;3368;3541;285,1;-14,6999999999999;173;0
vpja48;21;3565;3732;331,7;-25;167;0
vpja48;21;3790;4018;564,3;-134,8;228;0
vpja48;21;4042;4360;576;-184,4;318;0
vpja48;21;4446;4757;-108,1;-135,1;311;2,55e+08
vpja48;21;4783;5289;-79,9;-144,8;506;255000
vpja48;21;5333;5751;-223,9;35,7;418;0
vpja48;21;5786;6634;-283,3;123,1;848;0
vpja48;21;6686;7071;55,4000000000001;127,8;385;255
vpja48;21;7097;7400;117,3;137,2;303;0
vpja48;21;7423;7906;67,7;132,2;483;0
vpja48;21;7987;8381;173,9;78,6;394;0
vpja48;21;8410;8846;86,7;113,9;436;0
vpja48;21;8896;9212;311,3;-5,29999999999995;316;0
vpja48;21;9259;9433;80,2;153,8;174;0
vpja48;21;9487;9891;328,2;-29;404;0
vpja48;21;9910;10000;327,9;-50,9;90;0
vpja48;22;13;206;0,900000000000205;-18,2;193;0
vpja48;22;252;451;167,9;131,8;199;255
vpja48;22;527;961;-386,3;339,1;434;255255000
vpja48;22;1037;1244;-346,9;-207,2;207;255000
vpja48;22;1268;1778;-320;-231,2;510;255000
vpja48;22;1849;1881;268,8;-104,7;32;0
vpja48;22;1899;2216;237,9;-77,0000000000001;317;0
vpja48;22;2243;2376;292,5;-45,6;133;0
vpja48;22;2427;2572;435,7;-204,6;145;0
vpja48;22;2680;2929;-544,4;-159,6;249;0
vpja48;22;2956;3254;-605,1;-155;298;0
vpja48;22;3322;3661;-568,1;168,7;339;2,55e+08
vpja48;22;3687;3902;-527,7;233,1;215;2,55e+08
vpja48;22;3918;4194;-542,2;249,1;276;2,55e+08
vpja48;22;4214;4549;-549,5;255,7;335;2,55e+08
vpja48;22;4573;5018;-543,3;254,4;445;2,55e+08
vpja48;22;5212;5439;-390,6;155,6;227;2,55e+08
vpja48;22;5479;5712;-528,4;221,2;233;2,55e+08
vpja48;22;5735;6266;-547,7;249,8;531;2,55e+08
vpja48;22;6306;6407;-382,4;190,9;101;2,55e+08
vpja48;22;6619;6957;-380,7;162,8;338;2,55e+08
vpja48;22;7011;7451;-374,7;336,9;440;255255000
vpja48;22;7495;7761;-548,4;248,1;266;2,55e+08
vpja48;22;7780;8025;-559,7;251,2;245;2,55e+08
vpja48;22;8045;8289;-556,4;253,8;244;2,55e+08
vpja48;22;8312;8528;-542,2;241,9;216;2,55e+08
vpja48;22;8579;8790;-375,2;35,1999999999999;211;2,55e+08
vpja48;22;8833;9027;-340,6;-130,7;194;2,55e+08
vpja48;22;9053;9272;-306,6;-194,8;219;255000
vpja48;22;9388;9594;222;182,3;206;255
vpja48;22;9645;9810;348,1;-141,4;165;0
vpja48;22;9836;10000;429,1;-200,6;164;0
vpja48;23;296;508;-89,4213523131673;-154,419928825623;212;255000
vpja48;23;554;586;-303,921352313167;52,5800711743772;32;0
vpja48;23;625;889;-304,121352313167;173,380071174377;264;0
vpja48;23;910;1201;-269,321352313167;181,880071174377;291;255255000
vpja48;23;1248;1596;-1,62135231316734;132,180071174377;348;255
vpja48;23;1639;1775;-173,421352313167;207,780071174377;136;0
vpja48;23;1822;1958;-95,4213523131673;-107,119928825623;136;2,55e+08
vpja48;23;1981;2432;-88,1213523131673;-140,319928825623;451;255000
vpja48;23;2502;2705;37,5786476868327;173,980071174377;203;255
vpja48;23;2922;3282;-175,921352313167;341,780071174377;360;0
vpja48;23;3296;3539;-204,421352313167;333,080071174377;243;0
vpja48;23;3588;3769;-385,221352313167;83,0800711743772;181;0
vpja48;23;3844;4131;30,6786476868327;-282,919928825623;287;0
vpja48;23;4155;4319;71,2786476868328;-347,519928825623;164;0
vpja48;23;4348;4731;2,27864768683276;-425,619928825623;383;0
vpja48;23;4758;5025;16,4786476868327;-358,419928825623;267;0
vpja48;23;5103;5429;-421,421352313167;-129,219928825623;326;0
vpja48;23;5467;5861;-410,021352313167;-4,11992882562276;394;0
vpja48;23;5918;6143;-442,521352313167;236,980071174377;225;0
vpja48;23;6183;6424;-300,921352313167;144,380071174377;241;0
vpja48;23;6451;6652;-247,621352313167;144,680071174377;201;0
vpja48;23;6699;6889;-160,021352313167;327,780071174377;190;0
vpja48;23;6913;7249;-214,121352313167;345,880071174377;336;0
vpja48;23;7286;7445;-123,121352313167;282,780071174377;159;0
vpja48;23;7504;7726;-395,121352313167;-3,91992882562283;222;0
vpja48;23;7749;8034;-435,921352313167;11,7800711743772;285;0
vpja48;23;8075;8198;-329,721352313167;160,180071174377;123;0
vpja48;23;8246;8649;-469,321352313167;234,680071174377;403;0
vpja48;23;8668;9074;-457,021352313167;212,780071174377;406;0
vpja48;23;9114;9489;-422,521352313167;-4,91992882562283;375;0
vpja48;23;9653;9904;-276,921352313167;148,380071174377;251;0
vpja48;23;9957;10000;7,37864768683266;106,280071174377;43;255
vpja48;24;323;655;98,1858657243815;-226,231802120141;332;255000
vpja48;24;788;1079;-429,914134275618;313,768197879859;291;255255000
vpja48;24;1104;1299;-427,414134275618;357,668197879859;195;255255000
vpja48;24;1347;1553;-151,014134275618;380,268197879859;206;0
vpja48;24;1588;1745;23,0858657243816;378,468197879859;157;0
vpja48;24;1794;2176;285,085865724382;364,668197879859;382;255
vpja48;24;2217;2517;260,285865724382;190,168197879859;300;2,55e+08
vpja48;24;2560;2793;77,8858657243816;122,968197879859;233;2,55e+08
vpja48;24;2832;3121;-65,5141342756184;164,268197879859;289;2,55e+08
vpja48;24;3163;3466;-238,614134275618;151,868197879859;303;0
vpja48;24;3524;3841;-435,314134275618;281,768197879859;317;255255000
vpja48;24;3861;4077;-446,414134275618;252,968197879859;216;255255000
vpja48;24;4226;4544;298,285865724382;326,568197879859;318;255
vpja48;24;4592;4744;36,0858657243816;256,268197879859;152;2,55e+08
vpja48;24;4801;5125;467,485865724382;215,368197879859;324;0
vpja48;24;5147;5410;513,985865724382;222,368197879859;263;0
vpja48;24;5508;5742;-268,014134275618;-128,931802120141;234;0
vpja48;24;5781;6019;-184,714134275618;-211,231802120141;238;0
vpja48;24;6046;6357;-193,414134275618;-291,831802120141;311;0
vpja48;24;6411;6601;-492,014134275618;-244,931802120141;190;0
vpja48;24;6628;6850;-578,414134275618;-283,531802120141;222;0
vpja48;24;6958;7314;93,5858657243816;-269,631802120141;356;255000
vpja48;24;7338;7623;86,5858657243816;-254,931802120141;285;255000
vpja48;24;7644;7859;107,585865724382;-241,831802120141;215;255000
vpja48;24;7879;8310;78,0858657243816;-280,331802120141;431;255000
vpja48;24;8343;8746;111,785865724382;-218,731802120141;403;255000
vpja48;24;8795;9040;51,4858657243817;14,7681978798587;245;2,55e+08
vpja48;24;9089;9349;-81,6141342756184;155,868197879859;260;2,55e+08
vpja48;24;9417;9673;-436,214134275618;297,068197879859;256;255255000
vpja48;24;9703;10000;-431,314134275618;420,068197879859;297;255255000
vpja48;25;318;502;152,189454545455;-165,561818181818;184;255000
vpja48;25;522;701;173,989454545454;-186,461818181818;179;255000
vpja48;25;772;970;-300,010545454546;15,7381818181818;198;255255000
vpja48;25;1000;1290;-319,910545454546;76,5381818181819;290;255255000
vpja48;25;1363;1568;306,689454545455;197,838181818182;205;255
vpja48;25;1593;1850;379,889454545455;286,838181818182;257;255
vpja48;25;1913;2074;174,989454545454;-142,261818181818;161;255000
vpja48;25;2097;2463;180,489454545454;-181,061818181818;366;255000
vpja48;25;2522;2849;-76,8105454545455;-125,961818181818;327;0
vpja48;25;2888;3105;-57,6105454545454;-308,861818181818;217;0
vpja48;25;3125;3328;-69,2105454545455;-352,461818181818;203;0
vpja48;25;3375;3482;165,789454545454;-248,861818181818;107;255000
vpja48;25;3503;3644;180,389454545455;-197,861818181818;141;255000
vpja48;25;3700;4129;421,089454545455;-318,161818181818;429;0
vpja48;25;4202;4398;-97,6105454545454;-353,461818181818;196;0
vpja48;25;4418;4588;-57,2105454545455;-361,361818181818;170;0
vpja48;25;4619;4865;-144,010545454546;-354,761818181818;246;0
vpja48;25;4915;5199;-69,9105454545455;-98,0618181818181;284;0
vpja48;25;5264;5572;-383,910545454546;-46,2618181818182;308;0
vpja48;25;5622;5958;-342,810545454545;115,838181818182;336;255255000
vpja48;25;6142;6273;444,489454545454;-194,461818181818;131;0
vpja48;25;6300;6457;446,889454545455;-306,961818181818;157;0
vpja48;25;6477;6650;419,889454545455;-341,061818181818;173;0
vpja48;25;6667;6921;410,489454545454;-305,561818181818;254;0
vpja48;25;6933;7234;413,689454545455;-288,761818181818;301;0
vpja48;25;7243;7554;428,189454545455;-284,761818181818;311;0
vpja48;25;7578;7856;416,689454545455;-358,561818181818;278;0
vpja48;25;7895;8141;534,889454545455;-261,861818181818;246;0
vpja48;25;8165;8461;573,689454545455;-321,861818181818;296;0
vpja48;25;8472;8760;574,589454545455;-332,261818181818;288;0
vpja48;25;8802;8939;371,489454545454;-322,761818181818;137;0
vpja48;25;8964;9328;330,989454545454;-285,661818181818;364;0
vpja48;25;9354;9835;413,789454545454;-283,061818181818;481;0
vpja48;25;9859;10000;399,389454545455;-340,361818181818;141;0
vpja48;26;47;260;3,69999999999993;3;213;0
vpja48;26;314;426;-4;-285,2;112;2,55e+08
vpja48;26;448;1135;3;-336;687;255000
vpja48;26;1177;1375;119,2;-214,3;198;0
vpja48;26;1458;1934;-400,8;-265,5;476;0
vpja48;26;1960;2181;-448;-254,6;221;0
vpja48;26;2203;2405;-476;-294,8;202;0
vpja48;26;2447;2705;-456,2;-127,7;258;0
vpja48;26;2741;3097;-415,9;-255,2;356;0
vpja48;26;3117;3310;-453,4;-293,3;193;0
vpja48;26;3338;3634;-454,2;-425;296;0
vpja48;26;3714;3888;-352,2;57,0999999999999;174;255255000
vpja48;26;3937;4219;-290,1;208,8;282;0
vpja48;26;4272;4458;-20,4;163,4;186;2,55e+08
vpja48;26;4603;4698;324,2;229;95;255
vpja48;26;4739;4957;401,2;328,1;218;0
vpja48;26;5016;5267;527,6;-71,2;251;0
vpja48;26;5292;5566;513,6;-167,5;274;0
vpja48;26;5596;5828;404,8;-119,7;232;0
vpja48;26;5882;6403;128,2;-158,5;521;0
vpja48;26;6487;6841;-286,8;146,7;354;255255000
vpja48;26;6884;7406;-50,5;149,9;522;2,55e+08
vpja48;26;7451;7613;-17,8000000000001;-114,2;162;2,55e+08
vpja48;26;7655;7812;-20;-323,4;157;255000
vpja48;26;7840;8041;-1,39999999999998;-331,6;201;255000
vpja48;26;8077;8531;-45,3000000000001;-231,7;454;2,55e+08
vpja48;26;8599;8829;-310,5;58,0999999999999;230;255255000
vpja48;26;8881;9260;-333,6;257,5;379;0
vpja48;26;9507;9598;267;283;91;255
vpja48;26;9624;9843;358;280,1;219;255
vpja48;26;9867;10000;395,6;305,1;133;0
