vp;trial;timest;timeend;x;y;duration;roi
vpja68;1;277;357;-175,387912087912;-141,28315018315;80;2,55e+08
vpja68;1;382;600;-172,587912087912;-188,08315018315;218;255000
vpja68;1;646;828;-342,487912087912;-204,08315018315;182;0
vpja68;1;880;1152;-435,487912087912;73,8168498168499;272;0
vpja68;1;1202;1326;-227,387912087912;-195,18315018315;124;0
vpja68;1;1357;1501;-161,787912087912;-197,28315018315;144;255000
vpja68;1;1541;1630;-345,087912087912;-214,98315018315;89;0
vpja68;1;1693;1951;1,91208791208794;-353,98315018315;258;0
vpja68;1;1987;2236;95,7120879120879;-371,88315018315;249;0
vpja68;1;2262;2503;18,512087912088;-415,18315018315;241;0
vpja68;1;2525;2725;45,9120879120879;-451,68315018315;200;0
vpja68;1;2800;2981;397,512087912088;36,6168498168498;181;255
vpja68;1;3050;3240;468,212087912088;310,41684981685;190;0
vpja68;1;3279;3498;371,712087912088;309,31684981685;219;0
vpja68;1;3518;3656;379,412087912088;293,21684981685;138;0
vpja68;1;3702;3946;416,412087912088;47,3168498168499;244;255
vpja68;1;3970;4146;435,412087912088;6,71684981684984;176;255
vpja68;1;4209;4517;411,012087912088;306,11684981685;308;0
vpja68;1;4582;4820;424,712087912088;0,616849816849822;238;255
vpja68;1;4891;5022;460,912087912088;287,01684981685;131;0
vpja68;1;5072;5316;601,612087912088;374,91684981685;244;0
vpja68;1;5420;5666;-392,587912087912;359,61684981685;246;255255000
vpja68;1;5685;5860;-407,387912087912;322,31684981685;175;255255000
vpja68;1;6061;6244;-628,687912087912;152,91684981685;183;0
vpja68;1;6265;6447;-645,287912087912;168,41684981685;182;NA
vpja68;1;6487;6714;-430,787912087912;63,8168498168499;227;0
vpja68;1;6739;7006;-460,687912087912;93,6168498168498;267;0
vpja68;1;7065;7281;-630,087912087912;180,51684981685;216;0
vpja68;1;7334;7457;-458,087912087912;56,5168498168499;123;0
vpja68;1;7476;7858;-474,487912087912;27,8168498168499;382;0
vpja68;1;7893;8158;-407,887912087912;62,5168498168499;265;0
vpja68;1;8187;8349;-365,487912087912;23,8168498168499;162;0
vpja68;1;8378;8529;-336,187912087912;8,31684981684987;151;0
vpja68;1;8552;8610;-349,787912087912;44,6168498168498;58;0
vpja68;1;8658;8991;-320,487912087912;-229,08315018315;333;0
vpja68;1;9020;9342;-345,587912087912;-190,88315018315;322;0
vpja68;1;9364;9698;-336,987912087912;-230,88315018315;334;0
vpja68;1;9720;9832;-354,987912087912;-195,58315018315;112;0
vpja68;1;9891;10000;5,61208791208799;-338,18315018315;109;0
vpja68;2;223;290;-10,5;-192,2;67;255000
vpja68;2;318;561;-54,3000000000001;-232,9;243;255000
vpja68;2;575;844;-64,4000000000001;-248,1;269;255000
vpja68;2;915;1106;-445,9;192,3;191;255
vpja68;2;1141;1212;-508,3;200,2;71;255
vpja68;2;1259;1482;-541,1;-26,5999999999999;223;0
vpja68;2;1518;1737;-418,3;-45,9;219;0
vpja68;2;1760;1956;-412,3;-86,1999999999999;196;0
vpja68;2;1975;2120;-410,5;-111;145;0
vpja68;2;2148;2755;-382,3;-45,5999999999999;607;0
vpja68;2;2782;2930;-371,7;-53,8;148;0
vpja68;2;3022;3133;429,3;-3,19999999999993;111;0
vpja68;2;3163;3318;536,9;35,4000000000001;155;0
vpja68;2;3373;3640;599,3;-228,2;267;0
vpja68;2;3665;3838;522,8;-197,5;173;0
vpja68;2;3873;4158;547,2;-343,4;285;0
vpja68;2;4263;4481;393,1;207,1;218;255255000
vpja68;2;4505;4647;332,3;161,9;142;255255000
vpja68;2;4688;4774;403,3;80,8000000000001;86;255255000
vpja68;2;4843;5048;-29,8000000000001;-237,2;205;255000
vpja68;2;5177;5240;-44,9000000000001;-232;63;255000
vpja68;2;5291;5335;35,5999999999999;-10,1999999999999;44;2,55e+08
vpja68;2;5418;5707;-396,7;-422,9;289;0
vpja68;2;5733;5981;-376,9;-340,6;248;0
vpja68;2;6030;6543;-289;-225,6;513;0
vpja68;2;6607;6810;-576,2;-140;203;0
vpja68;2;6863;7028;-482,2;31,6;165;0
vpja68;2;7051;7233;-502,8;19,5;182;0
vpja68;2;7294;7525;-434;229,5;231;255
vpja68;2;7548;8048;-494,3;184,5;500;255
vpja68;2;8074;8370;-404,1;205,8;296;255
vpja68;2;8412;8656;-220,8;220,2;244;0
vpja68;2;8680;8851;-187;220,4;171;0
vpja68;2;8908;9146;-462,5;214,2;238;255
vpja68;2;9207;9428;-86,2;126,1;221;2,55e+08
vpja68;2;9469;9625;11,3;23,4000000000001;156;2,55e+08
vpja68;2;9675;9867;74,7;-99,6;192;2,55e+08
vpja68;2;9906;10000;1,59999999999991;-3,39999999999998;94;2,55e+08
vpja68;3;247;303;-205,9;-141;56;2,55e+08
vpja68;3;337;503;-220,1;-204,5;166;255000
vpja68;3;510;781;-223,3;-218,7;271;255000
vpja68;3;836;1022;-109,9;17,1999999999999;186;255
vpja68;3;1044;1215;-164,4;34,5;171;2,55e+08
vpja68;3;1271;1463;-67,5999999999999;243,5;192;0
vpja68;3;1487;1684;-86,3;294,5;197;2,55e+08
vpja68;3;1707;1816;-50,4;281,7;109;2,55e+08
vpja68;3;1857;2179;-47;137,8;322;255
vpja68;3;2215;2349;-13,9;23,9;134;255
vpja68;3;2395;2545;270,1;-34,8000000000001;150;0
vpja68;3;2609;2835;594,5;-119,4;226;0
vpja68;3;2856;3386;598,6;-141;530;0
vpja68;3;3403;3675;605,5;-152,9;272;0
vpja68;3;3702;3914;592,4;-108,9;212;0
vpja68;3;3936;4076;607;-114;140;0
vpja68;3;4126;4350;522,3;-361;224;0
vpja68;3;4410;4596;281,8;-394,4;186;0
vpja68;3;4644;4750;110;-433,9;106;0
vpja68;3;4827;4912;-258,8;-194;85;0
vpja68;3;4944;5378;-208,5;-218,3;434;255000
vpja68;3;5443;5566;-76,8;4,29999999999995;123;255
vpja68;3;5604;5719;-93,5;-44,6;115;255
vpja68;3;5767;5865;-193,2;-159,5;98;2,55e+08
vpja68;3;5926;6124;-509,6;88,1999999999999;198;255255000
vpja68;3;6144;6365;-536,2;64,1999999999999;221;255255000
vpja68;3;6398;6724;-469,8;73,9;326;255255000
vpja68;3;6770;6956;-456,1;40,5999999999999;186;255255000
vpja68;3;6979;7221;-479,8;35,5999999999999;242;255255000
vpja68;3;7244;7528;-497,5;19,5;284;0
vpja68;3;7555;8042;-478,6;38,6999999999999;487;255255000
vpja68;3;8099;8385;-642;121,7;286;NA
vpja68;3;8443;8653;-483;301;210;0
vpja68;3;8697;8797;-550,8;234,9;100;0
vpja68;3;8934;9020;-655,5;-194;86;NA
vpja68;3;9072;9324;-584,3;-386,7;252;0
vpja68;3;9388;9558;-224,1;-142,4;170;2,55e+08
vpja68;3;9618;9687;-479,6;-97,5000000000001;69;0
vpja68;3;9843;9924;-435,5;-128,5;81;0
vpja68;4;235;261;-107,8;-17;26;2,55e+08
vpja68;4;292;493;-85,5999999999999;-171,7;201;255000
vpja68;4;509;685;-67;-180,9;176;255000
vpja68;4;743;1271;86,1000000000001;98,9;528;255
vpja68;4;1831;1942;529,7;-140,9;111;0
vpja68;4;1974;2210;594,5;-227,6;236;0
vpja68;4;2239;2691;604,1;-243,1;452;0
vpja68;4;2699;3183;597,3;-247,8;484;0
vpja68;4;3211;3422;601,1;-188,3;211;0
vpja68;4;3483;3606;582;117;123;0
vpja68;4;3674;3868;627,4;392,4;194;0
vpja68;4;3949;4020;599,3;-186,5;71;0
vpja68;4;4043;4185;608,3;-236,4;142;0
vpja68;4;4283;4496;630,1;327,6;213;0
vpja68;4;4555;4751;346,8;-28,7;196;0
vpja68;4;4775;4861;355,4;-75,5;86;0
vpja68;4;4923;5037;-30,8;-170,7;114;255000
vpja68;4;5066;5492;-62,3;-175,1;426;255000
vpja68;4;5554;5862;93,5;115,8;308;0
vpja68;4;5885;6122;143;103,5;237;255
vpja68;4;6145;6648;178,6;120,3;503;0
vpja68;4;6686;7007;74,1000000000001;102,5;321;0
vpja68;4;7547;7675;-247,9;19,4;128;0
vpja68;4;7825;7892;-255,4;0,299999999999955;67;0
vpja68;4;7976;8151;18,6;473,8;175;0
vpja68;4;8211;8291;-292,8;453,6;80;0
vpja68;4;8392;8576;-503;-239,3;184;0
vpja68;4;8629;8759;-387,6;-329,1;130;0
vpja68;4;8785;9042;-292,1;-384,3;257;0
vpja68;4;9087;9237;-69,0999999999999;-423,9;150;0
vpja68;4;9266;9560;-12,1999999999999;-431;294;0
vpja68;4;9581;9872;-43,5;-434,1;291;0
vpja68;4;9935;10000;81,6000000000001;-274,5;65;0
vpja68;5;215;261;11;-181,6;46;2,55e+08
vpja68;5;296;378;0,600000000000023;-251,5;82;2,55e+08
vpja68;5;402;800;-43,7;-281,1;398;255000
vpja68;5;862;1066;-93,8;33,3000000000001;204;255255000
vpja68;5;1102;1366;-109,5;-29,8;264;0
vpja68;5;1404;1634;-251,8;-46,1999999999999;230;255
vpja68;5;1677;2025;-91,2;-9,59999999999991;348;0
vpja68;5;2083;2139;-249,9;211,3;56;0
vpja68;5;2229;2406;386,7;-25,3;177;0
vpja68;5;2439;2662;444,4;-30,4;223;0
vpja68;5;2830;2973;469,6;-29,5999999999999;143;0
vpja68;5;2996;3390;425;-14,6999999999999;394;0
vpja68;5;3430;3696;506,1;-58,9;266;0
vpja68;5;3719;3991;561,7;-48,6999999999999;272;0
vpja68;5;4010;4197;579,9;-40;187;0
vpja68;5;4222;4486;636,5;-15,3;264;0
vpja68;5;4538;4731;468,1;-273,7;193;0
vpja68;5;4752;4940;443,4;-282,3;188;0
vpja68;5;4994;5226;260,3;-214,3;232;0
vpja68;5;5268;5511;192,3;-69,4;243;0
vpja68;5;5542;6049;166,3;-21,6999999999999;507;0
vpja68;5;6112;6463;-36,2;-286;351;255000
vpja68;5;6504;6569;-221;-249,7;65;0
vpja68;5;6640;6884;-600,2;-53,5999999999999;244;0
vpja68;5;6926;7148;-566,9;-128,1;222;0
vpja68;5;7190;7413;-580,9;39;223;0
vpja68;5;7481;7634;-335,7;341,5;153;0
vpja68;5;7673;7940;-320,7;425;267;0
vpja68;5;7999;8320;-5,10000000000002;421,8;321;0
vpja68;5;8351;8495;14,1;438,1;144;2,55e+08
vpja68;5;8568;8647;250,7;79,7;79;0
vpja68;5;8671;8751;197,4;-5,39999999999998;80;0
vpja68;5;8783;8931;145,7;-23,1999999999999;148;0
vpja68;5;8958;9397;167,4;-14,1999999999999;439;0
vpja68;5;9426;9539;262,4;-37;113;0
vpja68;5;9563;10000;169,7;-35,1999999999999;437;0
vpja68;6;209;245;53,4;-156,8;36;2,55e+08
vpja68;6;273;374;52,8;-282,1;101;0
vpja68;6;393;523;44,8;-322,1;130;255000
vpja68;6;590;781;345,5;70,6;191;255255000
vpja68;6;850;1196;-136,4;33,5;346;255
vpja68;6;1225;1377;-186;79,4;152;255
vpja68;6;1546;1590;-176,7;70;44;255
vpja68;6;1651;1728;15,7;-213,9;77;2,55e+08
vpja68;6;1755;2051;58;-302,4;296;255000
vpja68;6;2080;2155;92,2;-233;75;2,55e+08
vpja68;6;2233;2397;-368,3;-35,8000000000001;164;0
vpja68;6;2424;2566;-343,7;-23;142;0
vpja68;6;2601;2760;-413,8;71,5;159;0
vpja68;6;2805;3112;-617,5;-44,2;307;0
vpja68;6;3180;3357;-559,7;240,2;177;0
vpja68;6;3407;3518;-603,9;420;111;0
vpja68;6;3620;3656;366,9;193,4;36;0
vpja68;6;3714;3868;628,7;251;154;0
vpja68;6;3926;4239;571,8;29,5;313;0
vpja68;6;4306;4506;96,5999999999999;-272;200;2,55e+08
vpja68;6;4536;4703;60,5;-296,4;167;255000
vpja68;6;4729;5066;85,3;-258,1;337;2,55e+08
vpja68;6;5099;5321;51,7;-334,5;222;255000
vpja68;6;5344;5555;65,3;-298,9;211;255000
vpja68;6;5570;5958;73,7;-291,8;388;255000
vpja68;6;5985;6102;53,6;-320,3;117;255000
vpja68;6;6134;6462;53,7;-328,5;328;255000
vpja68;6;6473;6562;36,8;-333,3;89;255000
vpja68;6;6629;6947;-135,8;62,6;318;255
vpja68;6;6977;7058;-179,7;73,3;81;255
vpja68;6;7104;7588;-4,20000000000005;-38,1;484;0
vpja68;6;7636;7903;-160,1;52,6;267;255
vpja68;6;8107;8338;-164,9;60,9;231;255
vpja68;6;8377;8512;-109;-0,399999999999977;135;255
vpja68;6;8578;8766;307,3;122,9;188;255255000
vpja68;6;8804;8945;381,5;69,6;141;0
vpja68;6;8969;9193;417,3;42,8;224;0
vpja68;6;9232;9576;300;103,4;344;255255000
vpja68;6;9599;9806;315,8;115,6;207;255255000
vpja68;6;9876;9942;57,2;-254,4;66;2,55e+08
vpja68;6;9965;10000;67,4000000000001;-324,2;35;255000
vpja68;7;197;284;-13,7432628635497;-202,199210372385;87;2,55e+08
vpja68;7;313;360;-45,0432628635497;-217,499210372385;47;255000
vpja68;7;407;527;-28,3432628635497;41,2007896276151;120;2,55e+08
vpja68;7;565;658;78,7567371364503;81,3007896276151;93;2,55e+08
vpja68;7;721;1017;-84,1432628635497;-302,799210372385;296;255000
vpja68;7;1036;1383;-73,3432628635497;-326,099210372385;347;255000
vpja68;7;1410;1508;-96,4432628635498;-298,399210372385;98;255000
vpja68;7;1539;1674;-75,3432628635497;-231,199210372385;135;255000
vpja68;7;1754;1943;-448,24326286355;307,800789627615;189;0
vpja68;7;1968;2710;-456,04326286355;282,400789627615;742;255
vpja68;7;2798;2910;283,65673713645;296,700789627615;112;0
vpja68;7;2935;3157;375,95673713645;310,900789627615;222;255255000
vpja68;7;3208;3487;440,05673713645;71,6007896276152;279;0
vpja68;7;3528;3810;328,85673713645;-39,5992103723848;282;0
vpja68;7;3837;3942;364,45673713645;-25,2992103723849;105;0
vpja68;7;4000;4325;510,65673713645;-344,499210372385;325;0
vpja68;7;4349;4630;547,45673713645;-336,999210372385;281;0
vpja68;7;4667;4969;464,65673713645;-442,799210372385;302;0
vpja68;7;4986;5081;457,95673713645;-431,299210372385;95;0
vpja68;7;5154;5351;364,75673713645;-23,4992103723848;197;0
vpja68;7;5388;5565;345,05673713645;-92,8992103723849;177;0
vpja68;7;5655;5844;-413,64326286355;-203,099210372385;189;0
vpja68;7;5871;6166;-308,94326286355;-219,999210372385;295;0
vpja68;7;6208;6433;-79,0432628635497;-291,799210372385;225;255000
vpja68;7;6455;6669;-72,1432628635497;-322,299210372385;214;255000
vpja68;7;6743;6835;-5,84326286354974;-3,49921037238482;92;2,55e+08
vpja68;7;6982;7079;125,05673713645;76,4007896276152;97;2,55e+08
vpja68;7;7142;7350;425,35673713645;71,6007896276152;208;0
vpja68;7;7374;7489;477,65673713645;122,400789627615;115;0
vpja68;7;7582;7761;-371,54326286355;16,4007896276152;179;0
vpja68;7;7802;7914;-416,64326286355;-89,7992103723848;112;0
vpja68;7;7957;8148;-296,64326286355;-177,299210372385;191;0
vpja68;7;8198;8374;-87,6432628635497;-257,399210372385;176;255000
vpja68;7;8439;8562;32,7567371364503;-17,3992103723848;123;2,55e+08
vpja68;7;8619;8810;124,15673713645;100,000789627615;191;2,55e+08
vpja68;7;8836;9006;19,4567371364503;104,000789627615;170;2,55e+08
vpja68;7;9081;9330;-69,9432628635498;-305,999210372385;249;255000
vpja68;7;9345;9641;-72,9432628635498;-321,099210372385;296;255000
vpja68;7;9678;9985;-87,7432628635497;-224,299210372385;307;255000
vpja68;8;279;451;52,9000000000001;-253,1;172;255000
vpja68;8;467;773;38,5;-273,1;306;255000
vpja68;8;787;1086;48,9000000000001;-282,8;299;255000
vpja68;8;1172;1307;349,6;244,1;135;255
vpja68;8;1364;1440;56,3000000000001;75,6;76;2,55e+08
vpja68;8;1501;1591;84,6000000000001;-193,7;90;2,55e+08
vpja68;8;1656;1943;-305,4;-76,3000000000001;287;0
vpja68;8;2005;2220;59,6;-266;215;255000
vpja68;8;2234;2706;55,8000000000001;-281,3;472;255000
vpja68;8;2720;2944;41,9000000000001;-285,4;224;255000
vpja68;8;3012;3268;23;-25,4;256;2,55e+08
vpja68;8;3333;3536;-348,4;223,2;203;255255000
vpja68;8;3561;3901;-425,2;203,7;340;255255000
vpja68;8;3928;4087;-312,3;162,4;159;255255000
vpja68;8;4164;4328;318,7;226,1;164;255
vpja68;8;4352;4488;392;217,1;136;255
vpja68;8;4535;4792;510,4;-67,2;257;0
vpja68;8;4878;5083;-15,3;-388,4;205;0
vpja68;8;5132;5323;-108,5;-398,5;191;0
vpja68;8;5357;5722;-43,4;-389,7;365;0
vpja68;8;5735;5982;-58,5999999999999;-398,9;247;0
vpja68;8;6059;6348;-471,5;-90,8;289;0
vpja68;8;6387;6521;-502,1;-190,9;134;0
vpja68;8;6575;6699;-317;-31,8000000000001;124;0
vpja68;8;6729;6953;-278,9;-77,6;224;0
vpja68;8;7017;7098;65,5;-221,8;81;2,55e+08
vpja68;8;7123;7434;54,7;-280,6;311;255000
vpja68;8;7506;7650;91,4000000000001;160,1;144;0
vpja68;8;7706;7868;339,1;-47,4;162;0
vpja68;8;7892;8251;286,9;-97,2;359;0
vpja68;8;8263;8427;303,5;-91;164;0
vpja68;8;8486;8807;351,8;208,7;321;255
vpja68;8;8831;8959;379,7;225;128;255
vpja68;8;9115;9292;556,3;7,60000000000002;177;0
vpja68;8;9326;9557;507,2;-98,2;231;0
vpja68;8;9575;9646;527,2;-91,3;71;0
vpja68;8;9746;9980;-255,7;-35,6;234;0
vpja68;9;273;408;-286,059589041096;-124,554109589041;135;255000
vpja68;9;429;1019;-275,459589041096;-162,654109589041;590;255000
vpja68;9;1098;1230;-167,159589041096;297,745890410959;132;255255000
vpja68;9;1291;1593;263,040410958904;64,345890410959;302;255
vpja68;9;1621;2037;277,440410958904;46,545890410959;416;255
vpja68;9;2104;2366;-112,659589041096;293,445890410959;262;255255000
vpja68;9;2437;2547;-219,659589041096;-118,354109589041;110;0
vpja68;9;2587;2748;-358,759589041096;-163,954109589041;161;255000
vpja68;9;2786;2962;-259,259589041096;-168,954109589041;176;255000
vpja68;9;3041;3163;284,440410958904;60,1458904109591;122;255
vpja68;9;3221;3441;478,340410958904;-79,2541095890409;220;0
vpja68;9;3496;3644;242,440410958904;-115,454109589041;148;0
vpja68;9;3772;3937;-114,559589041096;-157,354109589041;165;0
vpja68;9;3981;4475;-253,759589041096;-168,054109589041;494;255000
vpja68;9;4506;4741;-281,159589041096;-128,354109589041;235;255000
vpja68;9;4779;5173;-331,259589041096;-147,254109589041;394;2,55e+08
vpja68;9;5213;5427;-381,259589041096;-226,654109589041;214;255000
vpja68;9;5452;5683;-451,659589041096;-234,854109589041;231;0
vpja68;9;5726;5886;-577,159589041096;-315,654109589041;160;0
vpja68;9;5916;6026;-425,259589041096;-214,754109589041;110;0
vpja68;9;6054;7036;-448,359589041096;-228,754109589041;982;0
vpja68;9;7083;7272;-644,659589041096;-254,654109589041;189;NA
vpja68;9;7311;7422;-586,359589041096;-346,054109589041;111;0
vpja68;9;7447;7651;-536,759589041096;-307,154109589041;204;0
vpja68;9;7675;7903;-538,459589041096;-366,554109589041;228;0
vpja68;9;7926;8044;-583,759589041096;-363,454109589041;118;0
vpja68;9;8135;8226;239,740410958904;-158,054109589041;91;0
vpja68;9;8286;8433;524,140410958904;-70,8541095890409;147;0
vpja68;9;8459;8813;562,940410958904;-123,154109589041;354;0
vpja68;9;8888;9095;632,040410958904;363,645890410959;207;0
vpja68;9;9171;9284;265,340410958904;-83,154109589041;113;0
vpja68;9;9315;9570;260,140410958904;-108,954109589041;255;0
vpja68;9;9592;10000;281,240410958904;-104,554109589041;408;0
vpja68;10;252;386;-156,9;247,2;134;255
vpja68;10;609;738;231,1;175,3;129;255255000
vpja68;10;757;1109;267,4;177,5;352;255255000
vpja68;10;1329;1643;-110,2;-237,7;314;255000
vpja68;10;1672;1879;-106,3;-177,8;207;255000
vpja68;10;1903;2202;-91;-232,3;299;255000
vpja68;10;2225;2367;-115,6;-222;142;255000
vpja68;10;2393;2593;-103;-161,9;200;255000
vpja68;10;2601;2693;-95,1999999999999;-166,2;92;255000
vpja68;10;2748;2951;-81,1999999999999;-20,3000000000001;203;2,55e+08
vpja68;10;2979;3122;-112,6;25,5;143;2,55e+08
vpja68;10;3436;3632;-24,3;18,8;196;2,55e+08
vpja68;10;3673;3970;8,30000000000007;-122,3;297;2,55e+08
vpja68;10;4037;4123;-341,5;-82;86;0
vpja68;10;4162;4504;-102,2;-245,1;342;255000
vpja68;10;4530;4676;-72,3;-225,3;146;255000
vpja68;10;4721;4888;-193,8;-11,3000000000001;167;2,55e+08
vpja68;10;4937;5163;-546,8;-118,6;226;0
vpja68;10;5188;5323;-576,1;-190,7;135;0
vpja68;10;5403;5569;-503,9;266,7;166;0
vpja68;10;5646;5774;-25,5;456,6;128;0
vpja68;10;5824;5931;113,4;413,9;107;0
vpja68;10;6000;6185;269,2;149,5;185;0
vpja68;10;6209;6396;267,7;180,5;187;255255000
vpja68;10;6453;6692;-32,9;151,9;239;2,55e+08
vpja68;10;6721;6888;-4;137;167;2,55e+08
vpja68;10;6950;7125;423;-161,2;175;0
vpja68;10;7146;7287;398,7;-192,9;141;0
vpja68;10;7327;7532;306,6;-87,7;205;0
vpja68;10;7576;7768;487,6;-12,3000000000001;192;0
vpja68;10;7830;8020;97,7;-303;190;0
vpja68;10;8078;8229;-111,8;-379,8;151;255000
vpja68;10;8368;8463;-33,0999999999999;-221,5;95;255000
vpja68;10;8492;8611;-10;-225,3;119;0
vpja68;10;8787;9027;-14,5;-231,5;240;255000
vpja68;10;9054;9451;-116,4;-222,2;397;255000
vpja68;10;9471;9738;-113,6;-243,3;267;255000
vpja68;10;9812;9912;-387,6;-337,8;100;0
vpja68;10;9957;9999;-513,2;-306,7;42;0
vpja68;11;200;294;-207,3;-150,5;94;255000
vpja68;11;315;641;-269,5;-208,9;326;0
vpja68;11;718;913;-411,1;368,2;195;255
vpja68;11;949;1032;-449,5;317,7;83;255
vpja68;11;1089;1328;-140,5;363;239;255255000
vpja68;11;1369;1613;-273,8;273,9;244;2,55e+08
vpja68;11;1652;1794;-423,3;264,4;142;0
vpja68;11;1858;1956;-272,8;-190;98;0
vpja68;11;1987;2528;-254;-205,9;541;255000
vpja68;11;2594;2781;156,5;-202,4;187;0
vpja68;11;2823;3036;308,1;-266,5;213;0
vpja68;11;3092;3356;-7,29999999999995;-203,5;264;0
vpja68;11;3380;3752;15,2;-225;372;0
vpja68;11;3784;4099;-76,2;-161,8;315;0
vpja68;11;4119;4276;-59,5;-182,4;157;0
vpja68;11;4301;4427;-53,2;-125;126;0
vpja68;11;4505;4634;-471,3;-312,3;129;0
vpja68;11;4665;4867;-568,9;-347,5;202;0
vpja68;11;4950;5048;-532,4;154,6;98;0
vpja68;11;5100;5291;-420,1;342,6;191;255
vpja68;11;5313;5654;-447;310,3;341;255
vpja68;11;5713;5901;-134,8;350,6;188;255255000
vpja68;11;6098;6159;379,6;146,5;61;0
vpja68;11;6189;6436;441,4;109,6;247;0
vpja68;11;6457;6712;440,5;95;255;0
vpja68;11;6765;6918;259,1;-139,9;153;0
vpja68;11;6955;7095;254;-266,5;140;0
vpja68;11;7120;7203;321,9;-307,3;83;0
vpja68;11;7267;7440;-23,7;-195,8;173;0
vpja68;11;7503;7623;269,3;-275;120;0
vpja68;11;7648;7773;316;-298,1;125;0
vpja68;11;7792;7874;326,3;-307,4;82;0
vpja68;11;7939;8268;-62,6;-189,2;329;0
vpja68;11;8300;8817;15,9;-221,3;517;0
vpja68;11;8835;8967;21,6;-241,7;132;0
vpja68;11;9006;9253;-92,4;-165;247;0
vpja68;11;9283;9524;-53,1;-152,8;241;0
vpja68;11;9588;9704;-271,1;-182,4;116;0
vpja68;11;9736;9949;-232,1;-192,9;213;255000
vpja68;12;181;230;7,19999999999993;-192,3;49;255000
vpja68;12;254;471;-26,8000000000001;-261,3;217;255000
vpja68;12;571;706;42,9;176,6;135;255255000
vpja68;12;755;926;49,5999999999999;357,7;171;255255000
vpja68;12;948;1101;44,1999999999999;305,1;153;255255000
vpja68;12;1179;1580;-469,9;278,5;401;255
vpja68;12;1635;1786;-225,5;351,4;151;0
vpja68;12;1832;1956;47,0999999999999;297,1;124;255255000
vpja68;12;2154;2456;480,3;229,7;302;0
vpja68;12;2512;2651;259,7;117;139;2,55e+08
vpja68;12;2737;3005;-14,9000000000001;-287,4;268;255000
vpja68;12;3035;3133;-58,3000000000001;-275,1;98;255000
vpja68;12;3197;3340;-335,1;-178,1;143;0
vpja68;12;3407;3589;-463,1;170,9;182;0
vpja68;12;3651;3770;-434,8;-197,3;119;0
vpja68;12;3826;3974;-208,4;-275,1;148;0
vpja68;12;4032;4354;-620,9;-291,8;322;0
vpja68;12;4416;4662;-211,2;-256,3;246;0
vpja68;12;4704;5059;-23,7;-290,8;355;255000
vpja68;12;5089;5294;-47,2;-264;205;255000
vpja68;12;5359;5743;0;-45,5;384;2,55e+08
vpja68;12;5801;6006;-105,2;149,9;205;2,55e+08
vpja68;12;6065;6274;200,6;150,6;209;2,55e+08
vpja68;12;6324;6521;255,7;263,8;197;2,55e+08
vpja68;12;6546;6759;168,5;322,8;213;2,55e+08
vpja68;12;6831;6968;-5,30000000000007;-261,5;137;255000
vpja68;12;6992;7297;-47,1;-298,4;305;255000
vpja68;12;7321;7551;-15,4000000000001;-285,4;230;255000
vpja68;12;7637;7842;368,2;154;205;0
vpja68;12;7869;8233;450,3;248;364;0
vpja68;12;8333;8646;-400,6;254,5;313;0
vpja68;12;8702;9039;-177,9;363,8;337;0
vpja68;12;9102;9467;-453,4;379,4;365;255
vpja68;12;9533;9740;-11,6;374,7;207;255255000
vpja68;12;9773;9908;69,3;400,7;135;255255000
vpja68;12;9956;10000;14,3;308,6;44;255255000
vpja68;13;201;291;-317,1;-72,1999999999999;90;2,55e+08
vpja68;13;327;712;-364,7;-156,7;385;255000
vpja68;13;732;1011;-374,8;-147,2;279;255000
vpja68;13;1066;1297;-321,9;112,2;231;255
vpja68;13;1334;1508;-404,8;120,9;174;255
vpja68;13;1528;1664;-424,2;124,7;136;2,55e+08
vpja68;13;1700;2017;-222,2;89,1;317;255
vpja68;13;2112;2188;381;-185,1;76;0
vpja68;13;2236;2395;492,4;-195,2;159;0
vpja68;13;2443;2676;539,3;-396,4;233;0
vpja68;13;2713;2904;436,1;-411,7;191;0
vpja68;13;2966;3190;83,9999999999999;-425,1;224;0
vpja68;13;3209;3377;71,9;-431,3;168;0
vpja68;13;3399;3626;43,4;-407,2;227;0
vpja68;13;3649;3799;66,1999999999999;-400,7;150;0
vpja68;13;3819;4120;78,6;-403,5;301;0
vpja68;13;4147;4411;54,8;-389,6;264;0
vpja68;13;4420;4782;40,6999999999999;-391,1;362;0
vpja68;13;4839;5102;-141,9;-299,2;263;0
vpja68;13;5138;5350;-48;-240;212;0
vpja68;13;5387;5616;-221,8;-238,2;229;0
vpja68;13;5636;6054;-237,7;-278,3;418;0
vpja68;13;6104;6377;-111,8;-251,3;273;0
vpja68;13;6407;6593;-60,7;-251,1;186;0
vpja68;13;6623;6744;-10,4;-240,8;121;0
vpja68;13;6817;6968;-402,1;-139,7;151;0
vpja68;13;6999;7150;-359,1;-149,1;151;255000
vpja68;13;7237;7459;-564,9;433,7;222;0
vpja68;13;7542;7721;35,5;60,2;179;255255000
vpja68;13;7747;7932;11,5;-23,3;185;255255000
vpja68;13;8107;8327;193,6;210,1;220;0
vpja68;13;8393;8557;-239,1;127;164;255
vpja68;13;8593;8828;-350,6;88,4;235;255
vpja68;13;8874;9343;-368,4;-148,5;469;255000
vpja68;13;9371;9589;-226,8;-256,3;218;0
vpja68;13;9611;9821;-245,1;-310,5;210;0
vpja68;13;9833;9934;-254,6;-326,9;101;0
vpja68;13;9963;10000;-123,3;-277,5;37;0
vpja68;14;168;390;55,2;-50,7;222;255000
vpja68;14;445;739;25,8000000000001;194,4;294;255
vpja68;14;762;914;104,7;186,4;152;255
vpja68;14;960;1175;316,8;115,4;215;255255000
vpja68;14;1193;1304;310,6;90,1;111;255255000
vpja68;14;1488;1556;312,6;74,9;68;0
vpja68;14;1606;1903;50,6;-40,5;297;255000
vpja68;14;1925;2279;55;-49,6;354;255000
vpja68;14;2351;2416;-228,4;-117,5;65;0
vpja68;14;2485;2816;-555,4;160,2;331;0
vpja68;14;2899;3067;38,5;-54,2;168;255000
vpja68;14;3098;3478;60,4;-58,7;380;255000
vpja68;14;3499;3600;57,3000000000001;-35,6;101;255000
vpja68;14;3651;3845;360,8;-162,5;194;0
vpja68;14;3875;3991;319,6;-165,8;116;0
vpja68;14;4052;4361;-23,6999999999999;-195,9;309;0
vpja68;14;4411;4575;-295,3;-189,5;164;0
vpja68;14;4644;4726;198,8;-183,7;82;0
vpja68;14;4754;5049;321,6;-172,7;295;0
vpja68;14;5076;5214;412,3;-112,3;138;0
vpja68;14;5280;5497;294,2;100,6;217;255255000
vpja68;14;5527;5787;324;103,9;260;255255000
vpja68;14;5797;5901;313,4;94,6;104;255255000
vpja68;14;5955;6101;317,1;-151,1;146;0
vpja68;14;6130;6324;338,2;-165,2;194;0
vpja68;14;6350;6545;414,9;-174,3;195;0
vpja68;14;6653;6802;-466;228;149;0
vpja68;14;6844;6997;-560;160;153;0
vpja68;14;7047;7484;-547,8;331,6;437;0
vpja68;14;7506;7877;-541,9;327,3;371;0
vpja68;14;7950;8038;44,3000000000001;-21,3000000000001;88;255000
vpja68;14;8068;8597;54,2;-49,2;529;255000
vpja68;14;8619;8879;67,5;-55,7;260;255000
vpja68;14;8890;9403;58;-47,2;513;255000
vpja68;14;9419;9533;63,4;-71,1;114;255000
vpja68;14;9575;9891;139,4;-287,9;316;0
vpja68;14;9946;10000;52,4;-146,5;54;0
vpja68;15;189;239;25,7;-224,7;50;2,55e+08
vpja68;15;266;495;-3,29999999999995;-319,2;229;255000
vpja68;15;513;767;-13,1;-360,9;254;255000
vpja68;15;775;933;-8,79999999999995;-369,5;158;255000
vpja68;15;1001;1162;-370,4;-235,6;161;0
vpja68;15;1203;1347;-524,8;-278,9;144;0
vpja68;15;1439;1556;229,1;-236,8;117;0
vpja68;15;1586;1737;289,8;-211;151;0
vpja68;15;1817;2050;-320,7;-266,9;233;0
vpja68;15;2098;2271;-177,7;-263,8;173;0
vpja68;15;2323;2582;16,7;-341,9;259;255000
vpja68;15;2591;2712;17,4;-353,5;121;255000
vpja68;15;2775;3006;371,3;-227,2;231;0
vpja68;15;3030;3149;419,2;-262,5;119;0
vpja68;15;3302;3514;414,4;-260,9;212;0
vpja68;15;3565;3759;281,1;-204,2;194;0
vpja68;15;3846;4077;444,6;358,9;231;0
vpja68;15;4113;5038;464,3;427;925;255255000
vpja68;15;5072;5458;446,3;369,5;386;0
vpja68;15;5483;6169;471,6;420,4;686;0
vpja68;15;6268;6476;-317,9;290,4;208;255
vpja68;15;6521;6682;-456,6;355,9;161;255
vpja68;15;6776;6908;418,3;406,3;132;0
vpja68;15;6940;7089;476,5;429,4;149;255255000
vpja68;15;7154;7351;591,7;3,39999999999998;197;0
vpja68;15;7414;7509;447,5;-240,7;95;0
vpja68;15;7578;7735;46,8;-361,2;157;255000
vpja68;15;7766;7905;-8,89999999999998;-372,6;139;255000
vpja68;15;7975;8188;-405,1;-282,9;213;0
vpja68;15;8220;8359;-511,1;-270,5;139;0
vpja68;15;8418;8591;-220,6;-290,4;173;0
vpja68;15;8658;8865;-491,1;-453,1;207;0
vpja68;15;8928;9118;-163,1;-276,2;190;0
vpja68;15;9142;9615;-167,1;-330,1;473;0
vpja68;15;9780;9930;-172,8;-337,3;150;0
vpja68;16;182;235;6,29999999999995;-177,1;53;2,55e+08
vpja68;16;258;403;-9,5;-251,4;145;255000
vpja68;16;421;746;-13,1;-277,6;325;255000
vpja68;16;755;906;2;-280,3;151;255000
vpja68;16;980;1206;500,7;-38,5;226;0
vpja68;16;1247;1316;598,7;55,2;69;0
vpja68;16;1371;1625;280,3;84,3;254;255
vpja68;16;1703;1816;-319,6;126,2;113;255255000
vpja68;16;1847;2086;-370,6;131,1;239;255255000
vpja68;16;2140;2373;-635,2;79,1;233;0
vpja68;16;2383;2568;-637,8;69;185;0
vpja68;16;2647;2784;-36,8000000000001;-262;137;255000
vpja68;16;2816;3171;3;-275,2;355;255000
vpja68;16;3321;3460;-0,200000000000045;-273,7;139;255000
vpja68;16;3481;3574;17,3;-279,1;93;255000
vpja68;16;3647;3842;274,4;96,8;195;255
vpja68;16;3922;4082;-341,6;121,3;160;255255000
vpja68;16;4113;4527;-377,6;129,8;414;0
vpja68;16;4538;5674;-374;118,1;1136;255255000
vpja68;16;5750;5886;232,6;93,3;136;255
vpja68;16;5918;6076;290,7;87,7;158;255
vpja68;16;6128;6332;524,2;-21,1;204;0
vpja68;16;6360;6518;607,9;57,1;158;0
vpja68;16;6563;6821;518,7;-226,3;258;0
vpja68;16;6862;7114;444,7;-245,9;252;0
vpja68;16;7136;7301;397,4;-233,9;165;0
vpja68;16;7361;7400;395,5;-86,3;39;0
vpja68;16;7473;7588;267,5;353,9;115;0
vpja68;16;7641;7822;54,1999999999999;450,9;181;0
vpja68;16;7873;8215;-122,2;448,2;342;2,55e+08
vpja68;16;8257;8432;86,2;443,4;175;2,55e+08
vpja68;16;8493;8617;-13,7;81,5;124;0
vpja68;16;8640;8806;-15,9000000000001;22,1;166;2,55e+08
vpja68;16;8858;9154;-9,30000000000007;-273,3;296;255000
vpja68;16;9209;9402;-108,5;-405,4;193;0
vpja68;16;9476;9643;-516,9;-336,4;167;0
vpja68;16;9711;9854;-36,7;-255,2;143;255000
vpja68;16;9885;10000;4,69999999999993;-273;115;255000
vpja68;17;174;284;121,6;-106,9;110;255000
vpja68;17;310;643;139,2;-125,3;333;255000
vpja68;17;659;1250;145,9;-144,2;591;255000
vpja68;17;1283;1462;160,8;-67,5;179;2,55e+08
vpja68;17;1533;1724;-134,5;270,7;191;255255000
vpja68;17;1755;1938;-203,8;269,7;183;255255000
vpja68;17;2005;2171;-507,9;24,9;166;0
vpja68;17;2244;2415;-267,1;-280,7;171;0
vpja68;17;2487;2617;-461,4;-104;130;0
vpja68;17;2651;2940;-337,4;-75;289;0
vpja68;17;3004;3085;-483,3;42,5999999999999;81;0
vpja68;17;3166;3397;-272;-365,2;231;0
vpja68;17;3444;3547;-295,3;-237,7;103;0
vpja68;17;3580;3826;-133,7;-249;246;0
vpja68;17;3855;4177;28,1;-280,9;322;0
vpja68;17;4208;4363;-78,6;-225,7;155;0
vpja68;17;4426;4715;-365;-187,6;289;0
vpja68;17;4808;4850;313,7;125,7;42;0
vpja68;17;4892;5062;399,3;215,3;170;255
vpja68;17;5102;5387;432,9;145,9;285;0
vpja68;17;5444;5622;352,8;351,3;178;255
vpja68;17;5714;5867;452,9;291;153;255
vpja68;17;6053;6458;456,2;308,2;405;255
vpja68;17;6466;6798;451,4;305;332;255
vpja68;17;6852;7181;266,8;397,9;329;255
vpja68;17;7202;7569;239,6;396,9;367;255
vpja68;17;7601;7933;309,8;415,5;332;255
vpja68;17;8003;8180;-140,7;276,3;177;255255000
vpja68;17;8204;8417;-209;269,6;213;255255000
vpja68;17;8425;8458;-223,2;270,6;33;255255000
vpja68;17;8601;8832;216,8;68,6999999999999;231;2,55e+08
vpja68;17;8879;9302;421;149,9;423;0
vpja68;17;9326;9450;428,3;119,7;124;0
vpja68;17;9495;9699;143,8;63,5999999999999;204;2,55e+08
vpja68;17;9742;10000;141,4;-142,3;258;255000
vpja68;18;250;549;1,10000000000002;-222,1;299;255000
vpja68;18;623;851;-460,3;227,5;228;255
vpja68;18;877;1037;-447,7;171,3;160;255
vpja68;18;1117;1261;296,4;244,5;144;255255000
vpja68;18;1290;1606;349,4;229,7;316;255255000
vpja68;18;1633;2008;345,8;283,2;375;255255000
vpja68;18;2074;2235;-59,9;70,6;161;2,55e+08
vpja68;18;2284;2744;-9,39999999999998;-239,5;460;255000
vpja68;18;2766;2916;8,79999999999995;-248,4;150;255000
vpja68;18;2980;3197;-31;61,8000000000001;217;2,55e+08
vpja68;18;3257;3464;0,5;-146,1;207;2,55e+08
vpja68;18;3503;3935;7,89999999999998;-251,1;432;255000
vpja68;18;3989;4258;7,5;-58,6999999999999;269;2,55e+08
vpja68;18;4309;4695;77,4000000000001;40,2;386;2,55e+08
vpja68;18;4753;4784;394,7;-16,3;31;0
vpja68;18;4864;5075;100,9;-363,2;211;0
vpja68;18;5126;5339;218,5;-390,7;213;0
vpja68;18;5364;5536;326,8;-423,3;172;0
vpja68;18;5612;5691;-77,6;-333,6;79;0
vpja68;18;5765;5906;-432,3;19,9000000000001;141;0
vpja68;18;5955;6133;-531,8;-182,6;178;0
vpja68;18;6190;6364;-395,4;75,3000000000001;174;0
vpja68;18;6451;6640;397,5;70,5;189;0
vpja68;18;6827;6860;446,9;87,5;33;0
vpja68;18;6896;7226;341,9;224,2;330;255255000
vpja68;18;7309;7477;-379,1;206,2;168;255
vpja68;18;7502;7851;-441,2;162,2;349;255
vpja68;18;7878;8154;-420,5;235,1;276;255
vpja68;18;8177;8361;-420;269,8;184;255
vpja68;18;8380;8703;-400,9;268,7;323;255
vpja68;18;8734;9040;-414,6;278;306;255
vpja68;18;9127;9213;-47,2;-174,5;86;0
vpja68;18;9238;9657;5;-226,2;419;255000
vpja68;18;9679;10000;4,79999999999995;-240;321;255000
vpja68;19;174;227;37,1;-192,8;53;2,55e+08
vpja68;19;251;423;22;-254;172;255000
vpja68;19;441;744;-6,39999999999998;-267,5;303;255000
vpja68;19;766;1095;17,5;-278,2;329;255000
vpja68;19;1125;1461;-1,19999999999993;-243;336;255000
vpja68;19;1478;1617;3,80000000000007;-219;139;255000
vpja68;19;1687;2000;-343;158,4;313;255
vpja68;19;2022;2212;-344,2;137,7;190;255
vpja68;19;2256;2357;-496;214,9;101;0
vpja68;19;2398;2520;-330,1;143,8;122;255
vpja68;19;2577;2715;-12,9;59,1999999999999;138;2,55e+08
vpja68;19;2770;2969;299,4;161,7;199;0
vpja68;19;3000;3236;347,4;156,6;236;255255000
vpja68;19;3325;3455;-309,1;153,6;130;255
vpja68;19;3480;3609;-347,7;150,7;129;255
vpja68;19;3692;3826;293,6;172,8;134;0
vpja68;19;3858;4117;348,3;160,6;259;255255000
vpja68;19;4190;4391;-128,4;93,8;201;0
vpja68;19;4445;4524;59,2;48,1999999999999;79;2,55e+08
vpja68;19;4588;4781;43,5;-291,3;193;255000
vpja68;19;4810;4932;12,1;-287,3;122;255000
vpja68;19;4980;5114;178,9;-364,8;134;0
vpja68;19;5142;5268;280,3;-409,3;126;0
vpja68;19;5295;5474;295,4;-424,3;179;0
vpja68;19;5567;5689;560,9;159,1;122;0
vpja68;19;5739;5897;627,2;322,9;158;0
vpja68;19;5933;6042;538,1;357,2;109;0
vpja68;19;6203;6357;-101,6;-228,8;154;0
vpja68;19;6394;7041;8,90000000000009;-264,3;647;255000
vpja68;19;7061;7471;-7;-250,9;410;255000
vpja68;19;7491;7666;-4,29999999999995;-280,1;175;255000
vpja68;19;7690;8086;15,8000000000001;-280,3;396;255000
vpja68;19;8117;8440;-2,79999999999995;-194,4;323;0
vpja68;19;8463;8678;6,90000000000009;-242,3;215;255000
vpja68;19;8699;8934;-0,399999999999977;-206,3;235;255000
vpja68;19;8943;9142;-4,5;-216,1;199;255000
vpja68;19;9170;9470;19,7;-278,2;300;255000
vpja68;19;9493;9774;-12,1999999999999;-276;281;255000
vpja68;19;9809;9931;-99,3;-316,7;122;0
vpja68;19;9971;10000;8,5;-228,3;29;255000
vpja68;20;169;216;-54,4;-150,8;47;2,55e+08
vpja68;20;254;371;-128;-146,6;117;255000
vpja68;20;392;497;-122,2;-152,1;105;255000
vpja68;20;571;759;-312,3;170,6;188;255
vpja68;20;788;817;-259,6;126,2;29;0
vpja68;20;861;982;-139,8;-136,8;121;0
vpja68;20;1013;1166;-124,1;-148,8;153;255000
vpja68;20;1321;1589;-110;-144,1;268;255000
vpja68;20;1661;1844;-30,8;95,5;183;2,55e+08
vpja68;20;1895;2157;-150,3;82,1;262;2,55e+08
vpja68;20;2184;2303;-134,6;68,5;119;2,55e+08
vpja68;20;2360;2583;-116,4;-149,3;223;255000
vpja68;20;2642;2889;59,5;-316,8;247;0
vpja68;20;2928;3039;93,4000000000001;-391,8;111;0
vpja68;20;3116;3465;-420,1;-156;349;0
vpja68;20;3501;3644;-458,7;-106,3;143;0
vpja68;20;3691;3788;-536,1;-166,7;97;0
vpja68;20;3860;3951;-355,8;101,9;91;0
vpja68;20;3985;4189;-271;167,9;204;0
vpja68;20;4218;4332;-248,5;155,2;114;255
vpja68;20;4388;4767;8,90000000000009;144,7;379;255255000
vpja68;20;4822;5013;-120,7;313,9;191;0
vpja68;20;5049;5120;-222,2;357,6;71;0
vpja68;20;5185;5258;-104,6;-74;73;2,55e+08
vpja68;20;5284;5485;-99,3;-163,4;201;255000
vpja68;20;5507;5691;-112,3;-148,9;184;255000
vpja68;20;5746;5934;-31,5999999999999;34,4000000000001;188;2,55e+08
vpja68;20;5963;6167;40,9000000000001;158,3;204;255255000
vpja68;20;6246;6536;599,2;114,7;290;0
vpja68;20;6722;6968;312,3;-104,3;246;0
vpja68;20;7024;7273;254,4;104;249;0
vpja68;20;7330;7420;659,1;115,9;90;NA
vpja68;20;7496;7801;60,9000000000001;163,8;305;255255000
vpja68;20;7874;8018;120,4;-265,7;144;0
vpja68;20;8064;8370;10,3000000000001;-373,2;306;0
vpja68;20;8399;8673;123,4;-382,6;274;0
vpja68;20;8757;8856;-65,8;-92,3;99;2,55e+08
vpja68;20;8880;9123;-88,8;-144,4;243;255000
vpja68;20;9144;9558;-102,8;-147,5;414;255000
vpja68;20;9613;9797;-39,4;-12,4;184;2,55e+08
vpja68;20;9838;10000;-142,8;80,5;162;2,55e+08
vpja68;21;238;335;-359,5;-210,1;97;255000
vpja68;21;357;553;-412,8;-266,1;196;255000
vpja68;21;632;885;-515,3;301,8;253;255
vpja68;21;954;1202;-403,2;-258,3;248;255000
vpja68;21;1231;1577;-375,7;-263,2;346;255000
vpja68;21;1602;1791;-399,3;-222,1;189;255000
vpja68;21;1814;2047;-407,7;-266,6;233;255000
vpja68;21;2075;2264;-377,6;-262,4;189;255000
vpja68;21;2295;2406;-400,9;-198,3;111;255000
vpja68;21;2483;2682;-498,6;321,2;199;255
vpja68;21;2706;2986;-501,8;284;280;255
vpja68;21;3067;3363;72;195,9;296;255255000
vpja68;21;3385;3598;91,8;197,2;213;255255000
vpja68;21;3680;3906;-491,3;317,7;226;255
vpja68;21;3930;4485;-505,7;286,1;555;255
vpja68;21;4569;4705;155,8;50,6;136;0
vpja68;21;4823;4984;376,8;-128,2;161;0
vpja68;21;5007;5244;414,3;-164,7;237;0
vpja68;21;5312;5441;121,6;156,8;129;255255000
vpja68;21;5474;6385;73,1000000000001;189,7;911;255255000
vpja68;21;6410;6650;102,4;213,9;240;255255000
vpja68;21;6700;6908;217,4;-16,7;208;0
vpja68;21;6999;7098;-338,1;-287,3;99;255000
vpja68;21;7139;7331;-420,6;-250,3;192;255000
vpja68;21;7370;7661;-577,6;-215,5;291;0
vpja68;21;7693;7811;-382,8;-254,7;118;255000
vpja68;21;7867;8141;-582,6;-237,4;274;0
vpja68;21;8157;8349;-567,3;-249,2;192;0
vpja68;21;8440;8573;141;-82,9;133;0
vpja68;21;8614;8802;247,2;10,1999999999999;188;0
vpja68;21;8869;8975;-113,8;238,3;106;0
vpja68;21;9044;9229;-496;378,2;185;255
vpja68;21;9262;9540;-506,2;295,2;278;255
vpja68;21;9569;9619;-478,7;292,6;50;255
vpja68;21;9693;9848;-367,4;-212,2;155;255000
vpja68;21;9873;10000;-404,7;-255,4;127;255000
vpja68;22;196;274;74,4;-176,6;78;255000
vpja68;22;296;428;76,3000000000001;-217,5;132;255000
vpja68;22;484;756;311,2;171,4;272;255
vpja68;22;830;1032;104,5;-227,7;202;255000
vpja68;22;1061;1152;80,1999999999999;-238,6;91;255000
vpja68;22;1224;1469;-300,7;175,2;245;255255000
vpja68;22;1502;1534;-245,9;156,7;32;255255000
vpja68;22;1610;1797;283;160,7;187;255
vpja68;22;1859;2057;92,4;-218,7;198;255000
vpja68;22;2074;2193;97,1999999999999;-231,3;119;255000
vpja68;22;2262;2416;310,3;186,8;154;255
vpja68;22;2442;2654;317,7;131,9;212;255
vpja68;22;2827;3029;-287;152,2;202;255255000
vpja68;22;3060;3486;-250,9;175,6;426;255255000
vpja68;22;3561;3749;58,1;-220,6;188;255000
vpja68;22;3800;3985;-83,6;-330,3;185;0
vpja68;22;4048;4397;302,1;-250,8;349;0
vpja68;22;4419;4563;246,4;-270,9;144;0
vpja68;22;4627;4832;588,3;-79;205;0
vpja68;22;4911;5000;159,3;-226,4;89;0
vpja68;22;5034;5219;84,1999999999999;-227,1;185;255000
vpja68;22;5241;5660;82,9;-245,8;419;255000
vpja68;22;5738;6044;306,3;142,4;306;255
vpja68;22;6084;6249;112,5;92,3000000000001;165;2,55e+08
vpja68;22;6273;6427;133,5;123,1;154;2,55e+08
vpja68;22;6493;6710;-289,5;163,5;217;255255000
vpja68;22;6734;7192;-260,9;178,3;458;255255000
vpja68;22;7263;7463;295;164,2;200;255
vpja68;22;7493;8772;324,7;135;1279;255
vpja68;22;8795;9227;318,4;174,3;432;255
vpja68;22;9307;9668;-289,9;161,3;361;255255000
vpja68;22;9696;10000;-257,3;172,8;304;255255000
vpja68;23;206;376;-8,5;-94,4;170;255000
vpja68;23;559;718;-572;211,3;159;0
vpja68;23;737;830;-564,5;177,1;93;255
vpja68;23;906;1122;-28,1999999999999;-112,3;216;255000
vpja68;23;1144;1575;-58;-115;431;255000
vpja68;23;1599;1947;-46;-75,4;348;255000
vpja68;23;1974;2520;-40,1;-123,2;546;255000
vpja68;23;2596;2878;-87,4;284,4;282;255255000
vpja68;23;2912;3192;-26,8;224,8;280;255255000
vpja68;23;3215;3641;-84,6;280,4;426;255255000
vpja68;23;3848;3933;-61,6999999999999;237,3;85;255255000
vpja68;23;4008;4159;-502,9;176,9;151;255
vpja68;23;4180;4965;-527,5;159,4;785;255
vpja68;23;5046;5135;-209,5;183,7;89;0
vpja68;23;5178;5308;-114,2;287,8;130;255255000
vpja68;23;5346;5473;-18,8;217;127;255255000
vpja68;23;5525;5721;-17;-123,8;196;255000
vpja68;23;5749;5976;-52,1;-109,2;227;255000
vpja68;23;6002;6205;40;-170;203;255000
vpja68;23;6248;6353;95,5000000000001;-237,3;105;255000
vpja68;23;6425;6601;417,9;155;176;0
vpja68;23;6718;6991;-61,6;284,2;273;255255000
vpja68;23;7011;7440;-79,5;254,3;429;255255000
vpja68;23;7469;7661;-27,9;219,5;192;255255000
vpja68;23;7738;7886;-513,1;170,2;148;255
vpja68;23;7901;8265;-523,6;154,9;364;255
vpja68;23;8427;8566;-526,4;165,7;139;255
vpja68;23;8579;9054;-535,8;161,8;475;255
vpja68;23;9093;9288;-377,2;96,1;195;0
vpja68;23;9352;9550;-37,1;-116;198;255000
vpja68;23;9573;9773;-64,4;-104,5;200;255000
vpja68;23;9802;9999;-32,1999999999999;-120,4;197;255000
vpja68;24;197;284;-100,649800796813;-85,6988047808765;87;255000
vpja68;24;314;477;-74,7498007968128;-111,098804780876;163;255000
vpja68;24;526;713;199,550199203187;140,001195219124;187;255
vpja68;24;731;1018;217,550199203187;113,801195219124;287;255
vpja68;24;1399;1518;-486,849800796813;136,101195219124;119;255255000
vpja68;24;1676;1871;-85,7498007968128;-110,798804780876;195;255000
vpja68;24;1896;2510;-69,3498007968128;-110,098804780876;614;255000
vpja68;24;2571;2703;-11,8498007968128;173,501195219124;132;2,55e+08
vpja68;24;2734;2933;56,2501992031872;229,001195219124;199;2,55e+08
vpja68;24;2986;3195;-100,749800796813;296,301195219124;209;0
vpja68;24;3238;3479;69,7501992031872;208,701195219124;241;2,55e+08
vpja68;24;3521;3771;-14,7498007968128;96,3011952191235;250;2,55e+08
vpja68;24;3793;3930;-20,8498007968128;42,7011952191236;137;2,55e+08
vpja68;24;3971;4119;-80,2498007968128;-89,3988047808764;148;255000
vpja68;24;4139;4248;-76,9498007968128;-109,498804780876;109;255000
vpja68;24;4302;4412;-382,149800796813;145,201195219124;110;255255000
vpja68;24;4434;4520;-378,849800796813;144,001195219124;86;255255000
vpja68;24;4610;4750;360,550199203187;63,3011952191235;140;0
vpja68;24;4780;4959;386,050199203187;17,0011952191236;179;0
vpja68;24;5011;5235;203,550199203187;121,801195219124;224;255
vpja68;24;5304;5426;164,850199203187;-272,598804780876;122;0
vpja68;24;5474;5723;-32,9498007968128;-364,998804780876;249;0
vpja68;24;5778;6155;159,150199203187;-255,298804780876;377;0
vpja68;24;6219;6385;-89,3498007968128;-89,9988047808764;166;255000
vpja68;24;6408;6851;-75,4498007968128;-107,698804780876;443;255000
vpja68;24;7019;7170;-613,049800796813;-85,3988047808764;151;0
vpja68;24;7191;7333;-638,749800796813;-114,198804780876;142;0
vpja68;24;7372;7648;-436,749800796813;-104,598804780876;276;0
vpja68;24;7710;7846;-62,3498007968128;-92,2988047808764;136;255000
vpja68;24;7908;8130;-407,349800796813;-3,39880478087639;222;0
vpja68;24;8281;8690;-53,0498007968127;-110,398804780876;409;255000
vpja68;24;8714;8813;-68,5498007968127;-108,398804780876;99;255000
vpja68;24;8875;9158;291,050199203187;23,4011952191236;283;0
vpja68;24;9184;9393;376,350199203187;8,10119521912361;209;0
vpja68;24;9459;9663;-86,5498007968127;-94,9988047808764;204;255000
vpja68;24;9722;9917;152,550199203187;111,301195219124;195;0
vpja68;24;9956;10000;246,750199203187;24,3011952191235;44;0
vpja68;25;175;252;-138,4;-28,9;77;2,55e+08
vpja68;25;304;404;-112,8;-325,3;100;2,55e+08
vpja68;25;428;841;-79;-348,6;413;255000
vpja68;25;859;1253;-72,2;-352,8;394;255000
vpja68;25;1268;1638;-69,1;-347,9;370;255000
vpja68;25;1645;1851;-68,9;-337,5;206;255000
vpja68;25;1865;2107;-64,8;-348,3;242;255000
vpja68;25;2127;2213;-68,1;-348,8;86;255000
vpja68;25;2292;2479;-93,5;45,3;187;2,55e+08
vpja68;25;2524;2820;-98,5;146;296;2,55e+08
vpja68;25;2842;2888;-119,1;146,4;46;2,55e+08
vpja68;25;2950;3097;-436,7;213,5;147;255255000
vpja68;25;3164;3341;-413,9;-270,6;177;0
vpja68;25;3380;3522;-499,2;-299,5;142;0
vpja68;25;3579;3828;-278,8;-398,5;249;0
vpja68;25;3916;4217;432,8;-165;301;0
vpja68;25;4268;4414;542,4;-148,4;146;0
vpja68;25;4519;4637;-365,3;170,8;118;255255000
vpja68;25;4678;4825;-439,5;276,6;147;255255000
vpja68;25;4848;4913;-456,6;262,2;65;255255000
vpja68;25;4973;5223;-92,4;156,6;250;2,55e+08
vpja68;25;5247;5459;-117,4;149;212;2,55e+08
vpja68;25;5527;5635;-75,5;-318,4;108;255000
vpja68;25;5666;6276;-68,8;-350,1;610;255000
vpja68;25;6291;6782;-69,7;-341;491;255000
vpja68;25;6802;7484;-66,4;-356,9;682;255000
vpja68;25;7505;7645;-71,1;-329,2;140;255000
vpja68;25;7720;7997;-96,1;44,1999999999999;277;2,55e+08
vpja68;25;8027;8292;-113,7;157,2;265;2,55e+08
vpja68;25;8354;8706;273,5;194,2;352;255
vpja68;25;8738;9017;290,9;298,7;279;0
vpja68;25;9057;9222;263,4;143,7;165;255
vpja68;25;9245;9597;288,6;154;352;255
vpja68;25;9810;10000;295,7;158,6;190;255
vpja68;26;117;143;-0,384269662921497;-8,64419475655427;26;0
vpja68;26;189;359;135,515730337078;-197,544194756554;170;255000
vpja68;26;382;943;98,6157303370786;-210,544194756554;561;255000
vpja68;26;969;1171;117,715730337079;-214,844194756554;202;255000
vpja68;26;1194;1360;189,415730337079;-202,144194756554;166;255000
vpja68;26;1435;1749;-317,584269662921;44,7558052434457;314;255
vpja68;26;1794;1927;-292,184269662921;-1,44419475655423;133;255
vpja68;26;1968;2147;-404,184269662921;-133,344194756554;179;0
vpja68;26;2205;2396;-58,0842696629214;-154,344194756554;191;0
vpja68;26;2445;2587;-80,9842696629215;-366,444194756554;142;0
vpja68;26;2613;2736;-20,6842696629215;-364,344194756554;123;0
vpja68;26;2799;2996;134,315730337078;-200,044194756554;197;255000
vpja68;26;3071;3323;-301,684269662921;26,8558052434457;252;255
vpja68;26;3382;3572;-523,384269662921;-160,344194756554;190;0
vpja68;26;3601;3831;-603,384269662921;-155,144194756554;230;0
vpja68;26;3882;4030;-316,184269662921;-125,644194756554;148;0
vpja68;26;4115;4232;252,815730337078;-323,644194756554;117;0
vpja68;26;4283;4396;415,915730337079;-328,344194756554;113;0
vpja68;26;4421;4989;419,015730337078;-375,044194756554;568;0
vpja68;26;5069;5284;397,715730337079;203,755805243446;215;255255000
vpja68;26;5316;5525;433,715730337079;260,255805243446;209;255255000
vpja68;26;5549;5650;473,915730337079;266,255805243446;101;255255000
vpja68;26;5719;5825;87,2157303370785;-141,344194756554;106;2,55e+08
vpja68;26;5851;6173;106,115730337079;-216,644194756554;322;255000
vpja68;26;6225;6458;-59,3842696629215;-149,144194756554;233;0
vpja68;26;6483;6623;-20,2842696629215;-111,744194756554;140;0
vpja68;26;6712;7050;-528,984269662921;374,355805243446;338;0
vpja68;26;7084;7340;-463,084269662921;393,755805243446;256;0
vpja68;26;7365;7488;-518,684269662921;370,355805243446;123;0
vpja68;26;7527;7711;-390,484269662922;264,055805243446;184;0
vpja68;26;7748;7908;-491,184269662921;253,255805243446;160;0
vpja68;26;7964;8137;-217,584269662921;212,055805243446;173;0
vpja68;26;8217;8556;392,515730337078;257,655805243446;339;255255000
vpja68;26;8580;9223;426,215730337079;264,255805243446;643;255255000
vpja68;26;9259;9752;388,515730337078;207,155805243446;493;255255000
vpja68;26;9783;9940;427,015730337078;262,955805243446;157;255255000
